driver_1_id,driver_2_id,constructorId,year,driver_1,driver_2,driver_1_points,driver_2_points,point_gap,better_driver
304,360,1,1968,Denny Hulme,Bruce McLaren,0,0,0,Bruce McLaren
262,288,1,1971,Jackie Oliver,Mark Donohue,0,4,4,Mark Donohue
262,304,1,1971,Jackie Oliver,Denny Hulme,0,9,9,Denny Hulme
262,320,1,1971,Jackie Oliver,Peter Gethin,0,0,0,Peter Gethin
262,322,1,1971,Jackie Oliver,David Hobbs,0,0,0,David Hobbs
262,347,1,1971,Jackie Oliver,Jo Bonnier,0,0,0,Jo Bonnier
288,304,1,1971,Mark Donohue,Denny Hulme,4,9,5,Denny Hulme
288,320,1,1971,Mark Donohue,Peter Gethin,4,0,4,Mark Donohue
288,322,1,1971,Mark Donohue,David Hobbs,4,0,4,Mark Donohue
288,347,1,1971,Mark Donohue,Jo Bonnier,4,0,4,Mark Donohue
304,320,1,1971,Denny Hulme,Peter Gethin,9,0,9,Denny Hulme
304,322,1,1971,Denny Hulme,David Hobbs,9,0,9,Denny Hulme
304,347,1,1971,Denny Hulme,Jo Bonnier,9,0,9,Denny Hulme
320,322,1,1971,Peter Gethin,David Hobbs,0,0,0,David Hobbs
320,347,1,1971,Peter Gethin,Jo Bonnier,0,0,0,Jo Bonnier
322,347,1,1971,David Hobbs,Jo Bonnier,0,0,0,Jo Bonnier
222,304,1,1972,Jody Scheckter,Denny Hulme,0,39,39,Denny Hulme
222,309,1,1972,Jody Scheckter,Peter Revson,0,23,23,Peter Revson
222,312,1,1972,Jody Scheckter,Brian Redman,0,4,4,Brian Redman
304,309,1,1972,Denny Hulme,Peter Revson,39,23,16,Denny Hulme
304,312,1,1972,Denny Hulme,Brian Redman,39,4,35,Denny Hulme
309,312,1,1972,Peter Revson,Brian Redman,23,4,19,Peter Revson
222,235,1,1973,Jody Scheckter,Jacky Ickx,0,4,4,Jacky Ickx
222,304,1,1973,Jody Scheckter,Denny Hulme,0,26,26,Denny Hulme
222,309,1,1973,Jody Scheckter,Peter Revson,0,38,38,Peter Revson
235,304,1,1973,Jacky Ickx,Denny Hulme,4,26,22,Denny Hulme
235,309,1,1973,Jacky Ickx,Peter Revson,4,38,34,Peter Revson
304,309,1,1973,Denny Hulme,Peter Revson,26,38,12,Peter Revson
200,224,1,1974,Jochen Mass,Emerson Fittipaldi,0,55,55,Emerson Fittipaldi
200,293,1,1974,Jochen Mass,Dave Charlton,0,0,0,Dave Charlton
200,304,1,1974,Jochen Mass,Denny Hulme,0,20,20,Denny Hulme
200,305,1,1974,Jochen Mass,Mike Hailwood,0,12,12,Mike Hailwood
200,322,1,1974,Jochen Mass,David Hobbs,0,0,0,David Hobbs
224,293,1,1974,Emerson Fittipaldi,Dave Charlton,55,0,55,Emerson Fittipaldi
224,304,1,1974,Emerson Fittipaldi,Denny Hulme,55,20,35,Emerson Fittipaldi
224,305,1,1974,Emerson Fittipaldi,Mike Hailwood,55,12,43,Emerson Fittipaldi
224,322,1,1974,Emerson Fittipaldi,David Hobbs,55,0,55,Emerson Fittipaldi
293,304,1,1974,Dave Charlton,Denny Hulme,0,20,20,Denny Hulme
293,305,1,1974,Dave Charlton,Mike Hailwood,0,12,12,Mike Hailwood
293,322,1,1974,Dave Charlton,David Hobbs,0,0,0,David Hobbs
304,305,1,1974,Denny Hulme,Mike Hailwood,20,12,8,Denny Hulme
304,322,1,1974,Denny Hulme,David Hobbs,20,0,20,Denny Hulme
305,322,1,1974,Mike Hailwood,David Hobbs,12,0,12,Mike Hailwood
200,224,1,1975,Jochen Mass,Emerson Fittipaldi,20,45,25,Emerson Fittipaldi
200,293,1,1975,Jochen Mass,Dave Charlton,20,0,20,Jochen Mass
224,293,1,1975,Emerson Fittipaldi,Dave Charlton,45,0,45,Emerson Fittipaldi
200,231,1,1976,Jochen Mass,James Hunt,19,69,50,James Hunt
152,200,1,1977,Bruno Giacomelli,Jochen Mass,0,25,25,Jochen Mass
152,203,1,1977,Bruno Giacomelli,Gilles Villeneuve,0,0,0,Gilles Villeneuve
152,208,1,1977,Bruno Giacomelli,Emilio de Villota,0,0,0,Emilio de Villota
152,231,1,1977,Bruno Giacomelli,James Hunt,0,40,40,James Hunt
152,239,1,1977,Bruno Giacomelli,Brett Lunger,0,0,0,Brett Lunger
200,203,1,1977,Jochen Mass,Gilles Villeneuve,25,0,25,Jochen Mass
200,208,1,1977,Jochen Mass,Emilio de Villota,25,0,25,Jochen Mass
200,231,1,1977,Jochen Mass,James Hunt,25,40,15,James Hunt
200,239,1,1977,Jochen Mass,Brett Lunger,25,0,25,Jochen Mass
203,208,1,1977,Gilles Villeneuve,Emilio de Villota,0,0,0,Emilio de Villota
203,231,1,1977,Gilles Villeneuve,James Hunt,0,40,40,James Hunt
203,239,1,1977,Gilles Villeneuve,Brett Lunger,0,0,0,Brett Lunger
208,231,1,1977,Emilio de Villota,James Hunt,0,40,40,James Hunt
208,239,1,1977,Emilio de Villota,Brett Lunger,0,0,0,Brett Lunger
231,239,1,1977,James Hunt,Brett Lunger,40,0,40,James Hunt
137,152,1,1978,Nelson Piquet,Bruno Giacomelli,0,0,0,Bruno Giacomelli
137,175,1,1978,Nelson Piquet,Patrick Tambay,0,8,8,Patrick Tambay
137,208,1,1978,Nelson Piquet,Emilio de Villota,0,0,0,Emilio de Villota
137,231,1,1978,Nelson Piquet,James Hunt,0,8,8,James Hunt
137,239,1,1978,Nelson Piquet,Brett Lunger,0,0,0,Brett Lunger
137,245,1,1978,Nelson Piquet,Tony Trimmer,0,0,0,Tony Trimmer
152,175,1,1978,Bruno Giacomelli,Patrick Tambay,0,8,8,Patrick Tambay
152,208,1,1978,Bruno Giacomelli,Emilio de Villota,0,0,0,Emilio de Villota
152,231,1,1978,Bruno Giacomelli,James Hunt,0,8,8,James Hunt
152,239,1,1978,Bruno Giacomelli,Brett Lunger,0,0,0,Brett Lunger
152,245,1,1978,Bruno Giacomelli,Tony Trimmer,0,0,0,Tony Trimmer
175,208,1,1978,Patrick Tambay,Emilio de Villota,8,0,8,Patrick Tambay
175,231,1,1978,Patrick Tambay,James Hunt,8,8,0,James Hunt
175,239,1,1978,Patrick Tambay,Brett Lunger,8,0,8,Patrick Tambay
175,245,1,1978,Patrick Tambay,Tony Trimmer,8,0,8,Patrick Tambay
208,231,1,1978,Emilio de Villota,James Hunt,0,8,8,James Hunt
208,239,1,1978,Emilio de Villota,Brett Lunger,0,0,0,Brett Lunger
208,245,1,1978,Emilio de Villota,Tony Trimmer,0,0,0,Tony Trimmer
231,239,1,1978,James Hunt,Brett Lunger,8,0,8,James Hunt
231,245,1,1978,James Hunt,Tony Trimmer,8,0,8,James Hunt
239,245,1,1978,Brett Lunger,Tony Trimmer,0,0,0,Tony Trimmer
175,187,1,1979,Patrick Tambay,John Watson,0,15,15,John Watson
117,187,1,1980,Alain Prost,John Watson,5,6,1,John Watson
117,226,1,1980,Alain Prost,Stephen South,5,0,5,Alain Prost
187,226,1,1980,John Watson,Stephen South,6,0,6,John Watson
110,187,1,1981,Andrea de Cesaris,John Watson,1,27,26,John Watson
182,187,1,1982,Niki Lauda,John Watson,30,39,9,John Watson
182,187,1,1983,Niki Lauda,John Watson,12,22,10,John Watson
117,182,1,1984,Alain Prost,Niki Lauda,71,72,1,Niki Lauda
117,182,1,1985,Alain Prost,Niki Lauda,76,14,62,Alain Prost
117,187,1,1985,Alain Prost,John Watson,76,0,76,Alain Prost
182,187,1,1985,Niki Lauda,John Watson,14,0,14,Niki Lauda
117,177,1,1986,Alain Prost,Keke Rosberg,74,22,52,Alain Prost
117,140,1,1987,Alain Prost,Stefan Johansson,46,30,16,Alain Prost
102,117,1,1988,Ayrton Senna,Alain Prost,94,105,11,Alain Prost
102,117,1,1989,Ayrton Senna,Alain Prost,60,81,21,Alain Prost
102,77,1,1990,Ayrton Senna,Gerhard Berger,78,43,35,Ayrton Senna
102,77,1,1991,Ayrton Senna,Gerhard Berger,96,43,53,Ayrton Senna
102,77,1,1992,Ayrton Senna,Gerhard Berger,50,49,1,Ayrton Senna
102,121,1,1993,Ayrton Senna,Michael Andretti,73,7,66,Ayrton Senna
102,57,1,1993,Ayrton Senna,Mika HÃ¤kkinen,73,4,69,Ayrton Senna
121,57,1,1993,Michael Andretti,Mika HÃ¤kkinen,7,4,3,Michael Andretti
112,57,1,1994,Philippe Alliot,Mika HÃ¤kkinen,0,26,26,Mika HÃ¤kkinen
112,84,1,1994,Philippe Alliot,Martin Brundle,0,16,16,Martin Brundle
57,84,1,1994,Mika HÃ¤kkinen,Martin Brundle,26,16,10,Mika HÃ¤kkinen
57,76,1,1995,Mika HÃ¤kkinen,Jan Magnussen,17,0,17,Mika HÃ¤kkinen
57,87,1,1995,Mika HÃ¤kkinen,Mark Blundell,17,13,4,Mika HÃ¤kkinen
57,95,1,1995,Mika HÃ¤kkinen,Nigel Mansell,17,0,17,Mika HÃ¤kkinen
76,87,1,1995,Jan Magnussen,Mark Blundell,0,13,13,Mark Blundell
76,95,1,1995,Jan Magnussen,Nigel Mansell,0,0,0,Nigel Mansell
87,95,1,1995,Mark Blundell,Nigel Mansell,13,0,13,Mark Blundell
14,57,1,1996,David Coulthard,Mika HÃ¤kkinen,18,31,13,Mika HÃ¤kkinen
14,57,1,1997,David Coulthard,Mika HÃ¤kkinen,36,27,9,David Coulthard
14,57,1,1998,David Coulthard,Mika HÃ¤kkinen,56,100,44,Mika HÃ¤kkinen
14,57,1,1999,David Coulthard,Mika HÃ¤kkinen,48,76,28,Mika HÃ¤kkinen
14,57,1,2000,David Coulthard,Mika HÃ¤kkinen,73,89,16,Mika HÃ¤kkinen
14,57,1,2001,David Coulthard,Mika HÃ¤kkinen,65,37,28,David Coulthard
14,8,1,2002,David Coulthard,Kimi RÃ¤ikkÃ¶nen,41,24,17,David Coulthard
14,8,1,2003,David Coulthard,Kimi RÃ¤ikkÃ¶nen,51,91,40,Kimi RÃ¤ikkÃ¶nen
14,8,1,2004,David Coulthard,Kimi RÃ¤ikkÃ¶nen,24,45,21,Kimi RÃ¤ikkÃ¶nen
25,31,1,2005,Alexander Wurz,Juan Pablo Montoya,6,60,54,Juan Pablo Montoya
25,37,1,2005,Alexander Wurz,Pedro de la Rosa,6,4,2,Alexander Wurz
25,8,1,2005,Alexander Wurz,Kimi RÃ¤ikkÃ¶nen,6,112,106,Kimi RÃ¤ikkÃ¶nen
31,37,1,2005,Juan Pablo Montoya,Pedro de la Rosa,60,4,56,Juan Pablo Montoya
31,8,1,2005,Juan Pablo Montoya,Kimi RÃ¤ikkÃ¶nen,60,112,52,Kimi RÃ¤ikkÃ¶nen
37,8,1,2005,Pedro de la Rosa,Kimi RÃ¤ikkÃ¶nen,4,112,108,Kimi RÃ¤ikkÃ¶nen
31,37,1,2006,Juan Pablo Montoya,Pedro de la Rosa,26,19,7,Juan Pablo Montoya
31,8,1,2006,Juan Pablo Montoya,Kimi RÃ¤ikkÃ¶nen,26,65,39,Kimi RÃ¤ikkÃ¶nen
37,8,1,2006,Pedro de la Rosa,Kimi RÃ¤ikkÃ¶nen,19,65,46,Kimi RÃ¤ikkÃ¶nen
1,4,1,2007,Lewis Hamilton,Fernando Alonso,109,109,0,Fernando Alonso
1,5,1,2008,Lewis Hamilton,Heikki Kovalainen,98,53,45,Lewis Hamilton
1,5,1,2009,Lewis Hamilton,Heikki Kovalainen,49,22,27,Lewis Hamilton
1,18,1,2010,Lewis Hamilton,Jenson Button,240,214,26,Lewis Hamilton
1,18,1,2011,Lewis Hamilton,Jenson Button,227,270,43,Jenson Button
1,18,1,2012,Lewis Hamilton,Jenson Button,190,188,2,Lewis Hamilton
18,815,1,2013,Jenson Button,Sergio PÃ©rez,73,49,24,Jenson Button
18,825,1,2014,Jenson Button,Kevin Magnussen,126,55,71,Jenson Button
18,4,1,2015,Jenson Button,Fernando Alonso,16,11,5,Jenson Button
18,825,1,2015,Jenson Button,Kevin Magnussen,16,0,16,Jenson Button
4,825,1,2015,Fernando Alonso,Kevin Magnussen,11,0,11,Fernando Alonso
18,4,1,2016,Jenson Button,Fernando Alonso,21,54,33,Fernando Alonso
18,838,1,2016,Jenson Button,Stoffel Vandoorne,21,1,20,Jenson Button
4,838,1,2016,Fernando Alonso,Stoffel Vandoorne,54,1,53,Fernando Alonso
18,4,1,2017,Jenson Button,Fernando Alonso,0,17,17,Fernando Alonso
18,838,1,2017,Jenson Button,Stoffel Vandoorne,0,13,13,Stoffel Vandoorne
4,838,1,2017,Fernando Alonso,Stoffel Vandoorne,17,13,4,Fernando Alonso
4,838,1,2018,Fernando Alonso,Stoffel Vandoorne,50,12,38,Fernando Alonso
832,846,1,2019,Carlos Sainz,Lando Norris,96,49,47,Carlos Sainz
832,846,1,2020,Carlos Sainz,Lando Norris,105,97,8,Carlos Sainz
817,846,1,2021,Daniel Ricciardo,Lando Norris,114,160,46,Lando Norris
817,846,1,2022,Daniel Ricciardo,Lando Norris,34,116,82,Lando Norris
846,857,1,2023,Lando Norris,Oscar Piastri,184,82,102,Lando Norris
846,857,1,2024,Lando Norris,Oscar Piastri,162,112,50,Lando Norris
16,21,10,2008,Adrian Sutil,Giancarlo Fisichella,0,0,0,Giancarlo Fisichella
16,21,10,2009,Adrian Sutil,Giancarlo Fisichella,5,8,3,Giancarlo Fisichella
16,24,10,2009,Adrian Sutil,Vitantonio Liuzzi,5,0,5,Adrian Sutil
21,24,10,2009,Giancarlo Fisichella,Vitantonio Liuzzi,8,0,8,Giancarlo Fisichella
16,24,10,2010,Adrian Sutil,Vitantonio Liuzzi,47,21,26,Adrian Sutil
16,814,10,2011,Adrian Sutil,Paul di Resta,42,27,15,Adrian Sutil
807,814,10,2012,Nico HÃ¼lkenberg,Paul di Resta,63,46,17,Nico HÃ¼lkenberg
16,814,10,2013,Adrian Sutil,Paul di Resta,29,48,19,Paul di Resta
807,815,10,2014,Nico HÃ¼lkenberg,Sergio PÃ©rez,96,59,37,Nico HÃ¼lkenberg
807,815,10,2015,Nico HÃ¼lkenberg,Sergio PÃ©rez,58,78,20,Sergio PÃ©rez
807,815,10,2016,Nico HÃ¼lkenberg,Sergio PÃ©rez,72,101,29,Sergio PÃ©rez
815,839,10,2017,Sergio PÃ©rez,Esteban Ocon,100,87,13,Sergio PÃ©rez
815,839,10,2018,Sergio PÃ©rez,Esteban Ocon,62,49,13,Sergio PÃ©rez
475,486,102,1961,Stirling Moss,Jack Fairman,0,0,0,Jack Fairman
418,545,104,1960,Masten Gregory,Fred Gamble,0,0,0,Fred Gamble
498,589,105,1950,JosÃ© FroilÃ¡n GonzÃ¡lez,Louis Chiron,0,4,4,Louis Chiron
498,640,105,1950,JosÃ© FroilÃ¡n GonzÃ¡lez,Toulo de Graffenried,0,0,0,Toulo de Graffenried
498,669,105,1950,JosÃ© FroilÃ¡n GonzÃ¡lez,Prince Bira,0,5,5,Prince Bira
498,677,105,1950,JosÃ© FroilÃ¡n GonzÃ¡lez,Travis Webb,0,0,0,Travis Webb
498,686,105,1950,JosÃ© FroilÃ¡n GonzÃ¡lez,Reg Parnell,0,0,0,Reg Parnell
498,697,105,1950,JosÃ© FroilÃ¡n GonzÃ¡lez,Felice Bonetto,0,2,2,Felice Bonetto
498,731,105,1950,JosÃ© FroilÃ¡n GonzÃ¡lez,Henry Banks,0,0,0,Henry Banks
498,740,105,1950,JosÃ© FroilÃ¡n GonzÃ¡lez,Franco Comotti,0,0,0,Franco Comotti
498,747,105,1950,JosÃ© FroilÃ¡n GonzÃ¡lez,David Murray,0,0,0,David Murray
498,756,105,1950,JosÃ© FroilÃ¡n GonzÃ¡lez,Paul Pietsch,0,0,0,Paul Pietsch
498,762,105,1950,JosÃ© FroilÃ¡n GonzÃ¡lez,Franco Rol,0,0,0,Franco Rol
498,778,105,1950,JosÃ© FroilÃ¡n GonzÃ¡lez,Brian Shawe Taylor,0,0,0,Brian Shawe Taylor
498,780,105,1950,JosÃ© FroilÃ¡n GonzÃ¡lez,Toni Branca,0,0,0,Toni Branca
498,784,105,1950,JosÃ© FroilÃ¡n GonzÃ¡lez,David Hampshire,0,0,0,David Hampshire
498,788,105,1950,JosÃ© FroilÃ¡n GonzÃ¡lez,Joe Fry,0,0,0,Joe Fry
498,792,105,1950,JosÃ© FroilÃ¡n GonzÃ¡lez,Alfredo PiÃ¡n,0,0,0,Alfredo PiÃ¡n
498,800,105,1950,JosÃ© FroilÃ¡n GonzÃ¡lez,Nello Pagani,0,0,0,Nello Pagani
589,640,105,1950,Louis Chiron,Toulo de Graffenried,4,0,4,Louis Chiron
589,669,105,1950,Louis Chiron,Prince Bira,4,5,1,Prince Bira
589,677,105,1950,Louis Chiron,Travis Webb,4,0,4,Louis Chiron
589,686,105,1950,Louis Chiron,Reg Parnell,4,0,4,Louis Chiron
589,697,105,1950,Louis Chiron,Felice Bonetto,4,2,2,Louis Chiron
589,731,105,1950,Louis Chiron,Henry Banks,4,0,4,Louis Chiron
589,740,105,1950,Louis Chiron,Franco Comotti,4,0,4,Louis Chiron
589,747,105,1950,Louis Chiron,David Murray,4,0,4,Louis Chiron
589,756,105,1950,Louis Chiron,Paul Pietsch,4,0,4,Louis Chiron
589,762,105,1950,Louis Chiron,Franco Rol,4,0,4,Louis Chiron
589,778,105,1950,Louis Chiron,Brian Shawe Taylor,4,0,4,Louis Chiron
589,780,105,1950,Louis Chiron,Toni Branca,4,0,4,Louis Chiron
589,784,105,1950,Louis Chiron,David Hampshire,4,0,4,Louis Chiron
589,788,105,1950,Louis Chiron,Joe Fry,4,0,4,Louis Chiron
589,792,105,1950,Louis Chiron,Alfredo PiÃ¡n,4,0,4,Louis Chiron
589,800,105,1950,Louis Chiron,Nello Pagani,4,0,4,Louis Chiron
640,669,105,1950,Toulo de Graffenried,Prince Bira,0,5,5,Prince Bira
640,677,105,1950,Toulo de Graffenried,Travis Webb,0,0,0,Travis Webb
640,686,105,1950,Toulo de Graffenried,Reg Parnell,0,0,0,Reg Parnell
640,697,105,1950,Toulo de Graffenried,Felice Bonetto,0,2,2,Felice Bonetto
640,731,105,1950,Toulo de Graffenried,Henry Banks,0,0,0,Henry Banks
640,740,105,1950,Toulo de Graffenried,Franco Comotti,0,0,0,Franco Comotti
640,747,105,1950,Toulo de Graffenried,David Murray,0,0,0,David Murray
640,756,105,1950,Toulo de Graffenried,Paul Pietsch,0,0,0,Paul Pietsch
640,762,105,1950,Toulo de Graffenried,Franco Rol,0,0,0,Franco Rol
640,778,105,1950,Toulo de Graffenried,Brian Shawe Taylor,0,0,0,Brian Shawe Taylor
640,780,105,1950,Toulo de Graffenried,Toni Branca,0,0,0,Toni Branca
640,784,105,1950,Toulo de Graffenried,David Hampshire,0,0,0,David Hampshire
640,788,105,1950,Toulo de Graffenried,Joe Fry,0,0,0,Joe Fry
640,792,105,1950,Toulo de Graffenried,Alfredo PiÃ¡n,0,0,0,Alfredo PiÃ¡n
640,800,105,1950,Toulo de Graffenried,Nello Pagani,0,0,0,Nello Pagani
669,677,105,1950,Prince Bira,Travis Webb,5,0,5,Prince Bira
669,686,105,1950,Prince Bira,Reg Parnell,5,0,5,Prince Bira
669,697,105,1950,Prince Bira,Felice Bonetto,5,2,3,Prince Bira
669,731,105,1950,Prince Bira,Henry Banks,5,0,5,Prince Bira
669,740,105,1950,Prince Bira,Franco Comotti,5,0,5,Prince Bira
669,747,105,1950,Prince Bira,David Murray,5,0,5,Prince Bira
669,756,105,1950,Prince Bira,Paul Pietsch,5,0,5,Prince Bira
669,762,105,1950,Prince Bira,Franco Rol,5,0,5,Prince Bira
669,778,105,1950,Prince Bira,Brian Shawe Taylor,5,0,5,Prince Bira
669,780,105,1950,Prince Bira,Toni Branca,5,0,5,Prince Bira
669,784,105,1950,Prince Bira,David Hampshire,5,0,5,Prince Bira
669,788,105,1950,Prince Bira,Joe Fry,5,0,5,Prince Bira
669,792,105,1950,Prince Bira,Alfredo PiÃ¡n,5,0,5,Prince Bira
669,800,105,1950,Prince Bira,Nello Pagani,5,0,5,Prince Bira
677,686,105,1950,Travis Webb,Reg Parnell,0,0,0,Reg Parnell
677,697,105,1950,Travis Webb,Felice Bonetto,0,2,2,Felice Bonetto
677,731,105,1950,Travis Webb,Henry Banks,0,0,0,Henry Banks
677,740,105,1950,Travis Webb,Franco Comotti,0,0,0,Franco Comotti
677,747,105,1950,Travis Webb,David Murray,0,0,0,David Murray
677,756,105,1950,Travis Webb,Paul Pietsch,0,0,0,Paul Pietsch
677,762,105,1950,Travis Webb,Franco Rol,0,0,0,Franco Rol
677,778,105,1950,Travis Webb,Brian Shawe Taylor,0,0,0,Brian Shawe Taylor
677,780,105,1950,Travis Webb,Toni Branca,0,0,0,Toni Branca
677,784,105,1950,Travis Webb,David Hampshire,0,0,0,David Hampshire
677,788,105,1950,Travis Webb,Joe Fry,0,0,0,Joe Fry
677,792,105,1950,Travis Webb,Alfredo PiÃ¡n,0,0,0,Alfredo PiÃ¡n
677,800,105,1950,Travis Webb,Nello Pagani,0,0,0,Nello Pagani
686,697,105,1950,Reg Parnell,Felice Bonetto,0,2,2,Felice Bonetto
686,731,105,1950,Reg Parnell,Henry Banks,0,0,0,Henry Banks
686,740,105,1950,Reg Parnell,Franco Comotti,0,0,0,Franco Comotti
686,747,105,1950,Reg Parnell,David Murray,0,0,0,David Murray
686,756,105,1950,Reg Parnell,Paul Pietsch,0,0,0,Paul Pietsch
686,762,105,1950,Reg Parnell,Franco Rol,0,0,0,Franco Rol
686,778,105,1950,Reg Parnell,Brian Shawe Taylor,0,0,0,Brian Shawe Taylor
686,780,105,1950,Reg Parnell,Toni Branca,0,0,0,Toni Branca
686,784,105,1950,Reg Parnell,David Hampshire,0,0,0,David Hampshire
686,788,105,1950,Reg Parnell,Joe Fry,0,0,0,Joe Fry
686,792,105,1950,Reg Parnell,Alfredo PiÃ¡n,0,0,0,Alfredo PiÃ¡n
686,800,105,1950,Reg Parnell,Nello Pagani,0,0,0,Nello Pagani
697,731,105,1950,Felice Bonetto,Henry Banks,2,0,2,Felice Bonetto
697,740,105,1950,Felice Bonetto,Franco Comotti,2,0,2,Felice Bonetto
697,747,105,1950,Felice Bonetto,David Murray,2,0,2,Felice Bonetto
697,756,105,1950,Felice Bonetto,Paul Pietsch,2,0,2,Felice Bonetto
697,762,105,1950,Felice Bonetto,Franco Rol,2,0,2,Felice Bonetto
697,778,105,1950,Felice Bonetto,Brian Shawe Taylor,2,0,2,Felice Bonetto
697,780,105,1950,Felice Bonetto,Toni Branca,2,0,2,Felice Bonetto
697,784,105,1950,Felice Bonetto,David Hampshire,2,0,2,Felice Bonetto
697,788,105,1950,Felice Bonetto,Joe Fry,2,0,2,Felice Bonetto
697,792,105,1950,Felice Bonetto,Alfredo PiÃ¡n,2,0,2,Felice Bonetto
697,800,105,1950,Felice Bonetto,Nello Pagani,2,0,2,Felice Bonetto
731,740,105,1950,Henry Banks,Franco Comotti,0,0,0,Franco Comotti
731,747,105,1950,Henry Banks,David Murray,0,0,0,David Murray
731,756,105,1950,Henry Banks,Paul Pietsch,0,0,0,Paul Pietsch
731,762,105,1950,Henry Banks,Franco Rol,0,0,0,Franco Rol
731,778,105,1950,Henry Banks,Brian Shawe Taylor,0,0,0,Brian Shawe Taylor
731,780,105,1950,Henry Banks,Toni Branca,0,0,0,Toni Branca
731,784,105,1950,Henry Banks,David Hampshire,0,0,0,David Hampshire
731,788,105,1950,Henry Banks,Joe Fry,0,0,0,Joe Fry
731,792,105,1950,Henry Banks,Alfredo PiÃ¡n,0,0,0,Alfredo PiÃ¡n
731,800,105,1950,Henry Banks,Nello Pagani,0,0,0,Nello Pagani
740,747,105,1950,Franco Comotti,David Murray,0,0,0,David Murray
740,756,105,1950,Franco Comotti,Paul Pietsch,0,0,0,Paul Pietsch
740,762,105,1950,Franco Comotti,Franco Rol,0,0,0,Franco Rol
740,778,105,1950,Franco Comotti,Brian Shawe Taylor,0,0,0,Brian Shawe Taylor
740,780,105,1950,Franco Comotti,Toni Branca,0,0,0,Toni Branca
740,784,105,1950,Franco Comotti,David Hampshire,0,0,0,David Hampshire
740,788,105,1950,Franco Comotti,Joe Fry,0,0,0,Joe Fry
740,792,105,1950,Franco Comotti,Alfredo PiÃ¡n,0,0,0,Alfredo PiÃ¡n
740,800,105,1950,Franco Comotti,Nello Pagani,0,0,0,Nello Pagani
747,756,105,1950,David Murray,Paul Pietsch,0,0,0,Paul Pietsch
747,762,105,1950,David Murray,Franco Rol,0,0,0,Franco Rol
747,778,105,1950,David Murray,Brian Shawe Taylor,0,0,0,Brian Shawe Taylor
747,780,105,1950,David Murray,Toni Branca,0,0,0,Toni Branca
747,784,105,1950,David Murray,David Hampshire,0,0,0,David Hampshire
747,788,105,1950,David Murray,Joe Fry,0,0,0,Joe Fry
747,792,105,1950,David Murray,Alfredo PiÃ¡n,0,0,0,Alfredo PiÃ¡n
747,800,105,1950,David Murray,Nello Pagani,0,0,0,Nello Pagani
756,762,105,1950,Paul Pietsch,Franco Rol,0,0,0,Franco Rol
756,778,105,1950,Paul Pietsch,Brian Shawe Taylor,0,0,0,Brian Shawe Taylor
756,780,105,1950,Paul Pietsch,Toni Branca,0,0,0,Toni Branca
756,784,105,1950,Paul Pietsch,David Hampshire,0,0,0,David Hampshire
756,788,105,1950,Paul Pietsch,Joe Fry,0,0,0,Joe Fry
756,792,105,1950,Paul Pietsch,Alfredo PiÃ¡n,0,0,0,Alfredo PiÃ¡n
756,800,105,1950,Paul Pietsch,Nello Pagani,0,0,0,Nello Pagani
762,778,105,1950,Franco Rol,Brian Shawe Taylor,0,0,0,Brian Shawe Taylor
762,780,105,1950,Franco Rol,Toni Branca,0,0,0,Toni Branca
762,784,105,1950,Franco Rol,David Hampshire,0,0,0,David Hampshire
762,788,105,1950,Franco Rol,Joe Fry,0,0,0,Joe Fry
762,792,105,1950,Franco Rol,Alfredo PiÃ¡n,0,0,0,Alfredo PiÃ¡n
762,800,105,1950,Franco Rol,Nello Pagani,0,0,0,Nello Pagani
778,780,105,1950,Brian Shawe Taylor,Toni Branca,0,0,0,Toni Branca
778,784,105,1950,Brian Shawe Taylor,David Hampshire,0,0,0,David Hampshire
778,788,105,1950,Brian Shawe Taylor,Joe Fry,0,0,0,Joe Fry
778,792,105,1950,Brian Shawe Taylor,Alfredo PiÃ¡n,0,0,0,Alfredo PiÃ¡n
778,800,105,1950,Brian Shawe Taylor,Nello Pagani,0,0,0,Nello Pagani
780,784,105,1950,Toni Branca,David Hampshire,0,0,0,David Hampshire
780,788,105,1950,Toni Branca,Joe Fry,0,0,0,Joe Fry
780,792,105,1950,Toni Branca,Alfredo PiÃ¡n,0,0,0,Alfredo PiÃ¡n
780,800,105,1950,Toni Branca,Nello Pagani,0,0,0,Nello Pagani
784,788,105,1950,David Hampshire,Joe Fry,0,0,0,Joe Fry
784,792,105,1950,David Hampshire,Alfredo PiÃ¡n,0,0,0,Alfredo PiÃ¡n
784,800,105,1950,David Hampshire,Nello Pagani,0,0,0,Nello Pagani
788,792,105,1950,Joe Fry,Alfredo PiÃ¡n,0,0,0,Alfredo PiÃ¡n
788,800,105,1950,Joe Fry,Nello Pagani,0,0,0,Nello Pagani
792,800,105,1950,Alfredo PiÃ¡n,Nello Pagani,0,0,0,Nello Pagani
501,580,105,1951,Harry Schell,Paco Godia,0,0,0,Paco Godia
501,589,105,1951,Harry Schell,Louis Chiron,0,0,0,Louis Chiron
501,640,105,1951,Harry Schell,Toulo de Graffenried,0,0,0,Toulo de Graffenried
501,669,105,1951,Harry Schell,Prince Bira,0,0,0,Prince Bira
501,670,105,1951,Harry Schell,Onofre MarimÃ³n,0,0,0,Onofre MarimÃ³n
501,732,105,1951,Harry Schell,Johnny McDowell,0,0,0,Johnny McDowell
501,747,105,1951,Harry Schell,David Murray,0,0,0,David Murray
501,777,105,1951,Harry Schell,Philip Fotheringham-Parker,0,0,0,Philip Fotheringham-Parker
501,779,105,1951,Harry Schell,John James,0,0,0,John James
501,780,105,1951,Harry Schell,Toni Branca,0,0,0,Toni Branca
501,782,105,1951,Harry Schell,Juan Jover,0,0,0,Juan Jover
580,589,105,1951,Paco Godia,Louis Chiron,0,0,0,Louis Chiron
580,640,105,1951,Paco Godia,Toulo de Graffenried,0,0,0,Toulo de Graffenried
580,669,105,1951,Paco Godia,Prince Bira,0,0,0,Prince Bira
580,670,105,1951,Paco Godia,Onofre MarimÃ³n,0,0,0,Onofre MarimÃ³n
580,732,105,1951,Paco Godia,Johnny McDowell,0,0,0,Johnny McDowell
580,747,105,1951,Paco Godia,David Murray,0,0,0,David Murray
580,777,105,1951,Paco Godia,Philip Fotheringham-Parker,0,0,0,Philip Fotheringham-Parker
580,779,105,1951,Paco Godia,John James,0,0,0,John James
580,780,105,1951,Paco Godia,Toni Branca,0,0,0,Toni Branca
580,782,105,1951,Paco Godia,Juan Jover,0,0,0,Juan Jover
589,640,105,1951,Louis Chiron,Toulo de Graffenried,0,0,0,Toulo de Graffenried
589,669,105,1951,Louis Chiron,Prince Bira,0,0,0,Prince Bira
589,670,105,1951,Louis Chiron,Onofre MarimÃ³n,0,0,0,Onofre MarimÃ³n
589,732,105,1951,Louis Chiron,Johnny McDowell,0,0,0,Johnny McDowell
589,747,105,1951,Louis Chiron,David Murray,0,0,0,David Murray
589,777,105,1951,Louis Chiron,Philip Fotheringham-Parker,0,0,0,Philip Fotheringham-Parker
589,779,105,1951,Louis Chiron,John James,0,0,0,John James
589,780,105,1951,Louis Chiron,Toni Branca,0,0,0,Toni Branca
589,782,105,1951,Louis Chiron,Juan Jover,0,0,0,Juan Jover
640,669,105,1951,Toulo de Graffenried,Prince Bira,0,0,0,Prince Bira
640,670,105,1951,Toulo de Graffenried,Onofre MarimÃ³n,0,0,0,Onofre MarimÃ³n
640,732,105,1951,Toulo de Graffenried,Johnny McDowell,0,0,0,Johnny McDowell
640,747,105,1951,Toulo de Graffenried,David Murray,0,0,0,David Murray
640,777,105,1951,Toulo de Graffenried,Philip Fotheringham-Parker,0,0,0,Philip Fotheringham-Parker
640,779,105,1951,Toulo de Graffenried,John James,0,0,0,John James
640,780,105,1951,Toulo de Graffenried,Toni Branca,0,0,0,Toni Branca
640,782,105,1951,Toulo de Graffenried,Juan Jover,0,0,0,Juan Jover
669,670,105,1951,Prince Bira,Onofre MarimÃ³n,0,0,0,Onofre MarimÃ³n
669,732,105,1951,Prince Bira,Johnny McDowell,0,0,0,Johnny McDowell
669,747,105,1951,Prince Bira,David Murray,0,0,0,David Murray
669,777,105,1951,Prince Bira,Philip Fotheringham-Parker,0,0,0,Philip Fotheringham-Parker
669,779,105,1951,Prince Bira,John James,0,0,0,John James
669,780,105,1951,Prince Bira,Toni Branca,0,0,0,Toni Branca
669,782,105,1951,Prince Bira,Juan Jover,0,0,0,Juan Jover
670,732,105,1951,Onofre MarimÃ³n,Johnny McDowell,0,0,0,Johnny McDowell
670,747,105,1951,Onofre MarimÃ³n,David Murray,0,0,0,David Murray
670,777,105,1951,Onofre MarimÃ³n,Philip Fotheringham-Parker,0,0,0,Philip Fotheringham-Parker
670,779,105,1951,Onofre MarimÃ³n,John James,0,0,0,John James
670,780,105,1951,Onofre MarimÃ³n,Toni Branca,0,0,0,Toni Branca
670,782,105,1951,Onofre MarimÃ³n,Juan Jover,0,0,0,Juan Jover
732,747,105,1951,Johnny McDowell,David Murray,0,0,0,David Murray
732,777,105,1951,Johnny McDowell,Philip Fotheringham-Parker,0,0,0,Philip Fotheringham-Parker
732,779,105,1951,Johnny McDowell,John James,0,0,0,John James
732,780,105,1951,Johnny McDowell,Toni Branca,0,0,0,Toni Branca
732,782,105,1951,Johnny McDowell,Juan Jover,0,0,0,Juan Jover
747,777,105,1951,David Murray,Philip Fotheringham-Parker,0,0,0,Philip Fotheringham-Parker
747,779,105,1951,David Murray,John James,0,0,0,John James
747,780,105,1951,David Murray,Toni Branca,0,0,0,Toni Branca
747,782,105,1951,David Murray,Juan Jover,0,0,0,Juan Jover
777,779,105,1951,Philip Fotheringham-Parker,John James,0,0,0,John James
777,780,105,1951,Philip Fotheringham-Parker,Toni Branca,0,0,0,Toni Branca
777,782,105,1951,Philip Fotheringham-Parker,Juan Jover,0,0,0,Juan Jover
779,780,105,1951,John James,Toni Branca,0,0,0,Toni Branca
779,782,105,1951,John James,Juan Jover,0,0,0,Juan Jover
780,782,105,1951,Toni Branca,Juan Jover,0,0,0,Juan Jover
498,501,105,1952,JosÃ© FroilÃ¡n GonzÃ¡lez,Harry Schell,6,0,6,JosÃ© FroilÃ¡n GonzÃ¡lez
498,622,105,1952,JosÃ© FroilÃ¡n GonzÃ¡lez,Chico Landi,6,0,6,JosÃ© FroilÃ¡n GonzÃ¡lez
498,640,105,1952,JosÃ© FroilÃ¡n GonzÃ¡lez,Toulo de Graffenried,6,0,6,JosÃ© FroilÃ¡n GonzÃ¡lez
498,697,105,1952,JosÃ© FroilÃ¡n GonzÃ¡lez,Felice Bonetto,6,2,4,JosÃ© FroilÃ¡n GonzÃ¡lez
498,741,105,1952,JosÃ© FroilÃ¡n GonzÃ¡lez,Philippe Ã‰tancelin,6,0,6,JosÃ© FroilÃ¡n GonzÃ¡lez
498,746,105,1952,JosÃ© FroilÃ¡n GonzÃ¡lez,Gino Bianco,6,0,6,JosÃ© FroilÃ¡n GonzÃ¡lez
498,748,105,1952,JosÃ© FroilÃ¡n GonzÃ¡lez,Eitel Cantoni,6,0,6,JosÃ© FroilÃ¡n GonzÃ¡lez
498,759,105,1952,JosÃ© FroilÃ¡n GonzÃ¡lez,Jan Flinterman,6,0,6,JosÃ© FroilÃ¡n GonzÃ¡lez
498,761,105,1952,JosÃ© FroilÃ¡n GonzÃ¡lez,Alberto Crespo,6,0,6,JosÃ© FroilÃ¡n GonzÃ¡lez
498,762,105,1952,JosÃ© FroilÃ¡n GonzÃ¡lez,Franco Rol,6,0,6,JosÃ© FroilÃ¡n GonzÃ¡lez
501,622,105,1952,Harry Schell,Chico Landi,0,0,0,Chico Landi
501,640,105,1952,Harry Schell,Toulo de Graffenried,0,0,0,Toulo de Graffenried
501,697,105,1952,Harry Schell,Felice Bonetto,0,2,2,Felice Bonetto
501,741,105,1952,Harry Schell,Philippe Ã‰tancelin,0,0,0,Philippe Ã‰tancelin
501,746,105,1952,Harry Schell,Gino Bianco,0,0,0,Gino Bianco
501,748,105,1952,Harry Schell,Eitel Cantoni,0,0,0,Eitel Cantoni
501,759,105,1952,Harry Schell,Jan Flinterman,0,0,0,Jan Flinterman
501,761,105,1952,Harry Schell,Alberto Crespo,0,0,0,Alberto Crespo
501,762,105,1952,Harry Schell,Franco Rol,0,0,0,Franco Rol
622,640,105,1952,Chico Landi,Toulo de Graffenried,0,0,0,Toulo de Graffenried
622,697,105,1952,Chico Landi,Felice Bonetto,0,2,2,Felice Bonetto
622,741,105,1952,Chico Landi,Philippe Ã‰tancelin,0,0,0,Philippe Ã‰tancelin
622,746,105,1952,Chico Landi,Gino Bianco,0,0,0,Gino Bianco
622,748,105,1952,Chico Landi,Eitel Cantoni,0,0,0,Eitel Cantoni
622,759,105,1952,Chico Landi,Jan Flinterman,0,0,0,Jan Flinterman
622,761,105,1952,Chico Landi,Alberto Crespo,0,0,0,Alberto Crespo
622,762,105,1952,Chico Landi,Franco Rol,0,0,0,Franco Rol
640,697,105,1952,Toulo de Graffenried,Felice Bonetto,0,2,2,Felice Bonetto
640,741,105,1952,Toulo de Graffenried,Philippe Ã‰tancelin,0,0,0,Philippe Ã‰tancelin
640,746,105,1952,Toulo de Graffenried,Gino Bianco,0,0,0,Gino Bianco
640,748,105,1952,Toulo de Graffenried,Eitel Cantoni,0,0,0,Eitel Cantoni
640,759,105,1952,Toulo de Graffenried,Jan Flinterman,0,0,0,Jan Flinterman
640,761,105,1952,Toulo de Graffenried,Alberto Crespo,0,0,0,Alberto Crespo
640,762,105,1952,Toulo de Graffenried,Franco Rol,0,0,0,Franco Rol
697,741,105,1952,Felice Bonetto,Philippe Ã‰tancelin,2,0,2,Felice Bonetto
697,746,105,1952,Felice Bonetto,Gino Bianco,2,0,2,Felice Bonetto
697,748,105,1952,Felice Bonetto,Eitel Cantoni,2,0,2,Felice Bonetto
697,759,105,1952,Felice Bonetto,Jan Flinterman,2,0,2,Felice Bonetto
697,761,105,1952,Felice Bonetto,Alberto Crespo,2,0,2,Felice Bonetto
697,762,105,1952,Felice Bonetto,Franco Rol,2,0,2,Felice Bonetto
741,746,105,1952,Philippe Ã‰tancelin,Gino Bianco,0,0,0,Gino Bianco
741,748,105,1952,Philippe Ã‰tancelin,Eitel Cantoni,0,0,0,Eitel Cantoni
741,759,105,1952,Philippe Ã‰tancelin,Jan Flinterman,0,0,0,Jan Flinterman
741,761,105,1952,Philippe Ã‰tancelin,Alberto Crespo,0,0,0,Alberto Crespo
741,762,105,1952,Philippe Ã‰tancelin,Franco Rol,0,0,0,Franco Rol
746,748,105,1952,Gino Bianco,Eitel Cantoni,0,0,0,Eitel Cantoni
746,759,105,1952,Gino Bianco,Jan Flinterman,0,0,0,Jan Flinterman
746,761,105,1952,Gino Bianco,Alberto Crespo,0,0,0,Alberto Crespo
746,762,105,1952,Gino Bianco,Franco Rol,0,0,0,Franco Rol
748,759,105,1952,Eitel Cantoni,Jan Flinterman,0,0,0,Jan Flinterman
748,761,105,1952,Eitel Cantoni,Alberto Crespo,0,0,0,Alberto Crespo
748,762,105,1952,Eitel Cantoni,Franco Rol,0,0,0,Franco Rol
759,761,105,1952,Jan Flinterman,Alberto Crespo,0,0,0,Alberto Crespo
759,762,105,1952,Jan Flinterman,Franco Rol,0,0,0,Franco Rol
761,762,105,1952,Alberto Crespo,Franco Rol,0,0,0,Franco Rol
498,577,105,1953,JosÃ© FroilÃ¡n GonzÃ¡lez,Luigi Musso,15,0,15,JosÃ© FroilÃ¡n GonzÃ¡lez
498,579,105,1953,JosÃ© FroilÃ¡n GonzÃ¡lez,Juan Fangio,15,30,15,Juan Fangio
498,622,105,1953,JosÃ© FroilÃ¡n GonzÃ¡lez,Chico Landi,15,0,15,JosÃ© FroilÃ¡n GonzÃ¡lez
498,640,105,1953,JosÃ© FroilÃ¡n GonzÃ¡lez,Toulo de Graffenried,15,7,8,JosÃ© FroilÃ¡n GonzÃ¡lez
498,644,105,1953,JosÃ© FroilÃ¡n GonzÃ¡lez,Sergio Mantovani,15,0,15,JosÃ© FroilÃ¡n GonzÃ¡lez
498,660,105,1953,JosÃ© FroilÃ¡n GonzÃ¡lez,Johnny Claes,15,0,15,JosÃ© FroilÃ¡n GonzÃ¡lez
498,669,105,1953,JosÃ© FroilÃ¡n GonzÃ¡lez,Prince Bira,15,0,15,JosÃ© FroilÃ¡n GonzÃ¡lez
498,670,105,1953,JosÃ© FroilÃ¡n GonzÃ¡lez,Onofre MarimÃ³n,15,4,11,JosÃ© FroilÃ¡n GonzÃ¡lez
498,691,105,1953,JosÃ© FroilÃ¡n GonzÃ¡lez,Hermann Lang,15,2,13,JosÃ© FroilÃ¡n GonzÃ¡lez
498,695,105,1953,JosÃ© FroilÃ¡n GonzÃ¡lez,Oscar GÃ¡lvez,15,2,13,JosÃ© FroilÃ¡n GonzÃ¡lez
498,697,105,1953,JosÃ© FroilÃ¡n GonzÃ¡lez,Felice Bonetto,15,7,8,JosÃ© FroilÃ¡n GonzÃ¡lez
577,579,105,1953,Luigi Musso,Juan Fangio,0,30,30,Juan Fangio
577,622,105,1953,Luigi Musso,Chico Landi,0,0,0,Chico Landi
577,640,105,1953,Luigi Musso,Toulo de Graffenried,0,7,7,Toulo de Graffenried
577,644,105,1953,Luigi Musso,Sergio Mantovani,0,0,0,Sergio Mantovani
577,660,105,1953,Luigi Musso,Johnny Claes,0,0,0,Johnny Claes
577,669,105,1953,Luigi Musso,Prince Bira,0,0,0,Prince Bira
577,670,105,1953,Luigi Musso,Onofre MarimÃ³n,0,4,4,Onofre MarimÃ³n
577,691,105,1953,Luigi Musso,Hermann Lang,0,2,2,Hermann Lang
577,695,105,1953,Luigi Musso,Oscar GÃ¡lvez,0,2,2,Oscar GÃ¡lvez
577,697,105,1953,Luigi Musso,Felice Bonetto,0,7,7,Felice Bonetto
579,622,105,1953,Juan Fangio,Chico Landi,30,0,30,Juan Fangio
579,640,105,1953,Juan Fangio,Toulo de Graffenried,30,7,23,Juan Fangio
579,644,105,1953,Juan Fangio,Sergio Mantovani,30,0,30,Juan Fangio
579,660,105,1953,Juan Fangio,Johnny Claes,30,0,30,Juan Fangio
579,669,105,1953,Juan Fangio,Prince Bira,30,0,30,Juan Fangio
579,670,105,1953,Juan Fangio,Onofre MarimÃ³n,30,4,26,Juan Fangio
579,691,105,1953,Juan Fangio,Hermann Lang,30,2,28,Juan Fangio
579,695,105,1953,Juan Fangio,Oscar GÃ¡lvez,30,2,28,Juan Fangio
579,697,105,1953,Juan Fangio,Felice Bonetto,30,7,23,Juan Fangio
622,640,105,1953,Chico Landi,Toulo de Graffenried,0,7,7,Toulo de Graffenried
622,644,105,1953,Chico Landi,Sergio Mantovani,0,0,0,Sergio Mantovani
622,660,105,1953,Chico Landi,Johnny Claes,0,0,0,Johnny Claes
622,669,105,1953,Chico Landi,Prince Bira,0,0,0,Prince Bira
622,670,105,1953,Chico Landi,Onofre MarimÃ³n,0,4,4,Onofre MarimÃ³n
622,691,105,1953,Chico Landi,Hermann Lang,0,2,2,Hermann Lang
622,695,105,1953,Chico Landi,Oscar GÃ¡lvez,0,2,2,Oscar GÃ¡lvez
622,697,105,1953,Chico Landi,Felice Bonetto,0,7,7,Felice Bonetto
640,644,105,1953,Toulo de Graffenried,Sergio Mantovani,7,0,7,Toulo de Graffenried
640,660,105,1953,Toulo de Graffenried,Johnny Claes,7,0,7,Toulo de Graffenried
640,669,105,1953,Toulo de Graffenried,Prince Bira,7,0,7,Toulo de Graffenried
640,670,105,1953,Toulo de Graffenried,Onofre MarimÃ³n,7,4,3,Toulo de Graffenried
640,691,105,1953,Toulo de Graffenried,Hermann Lang,7,2,5,Toulo de Graffenried
640,695,105,1953,Toulo de Graffenried,Oscar GÃ¡lvez,7,2,5,Toulo de Graffenried
640,697,105,1953,Toulo de Graffenried,Felice Bonetto,7,7,0,Felice Bonetto
644,660,105,1953,Sergio Mantovani,Johnny Claes,0,0,0,Johnny Claes
644,669,105,1953,Sergio Mantovani,Prince Bira,0,0,0,Prince Bira
644,670,105,1953,Sergio Mantovani,Onofre MarimÃ³n,0,4,4,Onofre MarimÃ³n
644,691,105,1953,Sergio Mantovani,Hermann Lang,0,2,2,Hermann Lang
644,695,105,1953,Sergio Mantovani,Oscar GÃ¡lvez,0,2,2,Oscar GÃ¡lvez
644,697,105,1953,Sergio Mantovani,Felice Bonetto,0,7,7,Felice Bonetto
660,669,105,1953,Johnny Claes,Prince Bira,0,0,0,Prince Bira
660,670,105,1953,Johnny Claes,Onofre MarimÃ³n,0,4,4,Onofre MarimÃ³n
660,691,105,1953,Johnny Claes,Hermann Lang,0,2,2,Hermann Lang
660,695,105,1953,Johnny Claes,Oscar GÃ¡lvez,0,2,2,Oscar GÃ¡lvez
660,697,105,1953,Johnny Claes,Felice Bonetto,0,7,7,Felice Bonetto
669,670,105,1953,Prince Bira,Onofre MarimÃ³n,0,4,4,Onofre MarimÃ³n
669,691,105,1953,Prince Bira,Hermann Lang,0,2,2,Hermann Lang
669,695,105,1953,Prince Bira,Oscar GÃ¡lvez,0,2,2,Oscar GÃ¡lvez
669,697,105,1953,Prince Bira,Felice Bonetto,0,7,7,Felice Bonetto
670,691,105,1953,Onofre MarimÃ³n,Hermann Lang,4,2,2,Onofre MarimÃ³n
670,695,105,1953,Onofre MarimÃ³n,Oscar GÃ¡lvez,4,2,2,Onofre MarimÃ³n
670,697,105,1953,Onofre MarimÃ³n,Felice Bonetto,4,7,3,Felice Bonetto
691,695,105,1953,Hermann Lang,Oscar GÃ¡lvez,2,2,0,Oscar GÃ¡lvez
691,697,105,1953,Hermann Lang,Felice Bonetto,2,7,5,Felice Bonetto
695,697,105,1953,Oscar GÃ¡lvez,Felice Bonetto,2,7,5,Felice Bonetto
456,475,105,1954,Roy Salvadori,Stirling Moss,0,4,4,Stirling Moss
456,496,105,1954,Roy Salvadori,Carlos Menditeguy,0,0,0,Carlos Menditeguy
456,501,105,1954,Roy Salvadori,Harry Schell,0,0,0,Harry Schell
456,541,105,1954,Roy Salvadori,Ron Flockhart,0,0,0,Ron Flockhart
456,577,105,1954,Roy Salvadori,Luigi Musso,0,6,6,Luigi Musso
456,579,105,1954,Roy Salvadori,Juan Fangio,0,17,17,Juan Fangio
456,580,105,1954,Roy Salvadori,Paco Godia,0,0,0,Paco Godia
456,627,105,1954,Roy Salvadori,Louis Rosier,0,0,0,Louis Rosier
456,633,105,1954,Roy Salvadori,Luigi Villoresi,0,2,2,Luigi Villoresi
456,638,105,1954,Roy Salvadori,Ottorino Volonterio,0,0,0,Ottorino Volonterio
456,640,105,1954,Roy Salvadori,Toulo de Graffenried,0,0,0,Toulo de Graffenried
456,643,105,1954,Roy Salvadori,Roberto Mieres,0,6,6,Roberto Mieres
456,644,105,1954,Roy Salvadori,Sergio Mantovani,0,4,4,Sergio Mantovani
456,647,105,1954,Roy Salvadori,Alberto Ascari,0,0,0,Alberto Ascari
456,663,105,1954,Roy Salvadori,Ken Wharton,0,0,0,Ken Wharton
456,669,105,1954,Roy Salvadori,Prince Bira,0,3,3,Prince Bira
456,670,105,1954,Roy Salvadori,Onofre MarimÃ³n,0,4,4,Onofre MarimÃ³n
456,672,105,1954,Roy Salvadori,Jorge Daponte,0,0,0,Jorge Daponte
456,694,105,1954,Roy Salvadori,Giovanni de Riu,0,0,0,Giovanni de Riu
475,496,105,1954,Stirling Moss,Carlos Menditeguy,4,0,4,Stirling Moss
475,501,105,1954,Stirling Moss,Harry Schell,4,0,4,Stirling Moss
475,541,105,1954,Stirling Moss,Ron Flockhart,4,0,4,Stirling Moss
475,577,105,1954,Stirling Moss,Luigi Musso,4,6,2,Luigi Musso
475,579,105,1954,Stirling Moss,Juan Fangio,4,17,13,Juan Fangio
475,580,105,1954,Stirling Moss,Paco Godia,4,0,4,Stirling Moss
475,627,105,1954,Stirling Moss,Louis Rosier,4,0,4,Stirling Moss
475,633,105,1954,Stirling Moss,Luigi Villoresi,4,2,2,Stirling Moss
475,638,105,1954,Stirling Moss,Ottorino Volonterio,4,0,4,Stirling Moss
475,640,105,1954,Stirling Moss,Toulo de Graffenried,4,0,4,Stirling Moss
475,643,105,1954,Stirling Moss,Roberto Mieres,4,6,2,Roberto Mieres
475,644,105,1954,Stirling Moss,Sergio Mantovani,4,4,0,Sergio Mantovani
475,647,105,1954,Stirling Moss,Alberto Ascari,4,0,4,Stirling Moss
475,663,105,1954,Stirling Moss,Ken Wharton,4,0,4,Stirling Moss
475,669,105,1954,Stirling Moss,Prince Bira,4,3,1,Stirling Moss
475,670,105,1954,Stirling Moss,Onofre MarimÃ³n,4,4,0,Onofre MarimÃ³n
475,672,105,1954,Stirling Moss,Jorge Daponte,4,0,4,Stirling Moss
475,694,105,1954,Stirling Moss,Giovanni de Riu,4,0,4,Stirling Moss
496,501,105,1954,Carlos Menditeguy,Harry Schell,0,0,0,Harry Schell
496,541,105,1954,Carlos Menditeguy,Ron Flockhart,0,0,0,Ron Flockhart
496,577,105,1954,Carlos Menditeguy,Luigi Musso,0,6,6,Luigi Musso
496,579,105,1954,Carlos Menditeguy,Juan Fangio,0,17,17,Juan Fangio
496,580,105,1954,Carlos Menditeguy,Paco Godia,0,0,0,Paco Godia
496,627,105,1954,Carlos Menditeguy,Louis Rosier,0,0,0,Louis Rosier
496,633,105,1954,Carlos Menditeguy,Luigi Villoresi,0,2,2,Luigi Villoresi
496,638,105,1954,Carlos Menditeguy,Ottorino Volonterio,0,0,0,Ottorino Volonterio
496,640,105,1954,Carlos Menditeguy,Toulo de Graffenried,0,0,0,Toulo de Graffenried
496,643,105,1954,Carlos Menditeguy,Roberto Mieres,0,6,6,Roberto Mieres
496,644,105,1954,Carlos Menditeguy,Sergio Mantovani,0,4,4,Sergio Mantovani
496,647,105,1954,Carlos Menditeguy,Alberto Ascari,0,0,0,Alberto Ascari
496,663,105,1954,Carlos Menditeguy,Ken Wharton,0,0,0,Ken Wharton
496,669,105,1954,Carlos Menditeguy,Prince Bira,0,3,3,Prince Bira
496,670,105,1954,Carlos Menditeguy,Onofre MarimÃ³n,0,4,4,Onofre MarimÃ³n
496,672,105,1954,Carlos Menditeguy,Jorge Daponte,0,0,0,Jorge Daponte
496,694,105,1954,Carlos Menditeguy,Giovanni de Riu,0,0,0,Giovanni de Riu
501,541,105,1954,Harry Schell,Ron Flockhart,0,0,0,Ron Flockhart
501,577,105,1954,Harry Schell,Luigi Musso,0,6,6,Luigi Musso
501,579,105,1954,Harry Schell,Juan Fangio,0,17,17,Juan Fangio
501,580,105,1954,Harry Schell,Paco Godia,0,0,0,Paco Godia
501,627,105,1954,Harry Schell,Louis Rosier,0,0,0,Louis Rosier
501,633,105,1954,Harry Schell,Luigi Villoresi,0,2,2,Luigi Villoresi
501,638,105,1954,Harry Schell,Ottorino Volonterio,0,0,0,Ottorino Volonterio
501,640,105,1954,Harry Schell,Toulo de Graffenried,0,0,0,Toulo de Graffenried
501,643,105,1954,Harry Schell,Roberto Mieres,0,6,6,Roberto Mieres
501,644,105,1954,Harry Schell,Sergio Mantovani,0,4,4,Sergio Mantovani
501,647,105,1954,Harry Schell,Alberto Ascari,0,0,0,Alberto Ascari
501,663,105,1954,Harry Schell,Ken Wharton,0,0,0,Ken Wharton
501,669,105,1954,Harry Schell,Prince Bira,0,3,3,Prince Bira
501,670,105,1954,Harry Schell,Onofre MarimÃ³n,0,4,4,Onofre MarimÃ³n
501,672,105,1954,Harry Schell,Jorge Daponte,0,0,0,Jorge Daponte
501,694,105,1954,Harry Schell,Giovanni de Riu,0,0,0,Giovanni de Riu
541,577,105,1954,Ron Flockhart,Luigi Musso,0,6,6,Luigi Musso
541,579,105,1954,Ron Flockhart,Juan Fangio,0,17,17,Juan Fangio
541,580,105,1954,Ron Flockhart,Paco Godia,0,0,0,Paco Godia
541,627,105,1954,Ron Flockhart,Louis Rosier,0,0,0,Louis Rosier
541,633,105,1954,Ron Flockhart,Luigi Villoresi,0,2,2,Luigi Villoresi
541,638,105,1954,Ron Flockhart,Ottorino Volonterio,0,0,0,Ottorino Volonterio
541,640,105,1954,Ron Flockhart,Toulo de Graffenried,0,0,0,Toulo de Graffenried
541,643,105,1954,Ron Flockhart,Roberto Mieres,0,6,6,Roberto Mieres
541,644,105,1954,Ron Flockhart,Sergio Mantovani,0,4,4,Sergio Mantovani
541,647,105,1954,Ron Flockhart,Alberto Ascari,0,0,0,Alberto Ascari
541,663,105,1954,Ron Flockhart,Ken Wharton,0,0,0,Ken Wharton
541,669,105,1954,Ron Flockhart,Prince Bira,0,3,3,Prince Bira
541,670,105,1954,Ron Flockhart,Onofre MarimÃ³n,0,4,4,Onofre MarimÃ³n
541,672,105,1954,Ron Flockhart,Jorge Daponte,0,0,0,Jorge Daponte
541,694,105,1954,Ron Flockhart,Giovanni de Riu,0,0,0,Giovanni de Riu
577,579,105,1954,Luigi Musso,Juan Fangio,6,17,11,Juan Fangio
577,580,105,1954,Luigi Musso,Paco Godia,6,0,6,Luigi Musso
577,627,105,1954,Luigi Musso,Louis Rosier,6,0,6,Luigi Musso
577,633,105,1954,Luigi Musso,Luigi Villoresi,6,2,4,Luigi Musso
577,638,105,1954,Luigi Musso,Ottorino Volonterio,6,0,6,Luigi Musso
577,640,105,1954,Luigi Musso,Toulo de Graffenried,6,0,6,Luigi Musso
577,643,105,1954,Luigi Musso,Roberto Mieres,6,6,0,Roberto Mieres
577,644,105,1954,Luigi Musso,Sergio Mantovani,6,4,2,Luigi Musso
577,647,105,1954,Luigi Musso,Alberto Ascari,6,0,6,Luigi Musso
577,663,105,1954,Luigi Musso,Ken Wharton,6,0,6,Luigi Musso
577,669,105,1954,Luigi Musso,Prince Bira,6,3,3,Luigi Musso
577,670,105,1954,Luigi Musso,Onofre MarimÃ³n,6,4,2,Luigi Musso
577,672,105,1954,Luigi Musso,Jorge Daponte,6,0,6,Luigi Musso
577,694,105,1954,Luigi Musso,Giovanni de Riu,6,0,6,Luigi Musso
579,580,105,1954,Juan Fangio,Paco Godia,17,0,17,Juan Fangio
579,627,105,1954,Juan Fangio,Louis Rosier,17,0,17,Juan Fangio
579,633,105,1954,Juan Fangio,Luigi Villoresi,17,2,15,Juan Fangio
579,638,105,1954,Juan Fangio,Ottorino Volonterio,17,0,17,Juan Fangio
579,640,105,1954,Juan Fangio,Toulo de Graffenried,17,0,17,Juan Fangio
579,643,105,1954,Juan Fangio,Roberto Mieres,17,6,11,Juan Fangio
579,644,105,1954,Juan Fangio,Sergio Mantovani,17,4,13,Juan Fangio
579,647,105,1954,Juan Fangio,Alberto Ascari,17,0,17,Juan Fangio
579,663,105,1954,Juan Fangio,Ken Wharton,17,0,17,Juan Fangio
579,669,105,1954,Juan Fangio,Prince Bira,17,3,14,Juan Fangio
579,670,105,1954,Juan Fangio,Onofre MarimÃ³n,17,4,13,Juan Fangio
579,672,105,1954,Juan Fangio,Jorge Daponte,17,0,17,Juan Fangio
579,694,105,1954,Juan Fangio,Giovanni de Riu,17,0,17,Juan Fangio
580,627,105,1954,Paco Godia,Louis Rosier,0,0,0,Louis Rosier
580,633,105,1954,Paco Godia,Luigi Villoresi,0,2,2,Luigi Villoresi
580,638,105,1954,Paco Godia,Ottorino Volonterio,0,0,0,Ottorino Volonterio
580,640,105,1954,Paco Godia,Toulo de Graffenried,0,0,0,Toulo de Graffenried
580,643,105,1954,Paco Godia,Roberto Mieres,0,6,6,Roberto Mieres
580,644,105,1954,Paco Godia,Sergio Mantovani,0,4,4,Sergio Mantovani
580,647,105,1954,Paco Godia,Alberto Ascari,0,0,0,Alberto Ascari
580,663,105,1954,Paco Godia,Ken Wharton,0,0,0,Ken Wharton
580,669,105,1954,Paco Godia,Prince Bira,0,3,3,Prince Bira
580,670,105,1954,Paco Godia,Onofre MarimÃ³n,0,4,4,Onofre MarimÃ³n
580,672,105,1954,Paco Godia,Jorge Daponte,0,0,0,Jorge Daponte
580,694,105,1954,Paco Godia,Giovanni de Riu,0,0,0,Giovanni de Riu
627,633,105,1954,Louis Rosier,Luigi Villoresi,0,2,2,Luigi Villoresi
627,638,105,1954,Louis Rosier,Ottorino Volonterio,0,0,0,Ottorino Volonterio
627,640,105,1954,Louis Rosier,Toulo de Graffenried,0,0,0,Toulo de Graffenried
627,643,105,1954,Louis Rosier,Roberto Mieres,0,6,6,Roberto Mieres
627,644,105,1954,Louis Rosier,Sergio Mantovani,0,4,4,Sergio Mantovani
627,647,105,1954,Louis Rosier,Alberto Ascari,0,0,0,Alberto Ascari
627,663,105,1954,Louis Rosier,Ken Wharton,0,0,0,Ken Wharton
627,669,105,1954,Louis Rosier,Prince Bira,0,3,3,Prince Bira
627,670,105,1954,Louis Rosier,Onofre MarimÃ³n,0,4,4,Onofre MarimÃ³n
627,672,105,1954,Louis Rosier,Jorge Daponte,0,0,0,Jorge Daponte
627,694,105,1954,Louis Rosier,Giovanni de Riu,0,0,0,Giovanni de Riu
633,638,105,1954,Luigi Villoresi,Ottorino Volonterio,2,0,2,Luigi Villoresi
633,640,105,1954,Luigi Villoresi,Toulo de Graffenried,2,0,2,Luigi Villoresi
633,643,105,1954,Luigi Villoresi,Roberto Mieres,2,6,4,Roberto Mieres
633,644,105,1954,Luigi Villoresi,Sergio Mantovani,2,4,2,Sergio Mantovani
633,647,105,1954,Luigi Villoresi,Alberto Ascari,2,0,2,Luigi Villoresi
633,663,105,1954,Luigi Villoresi,Ken Wharton,2,0,2,Luigi Villoresi
633,669,105,1954,Luigi Villoresi,Prince Bira,2,3,1,Prince Bira
633,670,105,1954,Luigi Villoresi,Onofre MarimÃ³n,2,4,2,Onofre MarimÃ³n
633,672,105,1954,Luigi Villoresi,Jorge Daponte,2,0,2,Luigi Villoresi
633,694,105,1954,Luigi Villoresi,Giovanni de Riu,2,0,2,Luigi Villoresi
638,640,105,1954,Ottorino Volonterio,Toulo de Graffenried,0,0,0,Toulo de Graffenried
638,643,105,1954,Ottorino Volonterio,Roberto Mieres,0,6,6,Roberto Mieres
638,644,105,1954,Ottorino Volonterio,Sergio Mantovani,0,4,4,Sergio Mantovani
638,647,105,1954,Ottorino Volonterio,Alberto Ascari,0,0,0,Alberto Ascari
638,663,105,1954,Ottorino Volonterio,Ken Wharton,0,0,0,Ken Wharton
638,669,105,1954,Ottorino Volonterio,Prince Bira,0,3,3,Prince Bira
638,670,105,1954,Ottorino Volonterio,Onofre MarimÃ³n,0,4,4,Onofre MarimÃ³n
638,672,105,1954,Ottorino Volonterio,Jorge Daponte,0,0,0,Jorge Daponte
638,694,105,1954,Ottorino Volonterio,Giovanni de Riu,0,0,0,Giovanni de Riu
640,643,105,1954,Toulo de Graffenried,Roberto Mieres,0,6,6,Roberto Mieres
640,644,105,1954,Toulo de Graffenried,Sergio Mantovani,0,4,4,Sergio Mantovani
640,647,105,1954,Toulo de Graffenried,Alberto Ascari,0,0,0,Alberto Ascari
640,663,105,1954,Toulo de Graffenried,Ken Wharton,0,0,0,Ken Wharton
640,669,105,1954,Toulo de Graffenried,Prince Bira,0,3,3,Prince Bira
640,670,105,1954,Toulo de Graffenried,Onofre MarimÃ³n,0,4,4,Onofre MarimÃ³n
640,672,105,1954,Toulo de Graffenried,Jorge Daponte,0,0,0,Jorge Daponte
640,694,105,1954,Toulo de Graffenried,Giovanni de Riu,0,0,0,Giovanni de Riu
643,644,105,1954,Roberto Mieres,Sergio Mantovani,6,4,2,Roberto Mieres
643,647,105,1954,Roberto Mieres,Alberto Ascari,6,0,6,Roberto Mieres
643,663,105,1954,Roberto Mieres,Ken Wharton,6,0,6,Roberto Mieres
643,669,105,1954,Roberto Mieres,Prince Bira,6,3,3,Roberto Mieres
643,670,105,1954,Roberto Mieres,Onofre MarimÃ³n,6,4,2,Roberto Mieres
643,672,105,1954,Roberto Mieres,Jorge Daponte,6,0,6,Roberto Mieres
643,694,105,1954,Roberto Mieres,Giovanni de Riu,6,0,6,Roberto Mieres
644,647,105,1954,Sergio Mantovani,Alberto Ascari,4,0,4,Sergio Mantovani
644,663,105,1954,Sergio Mantovani,Ken Wharton,4,0,4,Sergio Mantovani
644,669,105,1954,Sergio Mantovani,Prince Bira,4,3,1,Sergio Mantovani
644,670,105,1954,Sergio Mantovani,Onofre MarimÃ³n,4,4,0,Onofre MarimÃ³n
644,672,105,1954,Sergio Mantovani,Jorge Daponte,4,0,4,Sergio Mantovani
644,694,105,1954,Sergio Mantovani,Giovanni de Riu,4,0,4,Sergio Mantovani
647,663,105,1954,Alberto Ascari,Ken Wharton,0,0,0,Ken Wharton
647,669,105,1954,Alberto Ascari,Prince Bira,0,3,3,Prince Bira
647,670,105,1954,Alberto Ascari,Onofre MarimÃ³n,0,4,4,Onofre MarimÃ³n
647,672,105,1954,Alberto Ascari,Jorge Daponte,0,0,0,Jorge Daponte
647,694,105,1954,Alberto Ascari,Giovanni de Riu,0,0,0,Giovanni de Riu
663,669,105,1954,Ken Wharton,Prince Bira,0,3,3,Prince Bira
663,670,105,1954,Ken Wharton,Onofre MarimÃ³n,0,4,4,Onofre MarimÃ³n
663,672,105,1954,Ken Wharton,Jorge Daponte,0,0,0,Jorge Daponte
663,694,105,1954,Ken Wharton,Giovanni de Riu,0,0,0,Giovanni de Riu
669,670,105,1954,Prince Bira,Onofre MarimÃ³n,3,4,1,Onofre MarimÃ³n
669,672,105,1954,Prince Bira,Jorge Daponte,3,0,3,Prince Bira
669,694,105,1954,Prince Bira,Giovanni de Riu,3,0,3,Prince Bira
670,672,105,1954,Onofre MarimÃ³n,Jorge Daponte,4,0,4,Onofre MarimÃ³n
670,694,105,1954,Onofre MarimÃ³n,Giovanni de Riu,4,0,4,Onofre MarimÃ³n
672,694,105,1954,Jorge Daponte,Giovanni de Riu,0,0,0,Giovanni de Riu
456,496,105,1955,Roy Salvadori,Carlos Menditeguy,0,2,2,Carlos Menditeguy
456,501,105,1955,Roy Salvadori,Harry Schell,0,0,0,Harry Schell
456,547,105,1955,Roy Salvadori,Horace Gould,0,0,0,Horace Gould
456,554,105,1955,Roy Salvadori,Jean Behra,0,6,6,Jean Behra
456,577,105,1955,Roy Salvadori,Luigi Musso,0,6,6,Luigi Musso
456,581,105,1955,Roy Salvadori,Peter Collins,0,0,0,Peter Collins
456,607,105,1955,Roy Salvadori,Cesare Perdisa,0,2,2,Cesare Perdisa
456,609,105,1955,Roy Salvadori,AndrÃ© Simon,0,0,0,AndrÃ© Simon
456,623,105,1955,Roy Salvadori,Alberto Uria,0,0,0,Alberto Uria
456,627,105,1955,Roy Salvadori,Louis Rosier,0,0,0,Louis Rosier
456,643,105,1955,Roy Salvadori,Roberto Mieres,0,7,7,Roberto Mieres
456,644,105,1955,Roy Salvadori,Sergio Mantovani,0,0,0,Sergio Mantovani
456,645,105,1955,Roy Salvadori,Clemar Bucci,0,0,0,Clemar Bucci
456,651,105,1955,Roy Salvadori,Lance Macklin,0,0,0,Lance Macklin
456,660,105,1955,Roy Salvadori,Johnny Claes,0,0,0,Johnny Claes
456,661,105,1955,Roy Salvadori,Peter Walker,0,0,0,Peter Walker
456,667,105,1955,Roy Salvadori,John Fitch,0,0,0,John Fitch
496,501,105,1955,Carlos Menditeguy,Harry Schell,2,0,2,Carlos Menditeguy
496,547,105,1955,Carlos Menditeguy,Horace Gould,2,0,2,Carlos Menditeguy
496,554,105,1955,Carlos Menditeguy,Jean Behra,2,6,4,Jean Behra
496,577,105,1955,Carlos Menditeguy,Luigi Musso,2,6,4,Luigi Musso
496,581,105,1955,Carlos Menditeguy,Peter Collins,2,0,2,Carlos Menditeguy
496,607,105,1955,Carlos Menditeguy,Cesare Perdisa,2,2,0,Cesare Perdisa
496,609,105,1955,Carlos Menditeguy,AndrÃ© Simon,2,0,2,Carlos Menditeguy
496,623,105,1955,Carlos Menditeguy,Alberto Uria,2,0,2,Carlos Menditeguy
496,627,105,1955,Carlos Menditeguy,Louis Rosier,2,0,2,Carlos Menditeguy
496,643,105,1955,Carlos Menditeguy,Roberto Mieres,2,7,5,Roberto Mieres
496,644,105,1955,Carlos Menditeguy,Sergio Mantovani,2,0,2,Carlos Menditeguy
496,645,105,1955,Carlos Menditeguy,Clemar Bucci,2,0,2,Carlos Menditeguy
496,651,105,1955,Carlos Menditeguy,Lance Macklin,2,0,2,Carlos Menditeguy
496,660,105,1955,Carlos Menditeguy,Johnny Claes,2,0,2,Carlos Menditeguy
496,661,105,1955,Carlos Menditeguy,Peter Walker,2,0,2,Carlos Menditeguy
496,667,105,1955,Carlos Menditeguy,John Fitch,2,0,2,Carlos Menditeguy
501,547,105,1955,Harry Schell,Horace Gould,0,0,0,Horace Gould
501,554,105,1955,Harry Schell,Jean Behra,0,6,6,Jean Behra
501,577,105,1955,Harry Schell,Luigi Musso,0,6,6,Luigi Musso
501,581,105,1955,Harry Schell,Peter Collins,0,0,0,Peter Collins
501,607,105,1955,Harry Schell,Cesare Perdisa,0,2,2,Cesare Perdisa
501,609,105,1955,Harry Schell,AndrÃ© Simon,0,0,0,AndrÃ© Simon
501,623,105,1955,Harry Schell,Alberto Uria,0,0,0,Alberto Uria
501,627,105,1955,Harry Schell,Louis Rosier,0,0,0,Louis Rosier
501,643,105,1955,Harry Schell,Roberto Mieres,0,7,7,Roberto Mieres
501,644,105,1955,Harry Schell,Sergio Mantovani,0,0,0,Sergio Mantovani
501,645,105,1955,Harry Schell,Clemar Bucci,0,0,0,Clemar Bucci
501,651,105,1955,Harry Schell,Lance Macklin,0,0,0,Lance Macklin
501,660,105,1955,Harry Schell,Johnny Claes,0,0,0,Johnny Claes
501,661,105,1955,Harry Schell,Peter Walker,0,0,0,Peter Walker
501,667,105,1955,Harry Schell,John Fitch,0,0,0,John Fitch
547,554,105,1955,Horace Gould,Jean Behra,0,6,6,Jean Behra
547,577,105,1955,Horace Gould,Luigi Musso,0,6,6,Luigi Musso
547,581,105,1955,Horace Gould,Peter Collins,0,0,0,Peter Collins
547,607,105,1955,Horace Gould,Cesare Perdisa,0,2,2,Cesare Perdisa
547,609,105,1955,Horace Gould,AndrÃ© Simon,0,0,0,AndrÃ© Simon
547,623,105,1955,Horace Gould,Alberto Uria,0,0,0,Alberto Uria
547,627,105,1955,Horace Gould,Louis Rosier,0,0,0,Louis Rosier
547,643,105,1955,Horace Gould,Roberto Mieres,0,7,7,Roberto Mieres
547,644,105,1955,Horace Gould,Sergio Mantovani,0,0,0,Sergio Mantovani
547,645,105,1955,Horace Gould,Clemar Bucci,0,0,0,Clemar Bucci
547,651,105,1955,Horace Gould,Lance Macklin,0,0,0,Lance Macklin
547,660,105,1955,Horace Gould,Johnny Claes,0,0,0,Johnny Claes
547,661,105,1955,Horace Gould,Peter Walker,0,0,0,Peter Walker
547,667,105,1955,Horace Gould,John Fitch,0,0,0,John Fitch
554,577,105,1955,Jean Behra,Luigi Musso,6,6,0,Luigi Musso
554,581,105,1955,Jean Behra,Peter Collins,6,0,6,Jean Behra
554,607,105,1955,Jean Behra,Cesare Perdisa,6,2,4,Jean Behra
554,609,105,1955,Jean Behra,AndrÃ© Simon,6,0,6,Jean Behra
554,623,105,1955,Jean Behra,Alberto Uria,6,0,6,Jean Behra
554,627,105,1955,Jean Behra,Louis Rosier,6,0,6,Jean Behra
554,643,105,1955,Jean Behra,Roberto Mieres,6,7,1,Roberto Mieres
554,644,105,1955,Jean Behra,Sergio Mantovani,6,0,6,Jean Behra
554,645,105,1955,Jean Behra,Clemar Bucci,6,0,6,Jean Behra
554,651,105,1955,Jean Behra,Lance Macklin,6,0,6,Jean Behra
554,660,105,1955,Jean Behra,Johnny Claes,6,0,6,Jean Behra
554,661,105,1955,Jean Behra,Peter Walker,6,0,6,Jean Behra
554,667,105,1955,Jean Behra,John Fitch,6,0,6,Jean Behra
577,581,105,1955,Luigi Musso,Peter Collins,6,0,6,Luigi Musso
577,607,105,1955,Luigi Musso,Cesare Perdisa,6,2,4,Luigi Musso
577,609,105,1955,Luigi Musso,AndrÃ© Simon,6,0,6,Luigi Musso
577,623,105,1955,Luigi Musso,Alberto Uria,6,0,6,Luigi Musso
577,627,105,1955,Luigi Musso,Louis Rosier,6,0,6,Luigi Musso
577,643,105,1955,Luigi Musso,Roberto Mieres,6,7,1,Roberto Mieres
577,644,105,1955,Luigi Musso,Sergio Mantovani,6,0,6,Luigi Musso
577,645,105,1955,Luigi Musso,Clemar Bucci,6,0,6,Luigi Musso
577,651,105,1955,Luigi Musso,Lance Macklin,6,0,6,Luigi Musso
577,660,105,1955,Luigi Musso,Johnny Claes,6,0,6,Luigi Musso
577,661,105,1955,Luigi Musso,Peter Walker,6,0,6,Luigi Musso
577,667,105,1955,Luigi Musso,John Fitch,6,0,6,Luigi Musso
581,607,105,1955,Peter Collins,Cesare Perdisa,0,2,2,Cesare Perdisa
581,609,105,1955,Peter Collins,AndrÃ© Simon,0,0,0,AndrÃ© Simon
581,623,105,1955,Peter Collins,Alberto Uria,0,0,0,Alberto Uria
581,627,105,1955,Peter Collins,Louis Rosier,0,0,0,Louis Rosier
581,643,105,1955,Peter Collins,Roberto Mieres,0,7,7,Roberto Mieres
581,644,105,1955,Peter Collins,Sergio Mantovani,0,0,0,Sergio Mantovani
581,645,105,1955,Peter Collins,Clemar Bucci,0,0,0,Clemar Bucci
581,651,105,1955,Peter Collins,Lance Macklin,0,0,0,Lance Macklin
581,660,105,1955,Peter Collins,Johnny Claes,0,0,0,Johnny Claes
581,661,105,1955,Peter Collins,Peter Walker,0,0,0,Peter Walker
581,667,105,1955,Peter Collins,John Fitch,0,0,0,John Fitch
607,609,105,1955,Cesare Perdisa,AndrÃ© Simon,2,0,2,Cesare Perdisa
607,623,105,1955,Cesare Perdisa,Alberto Uria,2,0,2,Cesare Perdisa
607,627,105,1955,Cesare Perdisa,Louis Rosier,2,0,2,Cesare Perdisa
607,643,105,1955,Cesare Perdisa,Roberto Mieres,2,7,5,Roberto Mieres
607,644,105,1955,Cesare Perdisa,Sergio Mantovani,2,0,2,Cesare Perdisa
607,645,105,1955,Cesare Perdisa,Clemar Bucci,2,0,2,Cesare Perdisa
607,651,105,1955,Cesare Perdisa,Lance Macklin,2,0,2,Cesare Perdisa
607,660,105,1955,Cesare Perdisa,Johnny Claes,2,0,2,Cesare Perdisa
607,661,105,1955,Cesare Perdisa,Peter Walker,2,0,2,Cesare Perdisa
607,667,105,1955,Cesare Perdisa,John Fitch,2,0,2,Cesare Perdisa
609,623,105,1955,AndrÃ© Simon,Alberto Uria,0,0,0,Alberto Uria
609,627,105,1955,AndrÃ© Simon,Louis Rosier,0,0,0,Louis Rosier
609,643,105,1955,AndrÃ© Simon,Roberto Mieres,0,7,7,Roberto Mieres
609,644,105,1955,AndrÃ© Simon,Sergio Mantovani,0,0,0,Sergio Mantovani
609,645,105,1955,AndrÃ© Simon,Clemar Bucci,0,0,0,Clemar Bucci
609,651,105,1955,AndrÃ© Simon,Lance Macklin,0,0,0,Lance Macklin
609,660,105,1955,AndrÃ© Simon,Johnny Claes,0,0,0,Johnny Claes
609,661,105,1955,AndrÃ© Simon,Peter Walker,0,0,0,Peter Walker
609,667,105,1955,AndrÃ© Simon,John Fitch,0,0,0,John Fitch
623,627,105,1955,Alberto Uria,Louis Rosier,0,0,0,Louis Rosier
623,643,105,1955,Alberto Uria,Roberto Mieres,0,7,7,Roberto Mieres
623,644,105,1955,Alberto Uria,Sergio Mantovani,0,0,0,Sergio Mantovani
623,645,105,1955,Alberto Uria,Clemar Bucci,0,0,0,Clemar Bucci
623,651,105,1955,Alberto Uria,Lance Macklin,0,0,0,Lance Macklin
623,660,105,1955,Alberto Uria,Johnny Claes,0,0,0,Johnny Claes
623,661,105,1955,Alberto Uria,Peter Walker,0,0,0,Peter Walker
623,667,105,1955,Alberto Uria,John Fitch,0,0,0,John Fitch
627,643,105,1955,Louis Rosier,Roberto Mieres,0,7,7,Roberto Mieres
627,644,105,1955,Louis Rosier,Sergio Mantovani,0,0,0,Sergio Mantovani
627,645,105,1955,Louis Rosier,Clemar Bucci,0,0,0,Clemar Bucci
627,651,105,1955,Louis Rosier,Lance Macklin,0,0,0,Lance Macklin
627,660,105,1955,Louis Rosier,Johnny Claes,0,0,0,Johnny Claes
627,661,105,1955,Louis Rosier,Peter Walker,0,0,0,Peter Walker
627,667,105,1955,Louis Rosier,John Fitch,0,0,0,John Fitch
643,644,105,1955,Roberto Mieres,Sergio Mantovani,7,0,7,Roberto Mieres
643,645,105,1955,Roberto Mieres,Clemar Bucci,7,0,7,Roberto Mieres
643,651,105,1955,Roberto Mieres,Lance Macklin,7,0,7,Roberto Mieres
643,660,105,1955,Roberto Mieres,Johnny Claes,7,0,7,Roberto Mieres
643,661,105,1955,Roberto Mieres,Peter Walker,7,0,7,Roberto Mieres
643,667,105,1955,Roberto Mieres,John Fitch,7,0,7,Roberto Mieres
644,645,105,1955,Sergio Mantovani,Clemar Bucci,0,0,0,Clemar Bucci
644,651,105,1955,Sergio Mantovani,Lance Macklin,0,0,0,Lance Macklin
644,660,105,1955,Sergio Mantovani,Johnny Claes,0,0,0,Johnny Claes
644,661,105,1955,Sergio Mantovani,Peter Walker,0,0,0,Peter Walker
644,667,105,1955,Sergio Mantovani,John Fitch,0,0,0,John Fitch
645,651,105,1955,Clemar Bucci,Lance Macklin,0,0,0,Lance Macklin
645,660,105,1955,Clemar Bucci,Johnny Claes,0,0,0,Johnny Claes
645,661,105,1955,Clemar Bucci,Peter Walker,0,0,0,Peter Walker
645,667,105,1955,Clemar Bucci,John Fitch,0,0,0,John Fitch
651,660,105,1955,Lance Macklin,Johnny Claes,0,0,0,Johnny Claes
651,661,105,1955,Lance Macklin,Peter Walker,0,0,0,Peter Walker
651,667,105,1955,Lance Macklin,John Fitch,0,0,0,John Fitch
660,661,105,1955,Johnny Claes,Peter Walker,0,0,0,Peter Walker
660,667,105,1955,Johnny Claes,John Fitch,0,0,0,John Fitch
661,667,105,1955,Peter Walker,John Fitch,0,0,0,John Fitch
347,356,105,1956,Jo Bonnier,Jack Brabham,0,0,0,Jack Brabham
347,456,105,1956,Jo Bonnier,Roy Salvadori,0,0,0,Roy Salvadori
347,475,105,1956,Jo Bonnier,Stirling Moss,0,28,28,Stirling Moss
347,496,105,1956,Jo Bonnier,Carlos Menditeguy,0,0,0,Carlos Menditeguy
347,498,105,1956,Jo Bonnier,JosÃ© FroilÃ¡n GonzÃ¡lez,0,0,0,JosÃ© FroilÃ¡n GonzÃ¡lez
347,501,105,1956,Jo Bonnier,Harry Schell,0,0,0,Harry Schell
347,506,105,1956,Jo Bonnier,Bruce Halford,0,0,0,Bruce Halford
347,547,105,1956,Jo Bonnier,Horace Gould,0,2,2,Horace Gould
347,554,105,1956,Jo Bonnier,Jean Behra,0,22,22,Jean Behra
347,578,105,1956,Jo Bonnier,Mike Hawthorn,0,4,4,Mike Hawthorn
347,580,105,1956,Jo Bonnier,Paco Godia,0,6,6,Paco Godia
347,583,105,1956,Jo Bonnier,Gerino Gerini,0,2,2,Gerino Gerini
347,586,105,1956,Jo Bonnier,Luigi Piotti,0,0,0,Luigi Piotti
347,589,105,1956,Jo Bonnier,Louis Chiron,0,0,0,Louis Chiron
347,607,105,1956,Jo Bonnier,Cesare Perdisa,0,3,3,Cesare Perdisa
347,609,105,1956,Jo Bonnier,AndrÃ© Simon,0,0,0,AndrÃ© Simon
347,620,105,1956,Jo Bonnier,Umberto Maglioli,0,0,0,Umberto Maglioli
347,622,105,1956,Jo Bonnier,Chico Landi,0,2,2,Chico Landi
347,623,105,1956,Jo Bonnier,Alberto Uria,0,0,0,Alberto Uria
347,624,105,1956,Jo Bonnier,Hernando da Silva Ramos,0,0,0,Hernando da Silva Ramos
347,627,105,1956,Jo Bonnier,Louis Rosier,0,2,2,Louis Rosier
347,633,105,1956,Jo Bonnier,Luigi Villoresi,0,2,2,Luigi Villoresi
347,638,105,1956,Jo Bonnier,Ottorino Volonterio,0,0,0,Ottorino Volonterio
347,640,105,1956,Jo Bonnier,Toulo de Graffenried,0,0,0,Toulo de Graffenried
347,806,105,1956,Jo Bonnier,Ã“scar GonzÃ¡lez,0,0,0,Ã“scar GonzÃ¡lez
356,456,105,1956,Jack Brabham,Roy Salvadori,0,0,0,Roy Salvadori
356,475,105,1956,Jack Brabham,Stirling Moss,0,28,28,Stirling Moss
356,496,105,1956,Jack Brabham,Carlos Menditeguy,0,0,0,Carlos Menditeguy
356,498,105,1956,Jack Brabham,JosÃ© FroilÃ¡n GonzÃ¡lez,0,0,0,JosÃ© FroilÃ¡n GonzÃ¡lez
356,501,105,1956,Jack Brabham,Harry Schell,0,0,0,Harry Schell
356,506,105,1956,Jack Brabham,Bruce Halford,0,0,0,Bruce Halford
356,547,105,1956,Jack Brabham,Horace Gould,0,2,2,Horace Gould
356,554,105,1956,Jack Brabham,Jean Behra,0,22,22,Jean Behra
356,578,105,1956,Jack Brabham,Mike Hawthorn,0,4,4,Mike Hawthorn
356,580,105,1956,Jack Brabham,Paco Godia,0,6,6,Paco Godia
356,583,105,1956,Jack Brabham,Gerino Gerini,0,2,2,Gerino Gerini
356,586,105,1956,Jack Brabham,Luigi Piotti,0,0,0,Luigi Piotti
356,589,105,1956,Jack Brabham,Louis Chiron,0,0,0,Louis Chiron
356,607,105,1956,Jack Brabham,Cesare Perdisa,0,3,3,Cesare Perdisa
356,609,105,1956,Jack Brabham,AndrÃ© Simon,0,0,0,AndrÃ© Simon
356,620,105,1956,Jack Brabham,Umberto Maglioli,0,0,0,Umberto Maglioli
356,622,105,1956,Jack Brabham,Chico Landi,0,2,2,Chico Landi
356,623,105,1956,Jack Brabham,Alberto Uria,0,0,0,Alberto Uria
356,624,105,1956,Jack Brabham,Hernando da Silva Ramos,0,0,0,Hernando da Silva Ramos
356,627,105,1956,Jack Brabham,Louis Rosier,0,2,2,Louis Rosier
356,633,105,1956,Jack Brabham,Luigi Villoresi,0,2,2,Luigi Villoresi
356,638,105,1956,Jack Brabham,Ottorino Volonterio,0,0,0,Ottorino Volonterio
356,640,105,1956,Jack Brabham,Toulo de Graffenried,0,0,0,Toulo de Graffenried
356,806,105,1956,Jack Brabham,Ã“scar GonzÃ¡lez,0,0,0,Ã“scar GonzÃ¡lez
456,475,105,1956,Roy Salvadori,Stirling Moss,0,28,28,Stirling Moss
456,496,105,1956,Roy Salvadori,Carlos Menditeguy,0,0,0,Carlos Menditeguy
456,498,105,1956,Roy Salvadori,JosÃ© FroilÃ¡n GonzÃ¡lez,0,0,0,JosÃ© FroilÃ¡n GonzÃ¡lez
456,501,105,1956,Roy Salvadori,Harry Schell,0,0,0,Harry Schell
456,506,105,1956,Roy Salvadori,Bruce Halford,0,0,0,Bruce Halford
456,547,105,1956,Roy Salvadori,Horace Gould,0,2,2,Horace Gould
456,554,105,1956,Roy Salvadori,Jean Behra,0,22,22,Jean Behra
456,578,105,1956,Roy Salvadori,Mike Hawthorn,0,4,4,Mike Hawthorn
456,580,105,1956,Roy Salvadori,Paco Godia,0,6,6,Paco Godia
456,583,105,1956,Roy Salvadori,Gerino Gerini,0,2,2,Gerino Gerini
456,586,105,1956,Roy Salvadori,Luigi Piotti,0,0,0,Luigi Piotti
456,589,105,1956,Roy Salvadori,Louis Chiron,0,0,0,Louis Chiron
456,607,105,1956,Roy Salvadori,Cesare Perdisa,0,3,3,Cesare Perdisa
456,609,105,1956,Roy Salvadori,AndrÃ© Simon,0,0,0,AndrÃ© Simon
456,620,105,1956,Roy Salvadori,Umberto Maglioli,0,0,0,Umberto Maglioli
456,622,105,1956,Roy Salvadori,Chico Landi,0,2,2,Chico Landi
456,623,105,1956,Roy Salvadori,Alberto Uria,0,0,0,Alberto Uria
456,624,105,1956,Roy Salvadori,Hernando da Silva Ramos,0,0,0,Hernando da Silva Ramos
456,627,105,1956,Roy Salvadori,Louis Rosier,0,2,2,Louis Rosier
456,633,105,1956,Roy Salvadori,Luigi Villoresi,0,2,2,Luigi Villoresi
456,638,105,1956,Roy Salvadori,Ottorino Volonterio,0,0,0,Ottorino Volonterio
456,640,105,1956,Roy Salvadori,Toulo de Graffenried,0,0,0,Toulo de Graffenried
456,806,105,1956,Roy Salvadori,Ã“scar GonzÃ¡lez,0,0,0,Ã“scar GonzÃ¡lez
475,496,105,1956,Stirling Moss,Carlos Menditeguy,28,0,28,Stirling Moss
475,498,105,1956,Stirling Moss,JosÃ© FroilÃ¡n GonzÃ¡lez,28,0,28,Stirling Moss
475,501,105,1956,Stirling Moss,Harry Schell,28,0,28,Stirling Moss
475,506,105,1956,Stirling Moss,Bruce Halford,28,0,28,Stirling Moss
475,547,105,1956,Stirling Moss,Horace Gould,28,2,26,Stirling Moss
475,554,105,1956,Stirling Moss,Jean Behra,28,22,6,Stirling Moss
475,578,105,1956,Stirling Moss,Mike Hawthorn,28,4,24,Stirling Moss
475,580,105,1956,Stirling Moss,Paco Godia,28,6,22,Stirling Moss
475,583,105,1956,Stirling Moss,Gerino Gerini,28,2,26,Stirling Moss
475,586,105,1956,Stirling Moss,Luigi Piotti,28,0,28,Stirling Moss
475,589,105,1956,Stirling Moss,Louis Chiron,28,0,28,Stirling Moss
475,607,105,1956,Stirling Moss,Cesare Perdisa,28,3,25,Stirling Moss
475,609,105,1956,Stirling Moss,AndrÃ© Simon,28,0,28,Stirling Moss
475,620,105,1956,Stirling Moss,Umberto Maglioli,28,0,28,Stirling Moss
475,622,105,1956,Stirling Moss,Chico Landi,28,2,26,Stirling Moss
475,623,105,1956,Stirling Moss,Alberto Uria,28,0,28,Stirling Moss
475,624,105,1956,Stirling Moss,Hernando da Silva Ramos,28,0,28,Stirling Moss
475,627,105,1956,Stirling Moss,Louis Rosier,28,2,26,Stirling Moss
475,633,105,1956,Stirling Moss,Luigi Villoresi,28,2,26,Stirling Moss
475,638,105,1956,Stirling Moss,Ottorino Volonterio,28,0,28,Stirling Moss
475,640,105,1956,Stirling Moss,Toulo de Graffenried,28,0,28,Stirling Moss
475,806,105,1956,Stirling Moss,Ã“scar GonzÃ¡lez,28,0,28,Stirling Moss
496,498,105,1956,Carlos Menditeguy,JosÃ© FroilÃ¡n GonzÃ¡lez,0,0,0,JosÃ© FroilÃ¡n GonzÃ¡lez
496,501,105,1956,Carlos Menditeguy,Harry Schell,0,0,0,Harry Schell
496,506,105,1956,Carlos Menditeguy,Bruce Halford,0,0,0,Bruce Halford
496,547,105,1956,Carlos Menditeguy,Horace Gould,0,2,2,Horace Gould
496,554,105,1956,Carlos Menditeguy,Jean Behra,0,22,22,Jean Behra
496,578,105,1956,Carlos Menditeguy,Mike Hawthorn,0,4,4,Mike Hawthorn
496,580,105,1956,Carlos Menditeguy,Paco Godia,0,6,6,Paco Godia
496,583,105,1956,Carlos Menditeguy,Gerino Gerini,0,2,2,Gerino Gerini
496,586,105,1956,Carlos Menditeguy,Luigi Piotti,0,0,0,Luigi Piotti
496,589,105,1956,Carlos Menditeguy,Louis Chiron,0,0,0,Louis Chiron
496,607,105,1956,Carlos Menditeguy,Cesare Perdisa,0,3,3,Cesare Perdisa
496,609,105,1956,Carlos Menditeguy,AndrÃ© Simon,0,0,0,AndrÃ© Simon
496,620,105,1956,Carlos Menditeguy,Umberto Maglioli,0,0,0,Umberto Maglioli
496,622,105,1956,Carlos Menditeguy,Chico Landi,0,2,2,Chico Landi
496,623,105,1956,Carlos Menditeguy,Alberto Uria,0,0,0,Alberto Uria
496,624,105,1956,Carlos Menditeguy,Hernando da Silva Ramos,0,0,0,Hernando da Silva Ramos
496,627,105,1956,Carlos Menditeguy,Louis Rosier,0,2,2,Louis Rosier
496,633,105,1956,Carlos Menditeguy,Luigi Villoresi,0,2,2,Luigi Villoresi
496,638,105,1956,Carlos Menditeguy,Ottorino Volonterio,0,0,0,Ottorino Volonterio
496,640,105,1956,Carlos Menditeguy,Toulo de Graffenried,0,0,0,Toulo de Graffenried
496,806,105,1956,Carlos Menditeguy,Ã“scar GonzÃ¡lez,0,0,0,Ã“scar GonzÃ¡lez
498,501,105,1956,JosÃ© FroilÃ¡n GonzÃ¡lez,Harry Schell,0,0,0,Harry Schell
498,506,105,1956,JosÃ© FroilÃ¡n GonzÃ¡lez,Bruce Halford,0,0,0,Bruce Halford
498,547,105,1956,JosÃ© FroilÃ¡n GonzÃ¡lez,Horace Gould,0,2,2,Horace Gould
498,554,105,1956,JosÃ© FroilÃ¡n GonzÃ¡lez,Jean Behra,0,22,22,Jean Behra
498,578,105,1956,JosÃ© FroilÃ¡n GonzÃ¡lez,Mike Hawthorn,0,4,4,Mike Hawthorn
498,580,105,1956,JosÃ© FroilÃ¡n GonzÃ¡lez,Paco Godia,0,6,6,Paco Godia
498,583,105,1956,JosÃ© FroilÃ¡n GonzÃ¡lez,Gerino Gerini,0,2,2,Gerino Gerini
498,586,105,1956,JosÃ© FroilÃ¡n GonzÃ¡lez,Luigi Piotti,0,0,0,Luigi Piotti
498,589,105,1956,JosÃ© FroilÃ¡n GonzÃ¡lez,Louis Chiron,0,0,0,Louis Chiron
498,607,105,1956,JosÃ© FroilÃ¡n GonzÃ¡lez,Cesare Perdisa,0,3,3,Cesare Perdisa
498,609,105,1956,JosÃ© FroilÃ¡n GonzÃ¡lez,AndrÃ© Simon,0,0,0,AndrÃ© Simon
498,620,105,1956,JosÃ© FroilÃ¡n GonzÃ¡lez,Umberto Maglioli,0,0,0,Umberto Maglioli
498,622,105,1956,JosÃ© FroilÃ¡n GonzÃ¡lez,Chico Landi,0,2,2,Chico Landi
498,623,105,1956,JosÃ© FroilÃ¡n GonzÃ¡lez,Alberto Uria,0,0,0,Alberto Uria
498,624,105,1956,JosÃ© FroilÃ¡n GonzÃ¡lez,Hernando da Silva Ramos,0,0,0,Hernando da Silva Ramos
498,627,105,1956,JosÃ© FroilÃ¡n GonzÃ¡lez,Louis Rosier,0,2,2,Louis Rosier
498,633,105,1956,JosÃ© FroilÃ¡n GonzÃ¡lez,Luigi Villoresi,0,2,2,Luigi Villoresi
498,638,105,1956,JosÃ© FroilÃ¡n GonzÃ¡lez,Ottorino Volonterio,0,0,0,Ottorino Volonterio
498,640,105,1956,JosÃ© FroilÃ¡n GonzÃ¡lez,Toulo de Graffenried,0,0,0,Toulo de Graffenried
498,806,105,1956,JosÃ© FroilÃ¡n GonzÃ¡lez,Ã“scar GonzÃ¡lez,0,0,0,Ã“scar GonzÃ¡lez
501,506,105,1956,Harry Schell,Bruce Halford,0,0,0,Bruce Halford
501,547,105,1956,Harry Schell,Horace Gould,0,2,2,Horace Gould
501,554,105,1956,Harry Schell,Jean Behra,0,22,22,Jean Behra
501,578,105,1956,Harry Schell,Mike Hawthorn,0,4,4,Mike Hawthorn
501,580,105,1956,Harry Schell,Paco Godia,0,6,6,Paco Godia
501,583,105,1956,Harry Schell,Gerino Gerini,0,2,2,Gerino Gerini
501,586,105,1956,Harry Schell,Luigi Piotti,0,0,0,Luigi Piotti
501,589,105,1956,Harry Schell,Louis Chiron,0,0,0,Louis Chiron
501,607,105,1956,Harry Schell,Cesare Perdisa,0,3,3,Cesare Perdisa
501,609,105,1956,Harry Schell,AndrÃ© Simon,0,0,0,AndrÃ© Simon
501,620,105,1956,Harry Schell,Umberto Maglioli,0,0,0,Umberto Maglioli
501,622,105,1956,Harry Schell,Chico Landi,0,2,2,Chico Landi
501,623,105,1956,Harry Schell,Alberto Uria,0,0,0,Alberto Uria
501,624,105,1956,Harry Schell,Hernando da Silva Ramos,0,0,0,Hernando da Silva Ramos
501,627,105,1956,Harry Schell,Louis Rosier,0,2,2,Louis Rosier
501,633,105,1956,Harry Schell,Luigi Villoresi,0,2,2,Luigi Villoresi
501,638,105,1956,Harry Schell,Ottorino Volonterio,0,0,0,Ottorino Volonterio
501,640,105,1956,Harry Schell,Toulo de Graffenried,0,0,0,Toulo de Graffenried
501,806,105,1956,Harry Schell,Ã“scar GonzÃ¡lez,0,0,0,Ã“scar GonzÃ¡lez
506,547,105,1956,Bruce Halford,Horace Gould,0,2,2,Horace Gould
506,554,105,1956,Bruce Halford,Jean Behra,0,22,22,Jean Behra
506,578,105,1956,Bruce Halford,Mike Hawthorn,0,4,4,Mike Hawthorn
506,580,105,1956,Bruce Halford,Paco Godia,0,6,6,Paco Godia
506,583,105,1956,Bruce Halford,Gerino Gerini,0,2,2,Gerino Gerini
506,586,105,1956,Bruce Halford,Luigi Piotti,0,0,0,Luigi Piotti
506,589,105,1956,Bruce Halford,Louis Chiron,0,0,0,Louis Chiron
506,607,105,1956,Bruce Halford,Cesare Perdisa,0,3,3,Cesare Perdisa
506,609,105,1956,Bruce Halford,AndrÃ© Simon,0,0,0,AndrÃ© Simon
506,620,105,1956,Bruce Halford,Umberto Maglioli,0,0,0,Umberto Maglioli
506,622,105,1956,Bruce Halford,Chico Landi,0,2,2,Chico Landi
506,623,105,1956,Bruce Halford,Alberto Uria,0,0,0,Alberto Uria
506,624,105,1956,Bruce Halford,Hernando da Silva Ramos,0,0,0,Hernando da Silva Ramos
506,627,105,1956,Bruce Halford,Louis Rosier,0,2,2,Louis Rosier
506,633,105,1956,Bruce Halford,Luigi Villoresi,0,2,2,Luigi Villoresi
506,638,105,1956,Bruce Halford,Ottorino Volonterio,0,0,0,Ottorino Volonterio
506,640,105,1956,Bruce Halford,Toulo de Graffenried,0,0,0,Toulo de Graffenried
506,806,105,1956,Bruce Halford,Ã“scar GonzÃ¡lez,0,0,0,Ã“scar GonzÃ¡lez
547,554,105,1956,Horace Gould,Jean Behra,2,22,20,Jean Behra
547,578,105,1956,Horace Gould,Mike Hawthorn,2,4,2,Mike Hawthorn
547,580,105,1956,Horace Gould,Paco Godia,2,6,4,Paco Godia
547,583,105,1956,Horace Gould,Gerino Gerini,2,2,0,Gerino Gerini
547,586,105,1956,Horace Gould,Luigi Piotti,2,0,2,Horace Gould
547,589,105,1956,Horace Gould,Louis Chiron,2,0,2,Horace Gould
547,607,105,1956,Horace Gould,Cesare Perdisa,2,3,1,Cesare Perdisa
547,609,105,1956,Horace Gould,AndrÃ© Simon,2,0,2,Horace Gould
547,620,105,1956,Horace Gould,Umberto Maglioli,2,0,2,Horace Gould
547,622,105,1956,Horace Gould,Chico Landi,2,2,0,Chico Landi
547,623,105,1956,Horace Gould,Alberto Uria,2,0,2,Horace Gould
547,624,105,1956,Horace Gould,Hernando da Silva Ramos,2,0,2,Horace Gould
547,627,105,1956,Horace Gould,Louis Rosier,2,2,0,Louis Rosier
547,633,105,1956,Horace Gould,Luigi Villoresi,2,2,0,Luigi Villoresi
547,638,105,1956,Horace Gould,Ottorino Volonterio,2,0,2,Horace Gould
547,640,105,1956,Horace Gould,Toulo de Graffenried,2,0,2,Horace Gould
547,806,105,1956,Horace Gould,Ã“scar GonzÃ¡lez,2,0,2,Horace Gould
554,578,105,1956,Jean Behra,Mike Hawthorn,22,4,18,Jean Behra
554,580,105,1956,Jean Behra,Paco Godia,22,6,16,Jean Behra
554,583,105,1956,Jean Behra,Gerino Gerini,22,2,20,Jean Behra
554,586,105,1956,Jean Behra,Luigi Piotti,22,0,22,Jean Behra
554,589,105,1956,Jean Behra,Louis Chiron,22,0,22,Jean Behra
554,607,105,1956,Jean Behra,Cesare Perdisa,22,3,19,Jean Behra
554,609,105,1956,Jean Behra,AndrÃ© Simon,22,0,22,Jean Behra
554,620,105,1956,Jean Behra,Umberto Maglioli,22,0,22,Jean Behra
554,622,105,1956,Jean Behra,Chico Landi,22,2,20,Jean Behra
554,623,105,1956,Jean Behra,Alberto Uria,22,0,22,Jean Behra
554,624,105,1956,Jean Behra,Hernando da Silva Ramos,22,0,22,Jean Behra
554,627,105,1956,Jean Behra,Louis Rosier,22,2,20,Jean Behra
554,633,105,1956,Jean Behra,Luigi Villoresi,22,2,20,Jean Behra
554,638,105,1956,Jean Behra,Ottorino Volonterio,22,0,22,Jean Behra
554,640,105,1956,Jean Behra,Toulo de Graffenried,22,0,22,Jean Behra
554,806,105,1956,Jean Behra,Ã“scar GonzÃ¡lez,22,0,22,Jean Behra
578,580,105,1956,Mike Hawthorn,Paco Godia,4,6,2,Paco Godia
578,583,105,1956,Mike Hawthorn,Gerino Gerini,4,2,2,Mike Hawthorn
578,586,105,1956,Mike Hawthorn,Luigi Piotti,4,0,4,Mike Hawthorn
578,589,105,1956,Mike Hawthorn,Louis Chiron,4,0,4,Mike Hawthorn
578,607,105,1956,Mike Hawthorn,Cesare Perdisa,4,3,1,Mike Hawthorn
578,609,105,1956,Mike Hawthorn,AndrÃ© Simon,4,0,4,Mike Hawthorn
578,620,105,1956,Mike Hawthorn,Umberto Maglioli,4,0,4,Mike Hawthorn
578,622,105,1956,Mike Hawthorn,Chico Landi,4,2,2,Mike Hawthorn
578,623,105,1956,Mike Hawthorn,Alberto Uria,4,0,4,Mike Hawthorn
578,624,105,1956,Mike Hawthorn,Hernando da Silva Ramos,4,0,4,Mike Hawthorn
578,627,105,1956,Mike Hawthorn,Louis Rosier,4,2,2,Mike Hawthorn
578,633,105,1956,Mike Hawthorn,Luigi Villoresi,4,2,2,Mike Hawthorn
578,638,105,1956,Mike Hawthorn,Ottorino Volonterio,4,0,4,Mike Hawthorn
578,640,105,1956,Mike Hawthorn,Toulo de Graffenried,4,0,4,Mike Hawthorn
578,806,105,1956,Mike Hawthorn,Ã“scar GonzÃ¡lez,4,0,4,Mike Hawthorn
580,583,105,1956,Paco Godia,Gerino Gerini,6,2,4,Paco Godia
580,586,105,1956,Paco Godia,Luigi Piotti,6,0,6,Paco Godia
580,589,105,1956,Paco Godia,Louis Chiron,6,0,6,Paco Godia
580,607,105,1956,Paco Godia,Cesare Perdisa,6,3,3,Paco Godia
580,609,105,1956,Paco Godia,AndrÃ© Simon,6,0,6,Paco Godia
580,620,105,1956,Paco Godia,Umberto Maglioli,6,0,6,Paco Godia
580,622,105,1956,Paco Godia,Chico Landi,6,2,4,Paco Godia
580,623,105,1956,Paco Godia,Alberto Uria,6,0,6,Paco Godia
580,624,105,1956,Paco Godia,Hernando da Silva Ramos,6,0,6,Paco Godia
580,627,105,1956,Paco Godia,Louis Rosier,6,2,4,Paco Godia
580,633,105,1956,Paco Godia,Luigi Villoresi,6,2,4,Paco Godia
580,638,105,1956,Paco Godia,Ottorino Volonterio,6,0,6,Paco Godia
580,640,105,1956,Paco Godia,Toulo de Graffenried,6,0,6,Paco Godia
580,806,105,1956,Paco Godia,Ã“scar GonzÃ¡lez,6,0,6,Paco Godia
583,586,105,1956,Gerino Gerini,Luigi Piotti,2,0,2,Gerino Gerini
583,589,105,1956,Gerino Gerini,Louis Chiron,2,0,2,Gerino Gerini
583,607,105,1956,Gerino Gerini,Cesare Perdisa,2,3,1,Cesare Perdisa
583,609,105,1956,Gerino Gerini,AndrÃ© Simon,2,0,2,Gerino Gerini
583,620,105,1956,Gerino Gerini,Umberto Maglioli,2,0,2,Gerino Gerini
583,622,105,1956,Gerino Gerini,Chico Landi,2,2,0,Chico Landi
583,623,105,1956,Gerino Gerini,Alberto Uria,2,0,2,Gerino Gerini
583,624,105,1956,Gerino Gerini,Hernando da Silva Ramos,2,0,2,Gerino Gerini
583,627,105,1956,Gerino Gerini,Louis Rosier,2,2,0,Louis Rosier
583,633,105,1956,Gerino Gerini,Luigi Villoresi,2,2,0,Luigi Villoresi
583,638,105,1956,Gerino Gerini,Ottorino Volonterio,2,0,2,Gerino Gerini
583,640,105,1956,Gerino Gerini,Toulo de Graffenried,2,0,2,Gerino Gerini
583,806,105,1956,Gerino Gerini,Ã“scar GonzÃ¡lez,2,0,2,Gerino Gerini
586,589,105,1956,Luigi Piotti,Louis Chiron,0,0,0,Louis Chiron
586,607,105,1956,Luigi Piotti,Cesare Perdisa,0,3,3,Cesare Perdisa
586,609,105,1956,Luigi Piotti,AndrÃ© Simon,0,0,0,AndrÃ© Simon
586,620,105,1956,Luigi Piotti,Umberto Maglioli,0,0,0,Umberto Maglioli
586,622,105,1956,Luigi Piotti,Chico Landi,0,2,2,Chico Landi
586,623,105,1956,Luigi Piotti,Alberto Uria,0,0,0,Alberto Uria
586,624,105,1956,Luigi Piotti,Hernando da Silva Ramos,0,0,0,Hernando da Silva Ramos
586,627,105,1956,Luigi Piotti,Louis Rosier,0,2,2,Louis Rosier
586,633,105,1956,Luigi Piotti,Luigi Villoresi,0,2,2,Luigi Villoresi
586,638,105,1956,Luigi Piotti,Ottorino Volonterio,0,0,0,Ottorino Volonterio
586,640,105,1956,Luigi Piotti,Toulo de Graffenried,0,0,0,Toulo de Graffenried
586,806,105,1956,Luigi Piotti,Ã“scar GonzÃ¡lez,0,0,0,Ã“scar GonzÃ¡lez
589,607,105,1956,Louis Chiron,Cesare Perdisa,0,3,3,Cesare Perdisa
589,609,105,1956,Louis Chiron,AndrÃ© Simon,0,0,0,AndrÃ© Simon
589,620,105,1956,Louis Chiron,Umberto Maglioli,0,0,0,Umberto Maglioli
589,622,105,1956,Louis Chiron,Chico Landi,0,2,2,Chico Landi
589,623,105,1956,Louis Chiron,Alberto Uria,0,0,0,Alberto Uria
589,624,105,1956,Louis Chiron,Hernando da Silva Ramos,0,0,0,Hernando da Silva Ramos
589,627,105,1956,Louis Chiron,Louis Rosier,0,2,2,Louis Rosier
589,633,105,1956,Louis Chiron,Luigi Villoresi,0,2,2,Luigi Villoresi
589,638,105,1956,Louis Chiron,Ottorino Volonterio,0,0,0,Ottorino Volonterio
589,640,105,1956,Louis Chiron,Toulo de Graffenried,0,0,0,Toulo de Graffenried
589,806,105,1956,Louis Chiron,Ã“scar GonzÃ¡lez,0,0,0,Ã“scar GonzÃ¡lez
607,609,105,1956,Cesare Perdisa,AndrÃ© Simon,3,0,3,Cesare Perdisa
607,620,105,1956,Cesare Perdisa,Umberto Maglioli,3,0,3,Cesare Perdisa
607,622,105,1956,Cesare Perdisa,Chico Landi,3,2,1,Cesare Perdisa
607,623,105,1956,Cesare Perdisa,Alberto Uria,3,0,3,Cesare Perdisa
607,624,105,1956,Cesare Perdisa,Hernando da Silva Ramos,3,0,3,Cesare Perdisa
607,627,105,1956,Cesare Perdisa,Louis Rosier,3,2,1,Cesare Perdisa
607,633,105,1956,Cesare Perdisa,Luigi Villoresi,3,2,1,Cesare Perdisa
607,638,105,1956,Cesare Perdisa,Ottorino Volonterio,3,0,3,Cesare Perdisa
607,640,105,1956,Cesare Perdisa,Toulo de Graffenried,3,0,3,Cesare Perdisa
607,806,105,1956,Cesare Perdisa,Ã“scar GonzÃ¡lez,3,0,3,Cesare Perdisa
609,620,105,1956,AndrÃ© Simon,Umberto Maglioli,0,0,0,Umberto Maglioli
609,622,105,1956,AndrÃ© Simon,Chico Landi,0,2,2,Chico Landi
609,623,105,1956,AndrÃ© Simon,Alberto Uria,0,0,0,Alberto Uria
609,624,105,1956,AndrÃ© Simon,Hernando da Silva Ramos,0,0,0,Hernando da Silva Ramos
609,627,105,1956,AndrÃ© Simon,Louis Rosier,0,2,2,Louis Rosier
609,633,105,1956,AndrÃ© Simon,Luigi Villoresi,0,2,2,Luigi Villoresi
609,638,105,1956,AndrÃ© Simon,Ottorino Volonterio,0,0,0,Ottorino Volonterio
609,640,105,1956,AndrÃ© Simon,Toulo de Graffenried,0,0,0,Toulo de Graffenried
609,806,105,1956,AndrÃ© Simon,Ã“scar GonzÃ¡lez,0,0,0,Ã“scar GonzÃ¡lez
620,622,105,1956,Umberto Maglioli,Chico Landi,0,2,2,Chico Landi
620,623,105,1956,Umberto Maglioli,Alberto Uria,0,0,0,Alberto Uria
620,624,105,1956,Umberto Maglioli,Hernando da Silva Ramos,0,0,0,Hernando da Silva Ramos
620,627,105,1956,Umberto Maglioli,Louis Rosier,0,2,2,Louis Rosier
620,633,105,1956,Umberto Maglioli,Luigi Villoresi,0,2,2,Luigi Villoresi
620,638,105,1956,Umberto Maglioli,Ottorino Volonterio,0,0,0,Ottorino Volonterio
620,640,105,1956,Umberto Maglioli,Toulo de Graffenried,0,0,0,Toulo de Graffenried
620,806,105,1956,Umberto Maglioli,Ã“scar GonzÃ¡lez,0,0,0,Ã“scar GonzÃ¡lez
622,623,105,1956,Chico Landi,Alberto Uria,2,0,2,Chico Landi
622,624,105,1956,Chico Landi,Hernando da Silva Ramos,2,0,2,Chico Landi
622,627,105,1956,Chico Landi,Louis Rosier,2,2,0,Louis Rosier
622,633,105,1956,Chico Landi,Luigi Villoresi,2,2,0,Luigi Villoresi
622,638,105,1956,Chico Landi,Ottorino Volonterio,2,0,2,Chico Landi
622,640,105,1956,Chico Landi,Toulo de Graffenried,2,0,2,Chico Landi
622,806,105,1956,Chico Landi,Ã“scar GonzÃ¡lez,2,0,2,Chico Landi
623,624,105,1956,Alberto Uria,Hernando da Silva Ramos,0,0,0,Hernando da Silva Ramos
623,627,105,1956,Alberto Uria,Louis Rosier,0,2,2,Louis Rosier
623,633,105,1956,Alberto Uria,Luigi Villoresi,0,2,2,Luigi Villoresi
623,638,105,1956,Alberto Uria,Ottorino Volonterio,0,0,0,Ottorino Volonterio
623,640,105,1956,Alberto Uria,Toulo de Graffenried,0,0,0,Toulo de Graffenried
623,806,105,1956,Alberto Uria,Ã“scar GonzÃ¡lez,0,0,0,Ã“scar GonzÃ¡lez
624,627,105,1956,Hernando da Silva Ramos,Louis Rosier,0,2,2,Louis Rosier
624,633,105,1956,Hernando da Silva Ramos,Luigi Villoresi,0,2,2,Luigi Villoresi
624,638,105,1956,Hernando da Silva Ramos,Ottorino Volonterio,0,0,0,Ottorino Volonterio
624,640,105,1956,Hernando da Silva Ramos,Toulo de Graffenried,0,0,0,Toulo de Graffenried
624,806,105,1956,Hernando da Silva Ramos,Ã“scar GonzÃ¡lez,0,0,0,Ã“scar GonzÃ¡lez
627,633,105,1956,Louis Rosier,Luigi Villoresi,2,2,0,Luigi Villoresi
627,638,105,1956,Louis Rosier,Ottorino Volonterio,2,0,2,Louis Rosier
627,640,105,1956,Louis Rosier,Toulo de Graffenried,2,0,2,Louis Rosier
627,806,105,1956,Louis Rosier,Ã“scar GonzÃ¡lez,2,0,2,Louis Rosier
633,638,105,1956,Luigi Villoresi,Ottorino Volonterio,2,0,2,Luigi Villoresi
633,640,105,1956,Luigi Villoresi,Toulo de Graffenried,2,0,2,Luigi Villoresi
633,806,105,1956,Luigi Villoresi,Ã“scar GonzÃ¡lez,2,0,2,Luigi Villoresi
638,640,105,1956,Ottorino Volonterio,Toulo de Graffenried,0,0,0,Toulo de Graffenried
638,806,105,1956,Ottorino Volonterio,Ã“scar GonzÃ¡lez,0,0,0,Ã“scar GonzÃ¡lez
640,806,105,1956,Toulo de Graffenried,Ã“scar GonzÃ¡lez,0,0,0,Ã“scar GonzÃ¡lez
347,418,105,1957,Jo Bonnier,Masten Gregory,0,10,10,Masten Gregory
347,475,105,1957,Jo Bonnier,Stirling Moss,0,1,1,Stirling Moss
347,478,105,1957,Jo Bonnier,Hans Herrmann,0,0,0,Hans Herrmann
347,483,105,1957,Jo Bonnier,Giorgio Scarlatti,0,1,1,Giorgio Scarlatti
347,496,105,1957,Jo Bonnier,Carlos Menditeguy,0,4,4,Carlos Menditeguy
347,501,105,1957,Jo Bonnier,Harry Schell,0,10,10,Harry Schell
347,506,105,1957,Jo Bonnier,Bruce Halford,0,0,0,Bruce Halford
347,547,105,1957,Jo Bonnier,Horace Gould,0,0,0,Horace Gould
347,549,105,1957,Jo Bonnier,Ivor Bueb,0,0,0,Ivor Bueb
347,554,105,1957,Jo Bonnier,Jean Behra,0,6,6,Jean Behra
347,579,105,1957,Jo Bonnier,Juan Fangio,0,46,46,Juan Fangio
347,580,105,1957,Jo Bonnier,Paco Godia,0,0,0,Paco Godia
347,586,105,1957,Jo Bonnier,Luigi Piotti,0,0,0,Luigi Piotti
347,609,105,1957,Jo Bonnier,AndrÃ© Simon,0,0,0,AndrÃ© Simon
347,638,105,1957,Jo Bonnier,Ottorino Volonterio,0,0,0,Ottorino Volonterio
418,475,105,1957,Masten Gregory,Stirling Moss,10,1,9,Masten Gregory
418,478,105,1957,Masten Gregory,Hans Herrmann,10,0,10,Masten Gregory
418,483,105,1957,Masten Gregory,Giorgio Scarlatti,10,1,9,Masten Gregory
418,496,105,1957,Masten Gregory,Carlos Menditeguy,10,4,6,Masten Gregory
418,501,105,1957,Masten Gregory,Harry Schell,10,10,0,Harry Schell
418,506,105,1957,Masten Gregory,Bruce Halford,10,0,10,Masten Gregory
418,547,105,1957,Masten Gregory,Horace Gould,10,0,10,Masten Gregory
418,549,105,1957,Masten Gregory,Ivor Bueb,10,0,10,Masten Gregory
418,554,105,1957,Masten Gregory,Jean Behra,10,6,4,Masten Gregory
418,579,105,1957,Masten Gregory,Juan Fangio,10,46,36,Juan Fangio
418,580,105,1957,Masten Gregory,Paco Godia,10,0,10,Masten Gregory
418,586,105,1957,Masten Gregory,Luigi Piotti,10,0,10,Masten Gregory
418,609,105,1957,Masten Gregory,AndrÃ© Simon,10,0,10,Masten Gregory
418,638,105,1957,Masten Gregory,Ottorino Volonterio,10,0,10,Masten Gregory
475,478,105,1957,Stirling Moss,Hans Herrmann,1,0,1,Stirling Moss
475,483,105,1957,Stirling Moss,Giorgio Scarlatti,1,1,0,Giorgio Scarlatti
475,496,105,1957,Stirling Moss,Carlos Menditeguy,1,4,3,Carlos Menditeguy
475,501,105,1957,Stirling Moss,Harry Schell,1,10,9,Harry Schell
475,506,105,1957,Stirling Moss,Bruce Halford,1,0,1,Stirling Moss
475,547,105,1957,Stirling Moss,Horace Gould,1,0,1,Stirling Moss
475,549,105,1957,Stirling Moss,Ivor Bueb,1,0,1,Stirling Moss
475,554,105,1957,Stirling Moss,Jean Behra,1,6,5,Jean Behra
475,579,105,1957,Stirling Moss,Juan Fangio,1,46,45,Juan Fangio
475,580,105,1957,Stirling Moss,Paco Godia,1,0,1,Stirling Moss
475,586,105,1957,Stirling Moss,Luigi Piotti,1,0,1,Stirling Moss
475,609,105,1957,Stirling Moss,AndrÃ© Simon,1,0,1,Stirling Moss
475,638,105,1957,Stirling Moss,Ottorino Volonterio,1,0,1,Stirling Moss
478,483,105,1957,Hans Herrmann,Giorgio Scarlatti,0,1,1,Giorgio Scarlatti
478,496,105,1957,Hans Herrmann,Carlos Menditeguy,0,4,4,Carlos Menditeguy
478,501,105,1957,Hans Herrmann,Harry Schell,0,10,10,Harry Schell
478,506,105,1957,Hans Herrmann,Bruce Halford,0,0,0,Bruce Halford
478,547,105,1957,Hans Herrmann,Horace Gould,0,0,0,Horace Gould
478,549,105,1957,Hans Herrmann,Ivor Bueb,0,0,0,Ivor Bueb
478,554,105,1957,Hans Herrmann,Jean Behra,0,6,6,Jean Behra
478,579,105,1957,Hans Herrmann,Juan Fangio,0,46,46,Juan Fangio
478,580,105,1957,Hans Herrmann,Paco Godia,0,0,0,Paco Godia
478,586,105,1957,Hans Herrmann,Luigi Piotti,0,0,0,Luigi Piotti
478,609,105,1957,Hans Herrmann,AndrÃ© Simon,0,0,0,AndrÃ© Simon
478,638,105,1957,Hans Herrmann,Ottorino Volonterio,0,0,0,Ottorino Volonterio
483,496,105,1957,Giorgio Scarlatti,Carlos Menditeguy,1,4,3,Carlos Menditeguy
483,501,105,1957,Giorgio Scarlatti,Harry Schell,1,10,9,Harry Schell
483,506,105,1957,Giorgio Scarlatti,Bruce Halford,1,0,1,Giorgio Scarlatti
483,547,105,1957,Giorgio Scarlatti,Horace Gould,1,0,1,Giorgio Scarlatti
483,549,105,1957,Giorgio Scarlatti,Ivor Bueb,1,0,1,Giorgio Scarlatti
483,554,105,1957,Giorgio Scarlatti,Jean Behra,1,6,5,Jean Behra
483,579,105,1957,Giorgio Scarlatti,Juan Fangio,1,46,45,Juan Fangio
483,580,105,1957,Giorgio Scarlatti,Paco Godia,1,0,1,Giorgio Scarlatti
483,586,105,1957,Giorgio Scarlatti,Luigi Piotti,1,0,1,Giorgio Scarlatti
483,609,105,1957,Giorgio Scarlatti,AndrÃ© Simon,1,0,1,Giorgio Scarlatti
483,638,105,1957,Giorgio Scarlatti,Ottorino Volonterio,1,0,1,Giorgio Scarlatti
496,501,105,1957,Carlos Menditeguy,Harry Schell,4,10,6,Harry Schell
496,506,105,1957,Carlos Menditeguy,Bruce Halford,4,0,4,Carlos Menditeguy
496,547,105,1957,Carlos Menditeguy,Horace Gould,4,0,4,Carlos Menditeguy
496,549,105,1957,Carlos Menditeguy,Ivor Bueb,4,0,4,Carlos Menditeguy
496,554,105,1957,Carlos Menditeguy,Jean Behra,4,6,2,Jean Behra
496,579,105,1957,Carlos Menditeguy,Juan Fangio,4,46,42,Juan Fangio
496,580,105,1957,Carlos Menditeguy,Paco Godia,4,0,4,Carlos Menditeguy
496,586,105,1957,Carlos Menditeguy,Luigi Piotti,4,0,4,Carlos Menditeguy
496,609,105,1957,Carlos Menditeguy,AndrÃ© Simon,4,0,4,Carlos Menditeguy
496,638,105,1957,Carlos Menditeguy,Ottorino Volonterio,4,0,4,Carlos Menditeguy
501,506,105,1957,Harry Schell,Bruce Halford,10,0,10,Harry Schell
501,547,105,1957,Harry Schell,Horace Gould,10,0,10,Harry Schell
501,549,105,1957,Harry Schell,Ivor Bueb,10,0,10,Harry Schell
501,554,105,1957,Harry Schell,Jean Behra,10,6,4,Harry Schell
501,579,105,1957,Harry Schell,Juan Fangio,10,46,36,Juan Fangio
501,580,105,1957,Harry Schell,Paco Godia,10,0,10,Harry Schell
501,586,105,1957,Harry Schell,Luigi Piotti,10,0,10,Harry Schell
501,609,105,1957,Harry Schell,AndrÃ© Simon,10,0,10,Harry Schell
501,638,105,1957,Harry Schell,Ottorino Volonterio,10,0,10,Harry Schell
506,547,105,1957,Bruce Halford,Horace Gould,0,0,0,Horace Gould
506,549,105,1957,Bruce Halford,Ivor Bueb,0,0,0,Ivor Bueb
506,554,105,1957,Bruce Halford,Jean Behra,0,6,6,Jean Behra
506,579,105,1957,Bruce Halford,Juan Fangio,0,46,46,Juan Fangio
506,580,105,1957,Bruce Halford,Paco Godia,0,0,0,Paco Godia
506,586,105,1957,Bruce Halford,Luigi Piotti,0,0,0,Luigi Piotti
506,609,105,1957,Bruce Halford,AndrÃ© Simon,0,0,0,AndrÃ© Simon
506,638,105,1957,Bruce Halford,Ottorino Volonterio,0,0,0,Ottorino Volonterio
547,549,105,1957,Horace Gould,Ivor Bueb,0,0,0,Ivor Bueb
547,554,105,1957,Horace Gould,Jean Behra,0,6,6,Jean Behra
547,579,105,1957,Horace Gould,Juan Fangio,0,46,46,Juan Fangio
547,580,105,1957,Horace Gould,Paco Godia,0,0,0,Paco Godia
547,586,105,1957,Horace Gould,Luigi Piotti,0,0,0,Luigi Piotti
547,609,105,1957,Horace Gould,AndrÃ© Simon,0,0,0,AndrÃ© Simon
547,638,105,1957,Horace Gould,Ottorino Volonterio,0,0,0,Ottorino Volonterio
549,554,105,1957,Ivor Bueb,Jean Behra,0,6,6,Jean Behra
549,579,105,1957,Ivor Bueb,Juan Fangio,0,46,46,Juan Fangio
549,580,105,1957,Ivor Bueb,Paco Godia,0,0,0,Paco Godia
549,586,105,1957,Ivor Bueb,Luigi Piotti,0,0,0,Luigi Piotti
549,609,105,1957,Ivor Bueb,AndrÃ© Simon,0,0,0,AndrÃ© Simon
549,638,105,1957,Ivor Bueb,Ottorino Volonterio,0,0,0,Ottorino Volonterio
554,579,105,1957,Jean Behra,Juan Fangio,6,46,40,Juan Fangio
554,580,105,1957,Jean Behra,Paco Godia,6,0,6,Jean Behra
554,586,105,1957,Jean Behra,Luigi Piotti,6,0,6,Jean Behra
554,609,105,1957,Jean Behra,AndrÃ© Simon,6,0,6,Jean Behra
554,638,105,1957,Jean Behra,Ottorino Volonterio,6,0,6,Jean Behra
579,580,105,1957,Juan Fangio,Paco Godia,46,0,46,Juan Fangio
579,586,105,1957,Juan Fangio,Luigi Piotti,46,0,46,Juan Fangio
579,609,105,1957,Juan Fangio,AndrÃ© Simon,46,0,46,Juan Fangio
579,638,105,1957,Juan Fangio,Ottorino Volonterio,46,0,46,Juan Fangio
580,586,105,1957,Paco Godia,Luigi Piotti,0,0,0,Luigi Piotti
580,609,105,1957,Paco Godia,AndrÃ© Simon,0,0,0,AndrÃ© Simon
580,638,105,1957,Paco Godia,Ottorino Volonterio,0,0,0,Ottorino Volonterio
586,609,105,1957,Luigi Piotti,AndrÃ© Simon,0,0,0,AndrÃ© Simon
586,638,105,1957,Luigi Piotti,Ottorino Volonterio,0,0,0,Ottorino Volonterio
609,638,105,1957,AndrÃ© Simon,Ottorino Volonterio,0,0,0,Ottorino Volonterio
347,403,105,1958,Jo Bonnier,Phil Hill,0,0,0,Phil Hill
347,418,105,1958,Jo Bonnier,Masten Gregory,0,0,0,Masten Gregory
347,427,105,1958,Jo Bonnier,Maurice Trintignant,0,0,0,Maurice Trintignant
347,455,105,1958,Jo Bonnier,Wolfgang Seidel,0,0,0,Wolfgang Seidel
347,477,105,1958,Jo Bonnier,Cliff Allison,0,0,0,Cliff Allison
347,478,105,1958,Jo Bonnier,Hans Herrmann,0,0,0,Hans Herrmann
347,483,105,1958,Jo Bonnier,Giorgio Scarlatti,0,0,0,Giorgio Scarlatti
347,496,105,1958,Jo Bonnier,Carlos Menditeguy,0,0,0,Carlos Menditeguy
347,501,105,1958,Jo Bonnier,Harry Schell,0,0,0,Harry Schell
347,526,105,1958,Jo Bonnier,Troy Ruttman,0,0,0,Troy Ruttman
347,543,105,1958,Jo Bonnier,Giulio Cabianca,0,0,0,Giulio Cabianca
347,547,105,1958,Jo Bonnier,Horace Gould,0,0,0,Horace Gould
347,551,105,1958,Jo Bonnier,Maria de Filippis,0,0,0,Maria de Filippis
347,553,105,1958,Jo Bonnier,AndrÃ© Testut,0,0,0,AndrÃ© Testut
347,554,105,1958,Jo Bonnier,Jean Behra,0,2,2,Jean Behra
347,566,105,1958,Jo Bonnier,Carroll Shelby,0,0,0,Carroll Shelby
347,579,105,1958,Jo Bonnier,Juan Fangio,0,7,7,Juan Fangio
347,580,105,1958,Jo Bonnier,Paco Godia,0,0,0,Paco Godia
347,582,105,1958,Jo Bonnier,Ken Kavanagh,0,0,0,Ken Kavanagh
347,583,105,1958,Jo Bonnier,Gerino Gerini,0,0,0,Gerino Gerini
347,588,105,1958,Jo Bonnier,Luigi Taramazzo,0,0,0,Luigi Taramazzo
347,589,105,1958,Jo Bonnier,Louis Chiron,0,0,0,Louis Chiron
403,418,105,1958,Phil Hill,Masten Gregory,0,0,0,Masten Gregory
403,427,105,1958,Phil Hill,Maurice Trintignant,0,0,0,Maurice Trintignant
403,455,105,1958,Phil Hill,Wolfgang Seidel,0,0,0,Wolfgang Seidel
403,477,105,1958,Phil Hill,Cliff Allison,0,0,0,Cliff Allison
403,478,105,1958,Phil Hill,Hans Herrmann,0,0,0,Hans Herrmann
403,483,105,1958,Phil Hill,Giorgio Scarlatti,0,0,0,Giorgio Scarlatti
403,496,105,1958,Phil Hill,Carlos Menditeguy,0,0,0,Carlos Menditeguy
403,501,105,1958,Phil Hill,Harry Schell,0,0,0,Harry Schell
403,526,105,1958,Phil Hill,Troy Ruttman,0,0,0,Troy Ruttman
403,543,105,1958,Phil Hill,Giulio Cabianca,0,0,0,Giulio Cabianca
403,547,105,1958,Phil Hill,Horace Gould,0,0,0,Horace Gould
403,551,105,1958,Phil Hill,Maria de Filippis,0,0,0,Maria de Filippis
403,553,105,1958,Phil Hill,AndrÃ© Testut,0,0,0,AndrÃ© Testut
403,554,105,1958,Phil Hill,Jean Behra,0,2,2,Jean Behra
403,566,105,1958,Phil Hill,Carroll Shelby,0,0,0,Carroll Shelby
403,579,105,1958,Phil Hill,Juan Fangio,0,7,7,Juan Fangio
403,580,105,1958,Phil Hill,Paco Godia,0,0,0,Paco Godia
403,582,105,1958,Phil Hill,Ken Kavanagh,0,0,0,Ken Kavanagh
403,583,105,1958,Phil Hill,Gerino Gerini,0,0,0,Gerino Gerini
403,588,105,1958,Phil Hill,Luigi Taramazzo,0,0,0,Luigi Taramazzo
403,589,105,1958,Phil Hill,Louis Chiron,0,0,0,Louis Chiron
418,427,105,1958,Masten Gregory,Maurice Trintignant,0,0,0,Maurice Trintignant
418,455,105,1958,Masten Gregory,Wolfgang Seidel,0,0,0,Wolfgang Seidel
418,477,105,1958,Masten Gregory,Cliff Allison,0,0,0,Cliff Allison
418,478,105,1958,Masten Gregory,Hans Herrmann,0,0,0,Hans Herrmann
418,483,105,1958,Masten Gregory,Giorgio Scarlatti,0,0,0,Giorgio Scarlatti
418,496,105,1958,Masten Gregory,Carlos Menditeguy,0,0,0,Carlos Menditeguy
418,501,105,1958,Masten Gregory,Harry Schell,0,0,0,Harry Schell
418,526,105,1958,Masten Gregory,Troy Ruttman,0,0,0,Troy Ruttman
418,543,105,1958,Masten Gregory,Giulio Cabianca,0,0,0,Giulio Cabianca
418,547,105,1958,Masten Gregory,Horace Gould,0,0,0,Horace Gould
418,551,105,1958,Masten Gregory,Maria de Filippis,0,0,0,Maria de Filippis
418,553,105,1958,Masten Gregory,AndrÃ© Testut,0,0,0,AndrÃ© Testut
418,554,105,1958,Masten Gregory,Jean Behra,0,2,2,Jean Behra
418,566,105,1958,Masten Gregory,Carroll Shelby,0,0,0,Carroll Shelby
418,579,105,1958,Masten Gregory,Juan Fangio,0,7,7,Juan Fangio
418,580,105,1958,Masten Gregory,Paco Godia,0,0,0,Paco Godia
418,582,105,1958,Masten Gregory,Ken Kavanagh,0,0,0,Ken Kavanagh
418,583,105,1958,Masten Gregory,Gerino Gerini,0,0,0,Gerino Gerini
418,588,105,1958,Masten Gregory,Luigi Taramazzo,0,0,0,Luigi Taramazzo
418,589,105,1958,Masten Gregory,Louis Chiron,0,0,0,Louis Chiron
427,455,105,1958,Maurice Trintignant,Wolfgang Seidel,0,0,0,Wolfgang Seidel
427,477,105,1958,Maurice Trintignant,Cliff Allison,0,0,0,Cliff Allison
427,478,105,1958,Maurice Trintignant,Hans Herrmann,0,0,0,Hans Herrmann
427,483,105,1958,Maurice Trintignant,Giorgio Scarlatti,0,0,0,Giorgio Scarlatti
427,496,105,1958,Maurice Trintignant,Carlos Menditeguy,0,0,0,Carlos Menditeguy
427,501,105,1958,Maurice Trintignant,Harry Schell,0,0,0,Harry Schell
427,526,105,1958,Maurice Trintignant,Troy Ruttman,0,0,0,Troy Ruttman
427,543,105,1958,Maurice Trintignant,Giulio Cabianca,0,0,0,Giulio Cabianca
427,547,105,1958,Maurice Trintignant,Horace Gould,0,0,0,Horace Gould
427,551,105,1958,Maurice Trintignant,Maria de Filippis,0,0,0,Maria de Filippis
427,553,105,1958,Maurice Trintignant,AndrÃ© Testut,0,0,0,AndrÃ© Testut
427,554,105,1958,Maurice Trintignant,Jean Behra,0,2,2,Jean Behra
427,566,105,1958,Maurice Trintignant,Carroll Shelby,0,0,0,Carroll Shelby
427,579,105,1958,Maurice Trintignant,Juan Fangio,0,7,7,Juan Fangio
427,580,105,1958,Maurice Trintignant,Paco Godia,0,0,0,Paco Godia
427,582,105,1958,Maurice Trintignant,Ken Kavanagh,0,0,0,Ken Kavanagh
427,583,105,1958,Maurice Trintignant,Gerino Gerini,0,0,0,Gerino Gerini
427,588,105,1958,Maurice Trintignant,Luigi Taramazzo,0,0,0,Luigi Taramazzo
427,589,105,1958,Maurice Trintignant,Louis Chiron,0,0,0,Louis Chiron
455,477,105,1958,Wolfgang Seidel,Cliff Allison,0,0,0,Cliff Allison
455,478,105,1958,Wolfgang Seidel,Hans Herrmann,0,0,0,Hans Herrmann
455,483,105,1958,Wolfgang Seidel,Giorgio Scarlatti,0,0,0,Giorgio Scarlatti
455,496,105,1958,Wolfgang Seidel,Carlos Menditeguy,0,0,0,Carlos Menditeguy
455,501,105,1958,Wolfgang Seidel,Harry Schell,0,0,0,Harry Schell
455,526,105,1958,Wolfgang Seidel,Troy Ruttman,0,0,0,Troy Ruttman
455,543,105,1958,Wolfgang Seidel,Giulio Cabianca,0,0,0,Giulio Cabianca
455,547,105,1958,Wolfgang Seidel,Horace Gould,0,0,0,Horace Gould
455,551,105,1958,Wolfgang Seidel,Maria de Filippis,0,0,0,Maria de Filippis
455,553,105,1958,Wolfgang Seidel,AndrÃ© Testut,0,0,0,AndrÃ© Testut
455,554,105,1958,Wolfgang Seidel,Jean Behra,0,2,2,Jean Behra
455,566,105,1958,Wolfgang Seidel,Carroll Shelby,0,0,0,Carroll Shelby
455,579,105,1958,Wolfgang Seidel,Juan Fangio,0,7,7,Juan Fangio
455,580,105,1958,Wolfgang Seidel,Paco Godia,0,0,0,Paco Godia
455,582,105,1958,Wolfgang Seidel,Ken Kavanagh,0,0,0,Ken Kavanagh
455,583,105,1958,Wolfgang Seidel,Gerino Gerini,0,0,0,Gerino Gerini
455,588,105,1958,Wolfgang Seidel,Luigi Taramazzo,0,0,0,Luigi Taramazzo
455,589,105,1958,Wolfgang Seidel,Louis Chiron,0,0,0,Louis Chiron
477,478,105,1958,Cliff Allison,Hans Herrmann,0,0,0,Hans Herrmann
477,483,105,1958,Cliff Allison,Giorgio Scarlatti,0,0,0,Giorgio Scarlatti
477,496,105,1958,Cliff Allison,Carlos Menditeguy,0,0,0,Carlos Menditeguy
477,501,105,1958,Cliff Allison,Harry Schell,0,0,0,Harry Schell
477,526,105,1958,Cliff Allison,Troy Ruttman,0,0,0,Troy Ruttman
477,543,105,1958,Cliff Allison,Giulio Cabianca,0,0,0,Giulio Cabianca
477,547,105,1958,Cliff Allison,Horace Gould,0,0,0,Horace Gould
477,551,105,1958,Cliff Allison,Maria de Filippis,0,0,0,Maria de Filippis
477,553,105,1958,Cliff Allison,AndrÃ© Testut,0,0,0,AndrÃ© Testut
477,554,105,1958,Cliff Allison,Jean Behra,0,2,2,Jean Behra
477,566,105,1958,Cliff Allison,Carroll Shelby,0,0,0,Carroll Shelby
477,579,105,1958,Cliff Allison,Juan Fangio,0,7,7,Juan Fangio
477,580,105,1958,Cliff Allison,Paco Godia,0,0,0,Paco Godia
477,582,105,1958,Cliff Allison,Ken Kavanagh,0,0,0,Ken Kavanagh
477,583,105,1958,Cliff Allison,Gerino Gerini,0,0,0,Gerino Gerini
477,588,105,1958,Cliff Allison,Luigi Taramazzo,0,0,0,Luigi Taramazzo
477,589,105,1958,Cliff Allison,Louis Chiron,0,0,0,Louis Chiron
478,483,105,1958,Hans Herrmann,Giorgio Scarlatti,0,0,0,Giorgio Scarlatti
478,496,105,1958,Hans Herrmann,Carlos Menditeguy,0,0,0,Carlos Menditeguy
478,501,105,1958,Hans Herrmann,Harry Schell,0,0,0,Harry Schell
478,526,105,1958,Hans Herrmann,Troy Ruttman,0,0,0,Troy Ruttman
478,543,105,1958,Hans Herrmann,Giulio Cabianca,0,0,0,Giulio Cabianca
478,547,105,1958,Hans Herrmann,Horace Gould,0,0,0,Horace Gould
478,551,105,1958,Hans Herrmann,Maria de Filippis,0,0,0,Maria de Filippis
478,553,105,1958,Hans Herrmann,AndrÃ© Testut,0,0,0,AndrÃ© Testut
478,554,105,1958,Hans Herrmann,Jean Behra,0,2,2,Jean Behra
478,566,105,1958,Hans Herrmann,Carroll Shelby,0,0,0,Carroll Shelby
478,579,105,1958,Hans Herrmann,Juan Fangio,0,7,7,Juan Fangio
478,580,105,1958,Hans Herrmann,Paco Godia,0,0,0,Paco Godia
478,582,105,1958,Hans Herrmann,Ken Kavanagh,0,0,0,Ken Kavanagh
478,583,105,1958,Hans Herrmann,Gerino Gerini,0,0,0,Gerino Gerini
478,588,105,1958,Hans Herrmann,Luigi Taramazzo,0,0,0,Luigi Taramazzo
478,589,105,1958,Hans Herrmann,Louis Chiron,0,0,0,Louis Chiron
483,496,105,1958,Giorgio Scarlatti,Carlos Menditeguy,0,0,0,Carlos Menditeguy
483,501,105,1958,Giorgio Scarlatti,Harry Schell,0,0,0,Harry Schell
483,526,105,1958,Giorgio Scarlatti,Troy Ruttman,0,0,0,Troy Ruttman
483,543,105,1958,Giorgio Scarlatti,Giulio Cabianca,0,0,0,Giulio Cabianca
483,547,105,1958,Giorgio Scarlatti,Horace Gould,0,0,0,Horace Gould
483,551,105,1958,Giorgio Scarlatti,Maria de Filippis,0,0,0,Maria de Filippis
483,553,105,1958,Giorgio Scarlatti,AndrÃ© Testut,0,0,0,AndrÃ© Testut
483,554,105,1958,Giorgio Scarlatti,Jean Behra,0,2,2,Jean Behra
483,566,105,1958,Giorgio Scarlatti,Carroll Shelby,0,0,0,Carroll Shelby
483,579,105,1958,Giorgio Scarlatti,Juan Fangio,0,7,7,Juan Fangio
483,580,105,1958,Giorgio Scarlatti,Paco Godia,0,0,0,Paco Godia
483,582,105,1958,Giorgio Scarlatti,Ken Kavanagh,0,0,0,Ken Kavanagh
483,583,105,1958,Giorgio Scarlatti,Gerino Gerini,0,0,0,Gerino Gerini
483,588,105,1958,Giorgio Scarlatti,Luigi Taramazzo,0,0,0,Luigi Taramazzo
483,589,105,1958,Giorgio Scarlatti,Louis Chiron,0,0,0,Louis Chiron
496,501,105,1958,Carlos Menditeguy,Harry Schell,0,0,0,Harry Schell
496,526,105,1958,Carlos Menditeguy,Troy Ruttman,0,0,0,Troy Ruttman
496,543,105,1958,Carlos Menditeguy,Giulio Cabianca,0,0,0,Giulio Cabianca
496,547,105,1958,Carlos Menditeguy,Horace Gould,0,0,0,Horace Gould
496,551,105,1958,Carlos Menditeguy,Maria de Filippis,0,0,0,Maria de Filippis
496,553,105,1958,Carlos Menditeguy,AndrÃ© Testut,0,0,0,AndrÃ© Testut
496,554,105,1958,Carlos Menditeguy,Jean Behra,0,2,2,Jean Behra
496,566,105,1958,Carlos Menditeguy,Carroll Shelby,0,0,0,Carroll Shelby
496,579,105,1958,Carlos Menditeguy,Juan Fangio,0,7,7,Juan Fangio
496,580,105,1958,Carlos Menditeguy,Paco Godia,0,0,0,Paco Godia
496,582,105,1958,Carlos Menditeguy,Ken Kavanagh,0,0,0,Ken Kavanagh
496,583,105,1958,Carlos Menditeguy,Gerino Gerini,0,0,0,Gerino Gerini
496,588,105,1958,Carlos Menditeguy,Luigi Taramazzo,0,0,0,Luigi Taramazzo
496,589,105,1958,Carlos Menditeguy,Louis Chiron,0,0,0,Louis Chiron
501,526,105,1958,Harry Schell,Troy Ruttman,0,0,0,Troy Ruttman
501,543,105,1958,Harry Schell,Giulio Cabianca,0,0,0,Giulio Cabianca
501,547,105,1958,Harry Schell,Horace Gould,0,0,0,Horace Gould
501,551,105,1958,Harry Schell,Maria de Filippis,0,0,0,Maria de Filippis
501,553,105,1958,Harry Schell,AndrÃ© Testut,0,0,0,AndrÃ© Testut
501,554,105,1958,Harry Schell,Jean Behra,0,2,2,Jean Behra
501,566,105,1958,Harry Schell,Carroll Shelby,0,0,0,Carroll Shelby
501,579,105,1958,Harry Schell,Juan Fangio,0,7,7,Juan Fangio
501,580,105,1958,Harry Schell,Paco Godia,0,0,0,Paco Godia
501,582,105,1958,Harry Schell,Ken Kavanagh,0,0,0,Ken Kavanagh
501,583,105,1958,Harry Schell,Gerino Gerini,0,0,0,Gerino Gerini
501,588,105,1958,Harry Schell,Luigi Taramazzo,0,0,0,Luigi Taramazzo
501,589,105,1958,Harry Schell,Louis Chiron,0,0,0,Louis Chiron
526,543,105,1958,Troy Ruttman,Giulio Cabianca,0,0,0,Giulio Cabianca
526,547,105,1958,Troy Ruttman,Horace Gould,0,0,0,Horace Gould
526,551,105,1958,Troy Ruttman,Maria de Filippis,0,0,0,Maria de Filippis
526,553,105,1958,Troy Ruttman,AndrÃ© Testut,0,0,0,AndrÃ© Testut
526,554,105,1958,Troy Ruttman,Jean Behra,0,2,2,Jean Behra
526,566,105,1958,Troy Ruttman,Carroll Shelby,0,0,0,Carroll Shelby
526,579,105,1958,Troy Ruttman,Juan Fangio,0,7,7,Juan Fangio
526,580,105,1958,Troy Ruttman,Paco Godia,0,0,0,Paco Godia
526,582,105,1958,Troy Ruttman,Ken Kavanagh,0,0,0,Ken Kavanagh
526,583,105,1958,Troy Ruttman,Gerino Gerini,0,0,0,Gerino Gerini
526,588,105,1958,Troy Ruttman,Luigi Taramazzo,0,0,0,Luigi Taramazzo
526,589,105,1958,Troy Ruttman,Louis Chiron,0,0,0,Louis Chiron
543,547,105,1958,Giulio Cabianca,Horace Gould,0,0,0,Horace Gould
543,551,105,1958,Giulio Cabianca,Maria de Filippis,0,0,0,Maria de Filippis
543,553,105,1958,Giulio Cabianca,AndrÃ© Testut,0,0,0,AndrÃ© Testut
543,554,105,1958,Giulio Cabianca,Jean Behra,0,2,2,Jean Behra
543,566,105,1958,Giulio Cabianca,Carroll Shelby,0,0,0,Carroll Shelby
543,579,105,1958,Giulio Cabianca,Juan Fangio,0,7,7,Juan Fangio
543,580,105,1958,Giulio Cabianca,Paco Godia,0,0,0,Paco Godia
543,582,105,1958,Giulio Cabianca,Ken Kavanagh,0,0,0,Ken Kavanagh
543,583,105,1958,Giulio Cabianca,Gerino Gerini,0,0,0,Gerino Gerini
543,588,105,1958,Giulio Cabianca,Luigi Taramazzo,0,0,0,Luigi Taramazzo
543,589,105,1958,Giulio Cabianca,Louis Chiron,0,0,0,Louis Chiron
547,551,105,1958,Horace Gould,Maria de Filippis,0,0,0,Maria de Filippis
547,553,105,1958,Horace Gould,AndrÃ© Testut,0,0,0,AndrÃ© Testut
547,554,105,1958,Horace Gould,Jean Behra,0,2,2,Jean Behra
547,566,105,1958,Horace Gould,Carroll Shelby,0,0,0,Carroll Shelby
547,579,105,1958,Horace Gould,Juan Fangio,0,7,7,Juan Fangio
547,580,105,1958,Horace Gould,Paco Godia,0,0,0,Paco Godia
547,582,105,1958,Horace Gould,Ken Kavanagh,0,0,0,Ken Kavanagh
547,583,105,1958,Horace Gould,Gerino Gerini,0,0,0,Gerino Gerini
547,588,105,1958,Horace Gould,Luigi Taramazzo,0,0,0,Luigi Taramazzo
547,589,105,1958,Horace Gould,Louis Chiron,0,0,0,Louis Chiron
551,553,105,1958,Maria de Filippis,AndrÃ© Testut,0,0,0,AndrÃ© Testut
551,554,105,1958,Maria de Filippis,Jean Behra,0,2,2,Jean Behra
551,566,105,1958,Maria de Filippis,Carroll Shelby,0,0,0,Carroll Shelby
551,579,105,1958,Maria de Filippis,Juan Fangio,0,7,7,Juan Fangio
551,580,105,1958,Maria de Filippis,Paco Godia,0,0,0,Paco Godia
551,582,105,1958,Maria de Filippis,Ken Kavanagh,0,0,0,Ken Kavanagh
551,583,105,1958,Maria de Filippis,Gerino Gerini,0,0,0,Gerino Gerini
551,588,105,1958,Maria de Filippis,Luigi Taramazzo,0,0,0,Luigi Taramazzo
551,589,105,1958,Maria de Filippis,Louis Chiron,0,0,0,Louis Chiron
553,554,105,1958,AndrÃ© Testut,Jean Behra,0,2,2,Jean Behra
553,566,105,1958,AndrÃ© Testut,Carroll Shelby,0,0,0,Carroll Shelby
553,579,105,1958,AndrÃ© Testut,Juan Fangio,0,7,7,Juan Fangio
553,580,105,1958,AndrÃ© Testut,Paco Godia,0,0,0,Paco Godia
553,582,105,1958,AndrÃ© Testut,Ken Kavanagh,0,0,0,Ken Kavanagh
553,583,105,1958,AndrÃ© Testut,Gerino Gerini,0,0,0,Gerino Gerini
553,588,105,1958,AndrÃ© Testut,Luigi Taramazzo,0,0,0,Luigi Taramazzo
553,589,105,1958,AndrÃ© Testut,Louis Chiron,0,0,0,Louis Chiron
554,566,105,1958,Jean Behra,Carroll Shelby,2,0,2,Jean Behra
554,579,105,1958,Jean Behra,Juan Fangio,2,7,5,Juan Fangio
554,580,105,1958,Jean Behra,Paco Godia,2,0,2,Jean Behra
554,582,105,1958,Jean Behra,Ken Kavanagh,2,0,2,Jean Behra
554,583,105,1958,Jean Behra,Gerino Gerini,2,0,2,Jean Behra
554,588,105,1958,Jean Behra,Luigi Taramazzo,2,0,2,Jean Behra
554,589,105,1958,Jean Behra,Louis Chiron,2,0,2,Jean Behra
566,579,105,1958,Carroll Shelby,Juan Fangio,0,7,7,Juan Fangio
566,580,105,1958,Carroll Shelby,Paco Godia,0,0,0,Paco Godia
566,582,105,1958,Carroll Shelby,Ken Kavanagh,0,0,0,Ken Kavanagh
566,583,105,1958,Carroll Shelby,Gerino Gerini,0,0,0,Gerino Gerini
566,588,105,1958,Carroll Shelby,Luigi Taramazzo,0,0,0,Luigi Taramazzo
566,589,105,1958,Carroll Shelby,Louis Chiron,0,0,0,Louis Chiron
579,580,105,1958,Juan Fangio,Paco Godia,7,0,7,Juan Fangio
579,582,105,1958,Juan Fangio,Ken Kavanagh,7,0,7,Juan Fangio
579,583,105,1958,Juan Fangio,Gerino Gerini,7,0,7,Juan Fangio
579,588,105,1958,Juan Fangio,Luigi Taramazzo,7,0,7,Juan Fangio
579,589,105,1958,Juan Fangio,Louis Chiron,7,0,7,Juan Fangio
580,582,105,1958,Paco Godia,Ken Kavanagh,0,0,0,Ken Kavanagh
580,583,105,1958,Paco Godia,Gerino Gerini,0,0,0,Gerino Gerini
580,588,105,1958,Paco Godia,Luigi Taramazzo,0,0,0,Luigi Taramazzo
580,589,105,1958,Paco Godia,Louis Chiron,0,0,0,Louis Chiron
582,583,105,1958,Ken Kavanagh,Gerino Gerini,0,0,0,Gerino Gerini
582,588,105,1958,Ken Kavanagh,Luigi Taramazzo,0,0,0,Luigi Taramazzo
582,589,105,1958,Ken Kavanagh,Louis Chiron,0,0,0,Louis Chiron
583,588,105,1958,Gerino Gerini,Luigi Taramazzo,0,0,0,Luigi Taramazzo
583,589,105,1958,Gerino Gerini,Louis Chiron,0,0,0,Louis Chiron
588,589,105,1958,Luigi Taramazzo,Louis Chiron,0,0,0,Louis Chiron
430,483,105,1959,Carel Godin de Beaufort,Giorgio Scarlatti,0,0,0,Giorgio Scarlatti
430,543,105,1959,Carel Godin de Beaufort,Giulio Cabianca,0,0,0,Giulio Cabianca
430,553,105,1959,Carel Godin de Beaufort,AndrÃ© Testut,0,0,0,AndrÃ© Testut
430,567,105,1959,Carel Godin de Beaufort,Fritz d'Orey,0,0,0,Fritz d'Orey
430,568,105,1959,Carel Godin de Beaufort,Azdrubal Fontes,0,0,0,Azdrubal Fontes
430,576,105,1959,Carel Godin de Beaufort,Phil Cade,0,0,0,Phil Cade
483,543,105,1959,Giorgio Scarlatti,Giulio Cabianca,0,0,0,Giulio Cabianca
483,553,105,1959,Giorgio Scarlatti,AndrÃ© Testut,0,0,0,AndrÃ© Testut
483,567,105,1959,Giorgio Scarlatti,Fritz d'Orey,0,0,0,Fritz d'Orey
483,568,105,1959,Giorgio Scarlatti,Azdrubal Fontes,0,0,0,Azdrubal Fontes
483,576,105,1959,Giorgio Scarlatti,Phil Cade,0,0,0,Phil Cade
543,553,105,1959,Giulio Cabianca,AndrÃ© Testut,0,0,0,AndrÃ© Testut
543,567,105,1959,Giulio Cabianca,Fritz d'Orey,0,0,0,Fritz d'Orey
543,568,105,1959,Giulio Cabianca,Azdrubal Fontes,0,0,0,Azdrubal Fontes
543,576,105,1959,Giulio Cabianca,Phil Cade,0,0,0,Phil Cade
553,567,105,1959,AndrÃ© Testut,Fritz d'Orey,0,0,0,Fritz d'Orey
553,568,105,1959,AndrÃ© Testut,Azdrubal Fontes,0,0,0,Azdrubal Fontes
553,576,105,1959,AndrÃ© Testut,Phil Cade,0,0,0,Phil Cade
567,568,105,1959,Fritz d'Orey,Azdrubal Fontes,0,0,0,Azdrubal Fontes
567,576,105,1959,Fritz d'Orey,Phil Cade,0,0,0,Phil Cade
568,576,105,1959,Azdrubal Fontes,Phil Cade,0,0,0,Phil Cade
439,483,105,1960,Nasif EstÃ©fano,Giorgio Scarlatti,0,0,0,Giorgio Scarlatti
439,500,105,1960,Nasif EstÃ©fano,Gino Munaron,0,0,0,Gino Munaron
439,503,105,1960,Nasif EstÃ©fano,Ettore Chimeri,0,0,0,Ettore Chimeri
439,504,105,1960,Nasif EstÃ©fano,Antonio Creus,0,0,0,Antonio Creus
439,547,105,1960,Nasif EstÃ©fano,Horace Gould,0,0,0,Horace Gould
439,548,105,1960,Nasif EstÃ©fano,Bob Drake,0,0,0,Bob Drake
483,500,105,1960,Giorgio Scarlatti,Gino Munaron,0,0,0,Gino Munaron
483,503,105,1960,Giorgio Scarlatti,Ettore Chimeri,0,0,0,Ettore Chimeri
483,504,105,1960,Giorgio Scarlatti,Antonio Creus,0,0,0,Antonio Creus
483,547,105,1960,Giorgio Scarlatti,Horace Gould,0,0,0,Horace Gould
483,548,105,1960,Giorgio Scarlatti,Bob Drake,0,0,0,Bob Drake
500,503,105,1960,Gino Munaron,Ettore Chimeri,0,0,0,Ettore Chimeri
500,504,105,1960,Gino Munaron,Antonio Creus,0,0,0,Antonio Creus
500,547,105,1960,Gino Munaron,Horace Gould,0,0,0,Horace Gould
500,548,105,1960,Gino Munaron,Bob Drake,0,0,0,Bob Drake
503,504,105,1960,Ettore Chimeri,Antonio Creus,0,0,0,Antonio Creus
503,547,105,1960,Ettore Chimeri,Horace Gould,0,0,0,Horace Gould
503,548,105,1960,Ettore Chimeri,Bob Drake,0,0,0,Bob Drake
504,547,105,1960,Antonio Creus,Horace Gould,0,0,0,Horace Gould
504,548,105,1960,Antonio Creus,Bob Drake,0,0,0,Bob Drake
547,548,105,1960,Horace Gould,Bob Drake,0,0,0,Bob Drake
386,507,106,1960,Richie Ginther,Chuck Daigh,0,0,0,Chuck Daigh
386,508,106,1960,Richie Ginther,Lance Reventlow,0,0,0,Lance Reventlow
507,508,106,1960,Chuck Daigh,Lance Reventlow,0,0,0,Lance Reventlow
537,564,107,1958,Dick Rathmann,Jud Larson,0,0,0,Jud Larson
537,592,107,1958,Dick Rathmann,Jimmy Reece,0,0,0,Jimmy Reece
537,596,107,1958,Dick Rathmann,Ed Elisian,0,0,0,Ed Elisian
564,592,107,1958,Jud Larson,Jimmy Reece,0,0,0,Jimmy Reece
564,596,107,1958,Jud Larson,Ed Elisian,0,0,0,Ed Elisian
592,596,107,1958,Jimmy Reece,Ed Elisian,0,0,0,Ed Elisian
449,509,107,1959,Rodger Ward,Jim Rathmann,8,6,2,Rodger Ward
449,537,107,1959,Rodger Ward,Dick Rathmann,8,0,8,Rodger Ward
449,559,107,1959,Rodger Ward,Pat Flaherty,8,0,8,Rodger Ward
509,537,107,1959,Jim Rathmann,Dick Rathmann,6,0,6,Jim Rathmann
509,559,107,1959,Jim Rathmann,Pat Flaherty,6,0,6,Jim Rathmann
537,559,107,1959,Dick Rathmann,Pat Flaherty,0,0,0,Pat Flaherty
449,494,107,1960,Rodger Ward,Lloyd Ruby,6,0,6,Rodger Ward
449,509,107,1960,Rodger Ward,Jim Rathmann,6,8,2,Jim Rathmann
449,521,107,1960,Rodger Ward,Chuck Stevenson,6,0,6,Rodger Ward
449,526,107,1960,Rodger Ward,Troy Ruttman,6,0,6,Rodger Ward
449,529,107,1960,Rodger Ward,Tony Bettenhausen,6,0,6,Rodger Ward
449,536,107,1960,Rodger Ward,Len Sutton,6,0,6,Rodger Ward
449,537,107,1960,Rodger Ward,Dick Rathmann,6,0,6,Rodger Ward
494,509,107,1960,Lloyd Ruby,Jim Rathmann,0,8,8,Jim Rathmann
494,521,107,1960,Lloyd Ruby,Chuck Stevenson,0,0,0,Chuck Stevenson
494,526,107,1960,Lloyd Ruby,Troy Ruttman,0,0,0,Troy Ruttman
494,529,107,1960,Lloyd Ruby,Tony Bettenhausen,0,0,0,Tony Bettenhausen
494,536,107,1960,Lloyd Ruby,Len Sutton,0,0,0,Len Sutton
494,537,107,1960,Lloyd Ruby,Dick Rathmann,0,0,0,Dick Rathmann
509,521,107,1960,Jim Rathmann,Chuck Stevenson,8,0,8,Jim Rathmann
509,526,107,1960,Jim Rathmann,Troy Ruttman,8,0,8,Jim Rathmann
509,529,107,1960,Jim Rathmann,Tony Bettenhausen,8,0,8,Jim Rathmann
509,536,107,1960,Jim Rathmann,Len Sutton,8,0,8,Jim Rathmann
509,537,107,1960,Jim Rathmann,Dick Rathmann,8,0,8,Jim Rathmann
521,526,107,1960,Chuck Stevenson,Troy Ruttman,0,0,0,Troy Ruttman
521,529,107,1960,Chuck Stevenson,Tony Bettenhausen,0,0,0,Tony Bettenhausen
521,536,107,1960,Chuck Stevenson,Len Sutton,0,0,0,Len Sutton
521,537,107,1960,Chuck Stevenson,Dick Rathmann,0,0,0,Dick Rathmann
526,529,107,1960,Troy Ruttman,Tony Bettenhausen,0,0,0,Tony Bettenhausen
526,536,107,1960,Troy Ruttman,Len Sutton,0,0,0,Len Sutton
526,537,107,1960,Troy Ruttman,Dick Rathmann,0,0,0,Dick Rathmann
529,536,107,1960,Tony Bettenhausen,Len Sutton,0,0,0,Len Sutton
529,537,107,1960,Tony Bettenhausen,Dick Rathmann,0,0,0,Dick Rathmann
536,537,107,1960,Len Sutton,Dick Rathmann,0,0,0,Dick Rathmann
509,611,108,1957,Jim Rathmann,Sam Hanks,7,8,1,Sam Hanks
509,525,108,1958,Jim Rathmann,Jimmy Bryan,2,8,6,Jimmy Bryan
509,529,108,1958,Jim Rathmann,Tony Bettenhausen,2,4,2,Tony Bettenhausen
509,591,108,1958,Jim Rathmann,George Amick,2,6,4,George Amick
525,529,108,1958,Jimmy Bryan,Tony Bettenhausen,8,4,4,Jimmy Bryan
525,591,108,1958,Jimmy Bryan,George Amick,8,6,2,Jimmy Bryan
529,591,108,1958,Tony Bettenhausen,George Amick,4,6,2,George Amick
510,525,108,1959,Paul Goldsmith,Jimmy Bryan,2,0,2,Paul Goldsmith
510,529,108,1959,Paul Goldsmith,Tony Bettenhausen,2,3,1,Tony Bettenhausen
510,533,108,1959,Paul Goldsmith,Johnny Boyd,2,0,2,Paul Goldsmith
525,529,108,1959,Jimmy Bryan,Tony Bettenhausen,0,3,3,Tony Bettenhausen
525,533,108,1959,Jimmy Bryan,Johnny Boyd,0,0,0,Johnny Boyd
529,533,108,1959,Tony Bettenhausen,Johnny Boyd,3,0,3,Tony Bettenhausen
510,517,108,1960,Paul Goldsmith,Red Amick,4,0,4,Paul Goldsmith
510,525,108,1960,Paul Goldsmith,Jimmy Bryan,4,0,4,Paul Goldsmith
510,530,108,1960,Paul Goldsmith,Wayne Weiler,4,0,4,Paul Goldsmith
510,533,108,1960,Paul Goldsmith,Johnny Boyd,4,0,4,Paul Goldsmith
510,535,108,1960,Paul Goldsmith,Jim McWithey,4,0,4,Paul Goldsmith
517,525,108,1960,Red Amick,Jimmy Bryan,0,0,0,Jimmy Bryan
517,530,108,1960,Red Amick,Wayne Weiler,0,0,0,Wayne Weiler
517,533,108,1960,Red Amick,Johnny Boyd,0,0,0,Johnny Boyd
517,535,108,1960,Red Amick,Jim McWithey,0,0,0,Jim McWithey
525,530,108,1960,Jimmy Bryan,Wayne Weiler,0,0,0,Wayne Weiler
525,533,108,1960,Jimmy Bryan,Johnny Boyd,0,0,0,Johnny Boyd
525,535,108,1960,Jimmy Bryan,Jim McWithey,0,0,0,Jim McWithey
530,533,108,1960,Wayne Weiler,Johnny Boyd,0,0,0,Johnny Boyd
530,535,108,1960,Wayne Weiler,Jim McWithey,0,0,0,Jim McWithey
533,535,108,1960,Johnny Boyd,Jim McWithey,0,0,0,Jim McWithey
386,405,11,1965,Richie Ginther,Ronnie Bucknum,11,2,9,Richie Ginther
386,405,11,1966,Richie Ginther,Ronnie Bucknum,3,0,3,Richie Ginther
322,341,11,1968,David Hobbs,John Surtees,0,12,12,John Surtees
322,347,11,1968,David Hobbs,Jo Bonnier,0,2,2,Jo Bonnier
322,377,11,1968,David Hobbs,Jo Schlesser,0,0,0,Jo Schlesser
341,347,11,1968,John Surtees,Jo Bonnier,12,2,10,John Surtees
341,377,11,1968,John Surtees,Jo Schlesser,12,0,12,John Surtees
347,377,11,1968,Jo Bonnier,Jo Schlesser,2,0,2,Jo Bonnier
18,22,11,2006,Jenson Button,Rubens Barrichello,56,30,26,Jenson Button
18,22,11,2007,Jenson Button,Rubens Barrichello,6,0,6,Jenson Button
18,22,11,2008,Jenson Button,Rubens Barrichello,3,11,8,Rubens Barrichello
526,726,110,1950,Troy Ruttman,George Connor,0,0,0,George Connor
518,675,110,1952,Duane Carter,Manny Ayulo,3,0,3,Duane Carter
518,731,110,1952,Duane Carter,Henry Banks,3,0,3,Duane Carter
675,731,110,1952,Manny Ayulo,Henry Banks,0,0,0,Henry Banks
449,520,110,1957,Rodger Ward,Gene Hartley,0,0,0,Gene Hartley
449,562,110,1958,Rodger Ward,Jack Turner,0,0,0,Jack Turner
512,536,110,1959,Johnny Thomson,Len Sutton,5,0,5,Johnny Thomson
513,523,111,1955,Eddie Johnson,Shorty Templeman,0,0,0,Shorty Templeman
513,515,111,1960,Eddie Johnson,Bud Tingelstad,1,0,1,Eddie Johnson
514,522,112,1960,Bob Veith,Bobby Grim,0,0,0,Bobby Grim
529,559,113,1950,Tony Bettenhausen,Pat Flaherty,1,0,1,Tony Bettenhausen
529,593,113,1950,Tony Bettenhausen,Johnnie Parsons,1,9,8,Johnnie Parsons
529,611,113,1950,Tony Bettenhausen,Sam Hanks,1,0,1,Tony Bettenhausen
529,615,113,1950,Tony Bettenhausen,Fred Agabashian,1,0,1,Tony Bettenhausen
529,630,113,1950,Tony Bettenhausen,Duke Dinsmore,1,0,1,Tony Bettenhausen
529,654,113,1950,Tony Bettenhausen,Walt Faulkner,1,0,1,Tony Bettenhausen
529,658,113,1950,Tony Bettenhausen,Jack McGrath,1,0,1,Tony Bettenhausen
529,659,113,1950,Tony Bettenhausen,Jerry Hoyt,1,0,1,Tony Bettenhausen
529,732,113,1950,Tony Bettenhausen,Johnny McDowell,1,0,1,Tony Bettenhausen
529,770,113,1950,Tony Bettenhausen,Cecil Green,1,3,2,Cecil Green
529,771,113,1950,Tony Bettenhausen,Walt Brown,1,0,1,Tony Bettenhausen
529,772,113,1950,Tony Bettenhausen,Mack Hellings,1,0,1,Tony Bettenhausen
529,794,113,1950,Tony Bettenhausen,Joie Chitwood,1,1,0,Joie Chitwood
529,799,113,1950,Tony Bettenhausen,Jimmy Jackson,1,0,1,Tony Bettenhausen
559,593,113,1950,Pat Flaherty,Johnnie Parsons,0,9,9,Johnnie Parsons
559,611,113,1950,Pat Flaherty,Sam Hanks,0,0,0,Sam Hanks
559,615,113,1950,Pat Flaherty,Fred Agabashian,0,0,0,Fred Agabashian
559,630,113,1950,Pat Flaherty,Duke Dinsmore,0,0,0,Duke Dinsmore
559,654,113,1950,Pat Flaherty,Walt Faulkner,0,0,0,Walt Faulkner
559,658,113,1950,Pat Flaherty,Jack McGrath,0,0,0,Jack McGrath
559,659,113,1950,Pat Flaherty,Jerry Hoyt,0,0,0,Jerry Hoyt
559,732,113,1950,Pat Flaherty,Johnny McDowell,0,0,0,Johnny McDowell
559,770,113,1950,Pat Flaherty,Cecil Green,0,3,3,Cecil Green
559,771,113,1950,Pat Flaherty,Walt Brown,0,0,0,Walt Brown
559,772,113,1950,Pat Flaherty,Mack Hellings,0,0,0,Mack Hellings
559,794,113,1950,Pat Flaherty,Joie Chitwood,0,1,1,Joie Chitwood
559,799,113,1950,Pat Flaherty,Jimmy Jackson,0,0,0,Jimmy Jackson
593,611,113,1950,Johnnie Parsons,Sam Hanks,9,0,9,Johnnie Parsons
593,615,113,1950,Johnnie Parsons,Fred Agabashian,9,0,9,Johnnie Parsons
593,630,113,1950,Johnnie Parsons,Duke Dinsmore,9,0,9,Johnnie Parsons
593,654,113,1950,Johnnie Parsons,Walt Faulkner,9,0,9,Johnnie Parsons
593,658,113,1950,Johnnie Parsons,Jack McGrath,9,0,9,Johnnie Parsons
593,659,113,1950,Johnnie Parsons,Jerry Hoyt,9,0,9,Johnnie Parsons
593,732,113,1950,Johnnie Parsons,Johnny McDowell,9,0,9,Johnnie Parsons
593,770,113,1950,Johnnie Parsons,Cecil Green,9,3,6,Johnnie Parsons
593,771,113,1950,Johnnie Parsons,Walt Brown,9,0,9,Johnnie Parsons
593,772,113,1950,Johnnie Parsons,Mack Hellings,9,0,9,Johnnie Parsons
593,794,113,1950,Johnnie Parsons,Joie Chitwood,9,1,8,Johnnie Parsons
593,799,113,1950,Johnnie Parsons,Jimmy Jackson,9,0,9,Johnnie Parsons
611,615,113,1950,Sam Hanks,Fred Agabashian,0,0,0,Fred Agabashian
611,630,113,1950,Sam Hanks,Duke Dinsmore,0,0,0,Duke Dinsmore
611,654,113,1950,Sam Hanks,Walt Faulkner,0,0,0,Walt Faulkner
611,658,113,1950,Sam Hanks,Jack McGrath,0,0,0,Jack McGrath
611,659,113,1950,Sam Hanks,Jerry Hoyt,0,0,0,Jerry Hoyt
611,732,113,1950,Sam Hanks,Johnny McDowell,0,0,0,Johnny McDowell
611,770,113,1950,Sam Hanks,Cecil Green,0,3,3,Cecil Green
611,771,113,1950,Sam Hanks,Walt Brown,0,0,0,Walt Brown
611,772,113,1950,Sam Hanks,Mack Hellings,0,0,0,Mack Hellings
611,794,113,1950,Sam Hanks,Joie Chitwood,0,1,1,Joie Chitwood
611,799,113,1950,Sam Hanks,Jimmy Jackson,0,0,0,Jimmy Jackson
615,630,113,1950,Fred Agabashian,Duke Dinsmore,0,0,0,Duke Dinsmore
615,654,113,1950,Fred Agabashian,Walt Faulkner,0,0,0,Walt Faulkner
615,658,113,1950,Fred Agabashian,Jack McGrath,0,0,0,Jack McGrath
615,659,113,1950,Fred Agabashian,Jerry Hoyt,0,0,0,Jerry Hoyt
615,732,113,1950,Fred Agabashian,Johnny McDowell,0,0,0,Johnny McDowell
615,770,113,1950,Fred Agabashian,Cecil Green,0,3,3,Cecil Green
615,771,113,1950,Fred Agabashian,Walt Brown,0,0,0,Walt Brown
615,772,113,1950,Fred Agabashian,Mack Hellings,0,0,0,Mack Hellings
615,794,113,1950,Fred Agabashian,Joie Chitwood,0,1,1,Joie Chitwood
615,799,113,1950,Fred Agabashian,Jimmy Jackson,0,0,0,Jimmy Jackson
630,654,113,1950,Duke Dinsmore,Walt Faulkner,0,0,0,Walt Faulkner
630,658,113,1950,Duke Dinsmore,Jack McGrath,0,0,0,Jack McGrath
630,659,113,1950,Duke Dinsmore,Jerry Hoyt,0,0,0,Jerry Hoyt
630,732,113,1950,Duke Dinsmore,Johnny McDowell,0,0,0,Johnny McDowell
630,770,113,1950,Duke Dinsmore,Cecil Green,0,3,3,Cecil Green
630,771,113,1950,Duke Dinsmore,Walt Brown,0,0,0,Walt Brown
630,772,113,1950,Duke Dinsmore,Mack Hellings,0,0,0,Mack Hellings
630,794,113,1950,Duke Dinsmore,Joie Chitwood,0,1,1,Joie Chitwood
630,799,113,1950,Duke Dinsmore,Jimmy Jackson,0,0,0,Jimmy Jackson
654,658,113,1950,Walt Faulkner,Jack McGrath,0,0,0,Jack McGrath
654,659,113,1950,Walt Faulkner,Jerry Hoyt,0,0,0,Jerry Hoyt
654,732,113,1950,Walt Faulkner,Johnny McDowell,0,0,0,Johnny McDowell
654,770,113,1950,Walt Faulkner,Cecil Green,0,3,3,Cecil Green
654,771,113,1950,Walt Faulkner,Walt Brown,0,0,0,Walt Brown
654,772,113,1950,Walt Faulkner,Mack Hellings,0,0,0,Mack Hellings
654,794,113,1950,Walt Faulkner,Joie Chitwood,0,1,1,Joie Chitwood
654,799,113,1950,Walt Faulkner,Jimmy Jackson,0,0,0,Jimmy Jackson
658,659,113,1950,Jack McGrath,Jerry Hoyt,0,0,0,Jerry Hoyt
658,732,113,1950,Jack McGrath,Johnny McDowell,0,0,0,Johnny McDowell
658,770,113,1950,Jack McGrath,Cecil Green,0,3,3,Cecil Green
658,771,113,1950,Jack McGrath,Walt Brown,0,0,0,Walt Brown
658,772,113,1950,Jack McGrath,Mack Hellings,0,0,0,Mack Hellings
658,794,113,1950,Jack McGrath,Joie Chitwood,0,1,1,Joie Chitwood
658,799,113,1950,Jack McGrath,Jimmy Jackson,0,0,0,Jimmy Jackson
659,732,113,1950,Jerry Hoyt,Johnny McDowell,0,0,0,Johnny McDowell
659,770,113,1950,Jerry Hoyt,Cecil Green,0,3,3,Cecil Green
659,771,113,1950,Jerry Hoyt,Walt Brown,0,0,0,Walt Brown
659,772,113,1950,Jerry Hoyt,Mack Hellings,0,0,0,Mack Hellings
659,794,113,1950,Jerry Hoyt,Joie Chitwood,0,1,1,Joie Chitwood
659,799,113,1950,Jerry Hoyt,Jimmy Jackson,0,0,0,Jimmy Jackson
732,770,113,1950,Johnny McDowell,Cecil Green,0,3,3,Cecil Green
732,771,113,1950,Johnny McDowell,Walt Brown,0,0,0,Walt Brown
732,772,113,1950,Johnny McDowell,Mack Hellings,0,0,0,Mack Hellings
732,794,113,1950,Johnny McDowell,Joie Chitwood,0,1,1,Joie Chitwood
732,799,113,1950,Johnny McDowell,Jimmy Jackson,0,0,0,Jimmy Jackson
770,771,113,1950,Cecil Green,Walt Brown,3,0,3,Cecil Green
770,772,113,1950,Cecil Green,Mack Hellings,3,0,3,Cecil Green
770,794,113,1950,Cecil Green,Joie Chitwood,3,1,2,Cecil Green
770,799,113,1950,Cecil Green,Jimmy Jackson,3,0,3,Cecil Green
771,772,113,1950,Walt Brown,Mack Hellings,0,0,0,Mack Hellings
771,794,113,1950,Walt Brown,Joie Chitwood,0,1,1,Joie Chitwood
771,799,113,1950,Walt Brown,Jimmy Jackson,0,0,0,Jimmy Jackson
772,794,113,1950,Mack Hellings,Joie Chitwood,0,1,1,Joie Chitwood
772,799,113,1950,Mack Hellings,Jimmy Jackson,0,0,0,Jimmy Jackson
794,799,113,1950,Joie Chitwood,Jimmy Jackson,1,0,1,Joie Chitwood
526,534,113,1951,Troy Ruttman,Gene Force,0,0,0,Gene Force
526,593,113,1951,Troy Ruttman,Johnnie Parsons,0,0,0,Johnnie Parsons
526,611,113,1951,Troy Ruttman,Sam Hanks,0,0,0,Sam Hanks
526,615,113,1951,Troy Ruttman,Fred Agabashian,0,0,0,Fred Agabashian
526,629,113,1951,Troy Ruttman,Cliff Griffith,0,0,0,Cliff Griffith
526,658,113,1951,Troy Ruttman,Jack McGrath,0,2,2,Jack McGrath
526,673,113,1951,Troy Ruttman,Mike Nazaruk,0,6,6,Mike Nazaruk
526,675,113,1951,Troy Ruttman,Manny Ayulo,0,2,2,Manny Ayulo
526,699,113,1951,Troy Ruttman,Duke Nalon,0,0,0,Duke Nalon
526,700,113,1951,Troy Ruttman,Carl Scarborough,0,0,0,Carl Scarborough
526,729,113,1951,Troy Ruttman,Bill Schindler,0,0,0,Bill Schindler
526,733,113,1951,Troy Ruttman,Chet Miller,0,0,0,Chet Miller
526,766,113,1951,Troy Ruttman,Lee Wallard,0,9,9,Lee Wallard
526,767,113,1951,Troy Ruttman,Carl Forberg,0,0,0,Carl Forberg
526,770,113,1951,Troy Ruttman,Cecil Green,0,0,0,Cecil Green
526,771,113,1951,Troy Ruttman,Walt Brown,0,0,0,Walt Brown
534,593,113,1951,Gene Force,Johnnie Parsons,0,0,0,Johnnie Parsons
534,611,113,1951,Gene Force,Sam Hanks,0,0,0,Sam Hanks
534,615,113,1951,Gene Force,Fred Agabashian,0,0,0,Fred Agabashian
534,629,113,1951,Gene Force,Cliff Griffith,0,0,0,Cliff Griffith
534,658,113,1951,Gene Force,Jack McGrath,0,2,2,Jack McGrath
534,673,113,1951,Gene Force,Mike Nazaruk,0,6,6,Mike Nazaruk
534,675,113,1951,Gene Force,Manny Ayulo,0,2,2,Manny Ayulo
534,699,113,1951,Gene Force,Duke Nalon,0,0,0,Duke Nalon
534,700,113,1951,Gene Force,Carl Scarborough,0,0,0,Carl Scarborough
534,729,113,1951,Gene Force,Bill Schindler,0,0,0,Bill Schindler
534,733,113,1951,Gene Force,Chet Miller,0,0,0,Chet Miller
534,766,113,1951,Gene Force,Lee Wallard,0,9,9,Lee Wallard
534,767,113,1951,Gene Force,Carl Forberg,0,0,0,Carl Forberg
534,770,113,1951,Gene Force,Cecil Green,0,0,0,Cecil Green
534,771,113,1951,Gene Force,Walt Brown,0,0,0,Walt Brown
593,611,113,1951,Johnnie Parsons,Sam Hanks,0,0,0,Sam Hanks
593,615,113,1951,Johnnie Parsons,Fred Agabashian,0,0,0,Fred Agabashian
593,629,113,1951,Johnnie Parsons,Cliff Griffith,0,0,0,Cliff Griffith
593,658,113,1951,Johnnie Parsons,Jack McGrath,0,2,2,Jack McGrath
593,673,113,1951,Johnnie Parsons,Mike Nazaruk,0,6,6,Mike Nazaruk
593,675,113,1951,Johnnie Parsons,Manny Ayulo,0,2,2,Manny Ayulo
593,699,113,1951,Johnnie Parsons,Duke Nalon,0,0,0,Duke Nalon
593,700,113,1951,Johnnie Parsons,Carl Scarborough,0,0,0,Carl Scarborough
593,729,113,1951,Johnnie Parsons,Bill Schindler,0,0,0,Bill Schindler
593,733,113,1951,Johnnie Parsons,Chet Miller,0,0,0,Chet Miller
593,766,113,1951,Johnnie Parsons,Lee Wallard,0,9,9,Lee Wallard
593,767,113,1951,Johnnie Parsons,Carl Forberg,0,0,0,Carl Forberg
593,770,113,1951,Johnnie Parsons,Cecil Green,0,0,0,Cecil Green
593,771,113,1951,Johnnie Parsons,Walt Brown,0,0,0,Walt Brown
611,615,113,1951,Sam Hanks,Fred Agabashian,0,0,0,Fred Agabashian
611,629,113,1951,Sam Hanks,Cliff Griffith,0,0,0,Cliff Griffith
611,658,113,1951,Sam Hanks,Jack McGrath,0,2,2,Jack McGrath
611,673,113,1951,Sam Hanks,Mike Nazaruk,0,6,6,Mike Nazaruk
611,675,113,1951,Sam Hanks,Manny Ayulo,0,2,2,Manny Ayulo
611,699,113,1951,Sam Hanks,Duke Nalon,0,0,0,Duke Nalon
611,700,113,1951,Sam Hanks,Carl Scarborough,0,0,0,Carl Scarborough
611,729,113,1951,Sam Hanks,Bill Schindler,0,0,0,Bill Schindler
611,733,113,1951,Sam Hanks,Chet Miller,0,0,0,Chet Miller
611,766,113,1951,Sam Hanks,Lee Wallard,0,9,9,Lee Wallard
611,767,113,1951,Sam Hanks,Carl Forberg,0,0,0,Carl Forberg
611,770,113,1951,Sam Hanks,Cecil Green,0,0,0,Cecil Green
611,771,113,1951,Sam Hanks,Walt Brown,0,0,0,Walt Brown
615,629,113,1951,Fred Agabashian,Cliff Griffith,0,0,0,Cliff Griffith
615,658,113,1951,Fred Agabashian,Jack McGrath,0,2,2,Jack McGrath
615,673,113,1951,Fred Agabashian,Mike Nazaruk,0,6,6,Mike Nazaruk
615,675,113,1951,Fred Agabashian,Manny Ayulo,0,2,2,Manny Ayulo
615,699,113,1951,Fred Agabashian,Duke Nalon,0,0,0,Duke Nalon
615,700,113,1951,Fred Agabashian,Carl Scarborough,0,0,0,Carl Scarborough
615,729,113,1951,Fred Agabashian,Bill Schindler,0,0,0,Bill Schindler
615,733,113,1951,Fred Agabashian,Chet Miller,0,0,0,Chet Miller
615,766,113,1951,Fred Agabashian,Lee Wallard,0,9,9,Lee Wallard
615,767,113,1951,Fred Agabashian,Carl Forberg,0,0,0,Carl Forberg
615,770,113,1951,Fred Agabashian,Cecil Green,0,0,0,Cecil Green
615,771,113,1951,Fred Agabashian,Walt Brown,0,0,0,Walt Brown
629,658,113,1951,Cliff Griffith,Jack McGrath,0,2,2,Jack McGrath
629,673,113,1951,Cliff Griffith,Mike Nazaruk,0,6,6,Mike Nazaruk
629,675,113,1951,Cliff Griffith,Manny Ayulo,0,2,2,Manny Ayulo
629,699,113,1951,Cliff Griffith,Duke Nalon,0,0,0,Duke Nalon
629,700,113,1951,Cliff Griffith,Carl Scarborough,0,0,0,Carl Scarborough
629,729,113,1951,Cliff Griffith,Bill Schindler,0,0,0,Bill Schindler
629,733,113,1951,Cliff Griffith,Chet Miller,0,0,0,Chet Miller
629,766,113,1951,Cliff Griffith,Lee Wallard,0,9,9,Lee Wallard
629,767,113,1951,Cliff Griffith,Carl Forberg,0,0,0,Carl Forberg
629,770,113,1951,Cliff Griffith,Cecil Green,0,0,0,Cecil Green
629,771,113,1951,Cliff Griffith,Walt Brown,0,0,0,Walt Brown
658,673,113,1951,Jack McGrath,Mike Nazaruk,2,6,4,Mike Nazaruk
658,675,113,1951,Jack McGrath,Manny Ayulo,2,2,0,Manny Ayulo
658,699,113,1951,Jack McGrath,Duke Nalon,2,0,2,Jack McGrath
658,700,113,1951,Jack McGrath,Carl Scarborough,2,0,2,Jack McGrath
658,729,113,1951,Jack McGrath,Bill Schindler,2,0,2,Jack McGrath
658,733,113,1951,Jack McGrath,Chet Miller,2,0,2,Jack McGrath
658,766,113,1951,Jack McGrath,Lee Wallard,2,9,7,Lee Wallard
658,767,113,1951,Jack McGrath,Carl Forberg,2,0,2,Jack McGrath
658,770,113,1951,Jack McGrath,Cecil Green,2,0,2,Jack McGrath
658,771,113,1951,Jack McGrath,Walt Brown,2,0,2,Jack McGrath
673,675,113,1951,Mike Nazaruk,Manny Ayulo,6,2,4,Mike Nazaruk
673,699,113,1951,Mike Nazaruk,Duke Nalon,6,0,6,Mike Nazaruk
673,700,113,1951,Mike Nazaruk,Carl Scarborough,6,0,6,Mike Nazaruk
673,729,113,1951,Mike Nazaruk,Bill Schindler,6,0,6,Mike Nazaruk
673,733,113,1951,Mike Nazaruk,Chet Miller,6,0,6,Mike Nazaruk
673,766,113,1951,Mike Nazaruk,Lee Wallard,6,9,3,Lee Wallard
673,767,113,1951,Mike Nazaruk,Carl Forberg,6,0,6,Mike Nazaruk
673,770,113,1951,Mike Nazaruk,Cecil Green,6,0,6,Mike Nazaruk
673,771,113,1951,Mike Nazaruk,Walt Brown,6,0,6,Mike Nazaruk
675,699,113,1951,Manny Ayulo,Duke Nalon,2,0,2,Manny Ayulo
675,700,113,1951,Manny Ayulo,Carl Scarborough,2,0,2,Manny Ayulo
675,729,113,1951,Manny Ayulo,Bill Schindler,2,0,2,Manny Ayulo
675,733,113,1951,Manny Ayulo,Chet Miller,2,0,2,Manny Ayulo
675,766,113,1951,Manny Ayulo,Lee Wallard,2,9,7,Lee Wallard
675,767,113,1951,Manny Ayulo,Carl Forberg,2,0,2,Manny Ayulo
675,770,113,1951,Manny Ayulo,Cecil Green,2,0,2,Manny Ayulo
675,771,113,1951,Manny Ayulo,Walt Brown,2,0,2,Manny Ayulo
699,700,113,1951,Duke Nalon,Carl Scarborough,0,0,0,Carl Scarborough
699,729,113,1951,Duke Nalon,Bill Schindler,0,0,0,Bill Schindler
699,733,113,1951,Duke Nalon,Chet Miller,0,0,0,Chet Miller
699,766,113,1951,Duke Nalon,Lee Wallard,0,9,9,Lee Wallard
699,767,113,1951,Duke Nalon,Carl Forberg,0,0,0,Carl Forberg
699,770,113,1951,Duke Nalon,Cecil Green,0,0,0,Cecil Green
699,771,113,1951,Duke Nalon,Walt Brown,0,0,0,Walt Brown
700,729,113,1951,Carl Scarborough,Bill Schindler,0,0,0,Bill Schindler
700,733,113,1951,Carl Scarborough,Chet Miller,0,0,0,Chet Miller
700,766,113,1951,Carl Scarborough,Lee Wallard,0,9,9,Lee Wallard
700,767,113,1951,Carl Scarborough,Carl Forberg,0,0,0,Carl Forberg
700,770,113,1951,Carl Scarborough,Cecil Green,0,0,0,Cecil Green
700,771,113,1951,Carl Scarborough,Walt Brown,0,0,0,Walt Brown
729,733,113,1951,Bill Schindler,Chet Miller,0,0,0,Chet Miller
729,766,113,1951,Bill Schindler,Lee Wallard,0,9,9,Lee Wallard
729,767,113,1951,Bill Schindler,Carl Forberg,0,0,0,Carl Forberg
729,770,113,1951,Bill Schindler,Cecil Green,0,0,0,Cecil Green
729,771,113,1951,Bill Schindler,Walt Brown,0,0,0,Walt Brown
733,766,113,1951,Chet Miller,Lee Wallard,0,9,9,Lee Wallard
733,767,113,1951,Chet Miller,Carl Forberg,0,0,0,Carl Forberg
733,770,113,1951,Chet Miller,Cecil Green,0,0,0,Cecil Green
733,771,113,1951,Chet Miller,Walt Brown,0,0,0,Walt Brown
766,767,113,1951,Lee Wallard,Carl Forberg,9,0,9,Lee Wallard
766,770,113,1951,Lee Wallard,Cecil Green,9,0,9,Lee Wallard
766,771,113,1951,Lee Wallard,Walt Brown,9,0,9,Lee Wallard
767,770,113,1951,Carl Forberg,Cecil Green,0,0,0,Cecil Green
767,771,113,1951,Carl Forberg,Walt Brown,0,0,0,Walt Brown
770,771,113,1951,Cecil Green,Walt Brown,0,0,0,Walt Brown
449,509,113,1952,Rodger Ward,Jim Rathmann,0,6,6,Jim Rathmann
449,520,113,1952,Rodger Ward,Gene Hartley,0,0,0,Gene Hartley
449,521,113,1952,Rodger Ward,Chuck Stevenson,0,0,0,Chuck Stevenson
449,525,113,1952,Rodger Ward,Jimmy Bryan,0,0,0,Jimmy Bryan
449,592,113,1952,Rodger Ward,Jimmy Reece,0,0,0,Jimmy Reece
449,593,113,1952,Rodger Ward,Johnnie Parsons,0,0,0,Johnnie Parsons
449,611,113,1952,Rodger Ward,Sam Hanks,0,4,4,Sam Hanks
449,612,113,1952,Rodger Ward,Andy Linden,0,0,0,Andy Linden
449,615,113,1952,Rodger Ward,Fred Agabashian,0,0,0,Fred Agabashian
449,628,113,1952,Rodger Ward,Bob Sweikert,0,0,0,Bob Sweikert
449,629,113,1952,Rodger Ward,Cliff Griffith,0,0,0,Cliff Griffith
449,656,113,1952,Rodger Ward,Art Cross,0,2,2,Art Cross
449,657,113,1952,Rodger Ward,Bill Vukovich,0,1,1,Bill Vukovich
449,658,113,1952,Rodger Ward,Jack McGrath,0,0,0,Jack McGrath
449,699,113,1952,Rodger Ward,Duke Nalon,0,0,0,Duke Nalon
449,702,113,1952,Rodger Ward,Bob Scott,0,0,0,Bob Scott
449,726,113,1952,Rodger Ward,George Connor,0,0,0,George Connor
449,728,113,1952,Rodger Ward,Joe James,0,0,0,Joe James
449,732,113,1952,Rodger Ward,Johnny McDowell,0,0,0,Johnny McDowell
449,733,113,1952,Rodger Ward,Chet Miller,0,0,0,Chet Miller
509,520,113,1952,Jim Rathmann,Gene Hartley,6,0,6,Jim Rathmann
509,521,113,1952,Jim Rathmann,Chuck Stevenson,6,0,6,Jim Rathmann
509,525,113,1952,Jim Rathmann,Jimmy Bryan,6,0,6,Jim Rathmann
509,592,113,1952,Jim Rathmann,Jimmy Reece,6,0,6,Jim Rathmann
509,593,113,1952,Jim Rathmann,Johnnie Parsons,6,0,6,Jim Rathmann
509,611,113,1952,Jim Rathmann,Sam Hanks,6,4,2,Jim Rathmann
509,612,113,1952,Jim Rathmann,Andy Linden,6,0,6,Jim Rathmann
509,615,113,1952,Jim Rathmann,Fred Agabashian,6,0,6,Jim Rathmann
509,628,113,1952,Jim Rathmann,Bob Sweikert,6,0,6,Jim Rathmann
509,629,113,1952,Jim Rathmann,Cliff Griffith,6,0,6,Jim Rathmann
509,656,113,1952,Jim Rathmann,Art Cross,6,2,4,Jim Rathmann
509,657,113,1952,Jim Rathmann,Bill Vukovich,6,1,5,Jim Rathmann
509,658,113,1952,Jim Rathmann,Jack McGrath,6,0,6,Jim Rathmann
509,699,113,1952,Jim Rathmann,Duke Nalon,6,0,6,Jim Rathmann
509,702,113,1952,Jim Rathmann,Bob Scott,6,0,6,Jim Rathmann
509,726,113,1952,Jim Rathmann,George Connor,6,0,6,Jim Rathmann
509,728,113,1952,Jim Rathmann,Joe James,6,0,6,Jim Rathmann
509,732,113,1952,Jim Rathmann,Johnny McDowell,6,0,6,Jim Rathmann
509,733,113,1952,Jim Rathmann,Chet Miller,6,0,6,Jim Rathmann
520,521,113,1952,Gene Hartley,Chuck Stevenson,0,0,0,Chuck Stevenson
520,525,113,1952,Gene Hartley,Jimmy Bryan,0,0,0,Jimmy Bryan
520,592,113,1952,Gene Hartley,Jimmy Reece,0,0,0,Jimmy Reece
520,593,113,1952,Gene Hartley,Johnnie Parsons,0,0,0,Johnnie Parsons
520,611,113,1952,Gene Hartley,Sam Hanks,0,4,4,Sam Hanks
520,612,113,1952,Gene Hartley,Andy Linden,0,0,0,Andy Linden
520,615,113,1952,Gene Hartley,Fred Agabashian,0,0,0,Fred Agabashian
520,628,113,1952,Gene Hartley,Bob Sweikert,0,0,0,Bob Sweikert
520,629,113,1952,Gene Hartley,Cliff Griffith,0,0,0,Cliff Griffith
520,656,113,1952,Gene Hartley,Art Cross,0,2,2,Art Cross
520,657,113,1952,Gene Hartley,Bill Vukovich,0,1,1,Bill Vukovich
520,658,113,1952,Gene Hartley,Jack McGrath,0,0,0,Jack McGrath
520,699,113,1952,Gene Hartley,Duke Nalon,0,0,0,Duke Nalon
520,702,113,1952,Gene Hartley,Bob Scott,0,0,0,Bob Scott
520,726,113,1952,Gene Hartley,George Connor,0,0,0,George Connor
520,728,113,1952,Gene Hartley,Joe James,0,0,0,Joe James
520,732,113,1952,Gene Hartley,Johnny McDowell,0,0,0,Johnny McDowell
520,733,113,1952,Gene Hartley,Chet Miller,0,0,0,Chet Miller
521,525,113,1952,Chuck Stevenson,Jimmy Bryan,0,0,0,Jimmy Bryan
521,592,113,1952,Chuck Stevenson,Jimmy Reece,0,0,0,Jimmy Reece
521,593,113,1952,Chuck Stevenson,Johnnie Parsons,0,0,0,Johnnie Parsons
521,611,113,1952,Chuck Stevenson,Sam Hanks,0,4,4,Sam Hanks
521,612,113,1952,Chuck Stevenson,Andy Linden,0,0,0,Andy Linden
521,615,113,1952,Chuck Stevenson,Fred Agabashian,0,0,0,Fred Agabashian
521,628,113,1952,Chuck Stevenson,Bob Sweikert,0,0,0,Bob Sweikert
521,629,113,1952,Chuck Stevenson,Cliff Griffith,0,0,0,Cliff Griffith
521,656,113,1952,Chuck Stevenson,Art Cross,0,2,2,Art Cross
521,657,113,1952,Chuck Stevenson,Bill Vukovich,0,1,1,Bill Vukovich
521,658,113,1952,Chuck Stevenson,Jack McGrath,0,0,0,Jack McGrath
521,699,113,1952,Chuck Stevenson,Duke Nalon,0,0,0,Duke Nalon
521,702,113,1952,Chuck Stevenson,Bob Scott,0,0,0,Bob Scott
521,726,113,1952,Chuck Stevenson,George Connor,0,0,0,George Connor
521,728,113,1952,Chuck Stevenson,Joe James,0,0,0,Joe James
521,732,113,1952,Chuck Stevenson,Johnny McDowell,0,0,0,Johnny McDowell
521,733,113,1952,Chuck Stevenson,Chet Miller,0,0,0,Chet Miller
525,592,113,1952,Jimmy Bryan,Jimmy Reece,0,0,0,Jimmy Reece
525,593,113,1952,Jimmy Bryan,Johnnie Parsons,0,0,0,Johnnie Parsons
525,611,113,1952,Jimmy Bryan,Sam Hanks,0,4,4,Sam Hanks
525,612,113,1952,Jimmy Bryan,Andy Linden,0,0,0,Andy Linden
525,615,113,1952,Jimmy Bryan,Fred Agabashian,0,0,0,Fred Agabashian
525,628,113,1952,Jimmy Bryan,Bob Sweikert,0,0,0,Bob Sweikert
525,629,113,1952,Jimmy Bryan,Cliff Griffith,0,0,0,Cliff Griffith
525,656,113,1952,Jimmy Bryan,Art Cross,0,2,2,Art Cross
525,657,113,1952,Jimmy Bryan,Bill Vukovich,0,1,1,Bill Vukovich
525,658,113,1952,Jimmy Bryan,Jack McGrath,0,0,0,Jack McGrath
525,699,113,1952,Jimmy Bryan,Duke Nalon,0,0,0,Duke Nalon
525,702,113,1952,Jimmy Bryan,Bob Scott,0,0,0,Bob Scott
525,726,113,1952,Jimmy Bryan,George Connor,0,0,0,George Connor
525,728,113,1952,Jimmy Bryan,Joe James,0,0,0,Joe James
525,732,113,1952,Jimmy Bryan,Johnny McDowell,0,0,0,Johnny McDowell
525,733,113,1952,Jimmy Bryan,Chet Miller,0,0,0,Chet Miller
592,593,113,1952,Jimmy Reece,Johnnie Parsons,0,0,0,Johnnie Parsons
592,611,113,1952,Jimmy Reece,Sam Hanks,0,4,4,Sam Hanks
592,612,113,1952,Jimmy Reece,Andy Linden,0,0,0,Andy Linden
592,615,113,1952,Jimmy Reece,Fred Agabashian,0,0,0,Fred Agabashian
592,628,113,1952,Jimmy Reece,Bob Sweikert,0,0,0,Bob Sweikert
592,629,113,1952,Jimmy Reece,Cliff Griffith,0,0,0,Cliff Griffith
592,656,113,1952,Jimmy Reece,Art Cross,0,2,2,Art Cross
592,657,113,1952,Jimmy Reece,Bill Vukovich,0,1,1,Bill Vukovich
592,658,113,1952,Jimmy Reece,Jack McGrath,0,0,0,Jack McGrath
592,699,113,1952,Jimmy Reece,Duke Nalon,0,0,0,Duke Nalon
592,702,113,1952,Jimmy Reece,Bob Scott,0,0,0,Bob Scott
592,726,113,1952,Jimmy Reece,George Connor,0,0,0,George Connor
592,728,113,1952,Jimmy Reece,Joe James,0,0,0,Joe James
592,732,113,1952,Jimmy Reece,Johnny McDowell,0,0,0,Johnny McDowell
592,733,113,1952,Jimmy Reece,Chet Miller,0,0,0,Chet Miller
593,611,113,1952,Johnnie Parsons,Sam Hanks,0,4,4,Sam Hanks
593,612,113,1952,Johnnie Parsons,Andy Linden,0,0,0,Andy Linden
593,615,113,1952,Johnnie Parsons,Fred Agabashian,0,0,0,Fred Agabashian
593,628,113,1952,Johnnie Parsons,Bob Sweikert,0,0,0,Bob Sweikert
593,629,113,1952,Johnnie Parsons,Cliff Griffith,0,0,0,Cliff Griffith
593,656,113,1952,Johnnie Parsons,Art Cross,0,2,2,Art Cross
593,657,113,1952,Johnnie Parsons,Bill Vukovich,0,1,1,Bill Vukovich
593,658,113,1952,Johnnie Parsons,Jack McGrath,0,0,0,Jack McGrath
593,699,113,1952,Johnnie Parsons,Duke Nalon,0,0,0,Duke Nalon
593,702,113,1952,Johnnie Parsons,Bob Scott,0,0,0,Bob Scott
593,726,113,1952,Johnnie Parsons,George Connor,0,0,0,George Connor
593,728,113,1952,Johnnie Parsons,Joe James,0,0,0,Joe James
593,732,113,1952,Johnnie Parsons,Johnny McDowell,0,0,0,Johnny McDowell
593,733,113,1952,Johnnie Parsons,Chet Miller,0,0,0,Chet Miller
611,612,113,1952,Sam Hanks,Andy Linden,4,0,4,Sam Hanks
611,615,113,1952,Sam Hanks,Fred Agabashian,4,0,4,Sam Hanks
611,628,113,1952,Sam Hanks,Bob Sweikert,4,0,4,Sam Hanks
611,629,113,1952,Sam Hanks,Cliff Griffith,4,0,4,Sam Hanks
611,656,113,1952,Sam Hanks,Art Cross,4,2,2,Sam Hanks
611,657,113,1952,Sam Hanks,Bill Vukovich,4,1,3,Sam Hanks
611,658,113,1952,Sam Hanks,Jack McGrath,4,0,4,Sam Hanks
611,699,113,1952,Sam Hanks,Duke Nalon,4,0,4,Sam Hanks
611,702,113,1952,Sam Hanks,Bob Scott,4,0,4,Sam Hanks
611,726,113,1952,Sam Hanks,George Connor,4,0,4,Sam Hanks
611,728,113,1952,Sam Hanks,Joe James,4,0,4,Sam Hanks
611,732,113,1952,Sam Hanks,Johnny McDowell,4,0,4,Sam Hanks
611,733,113,1952,Sam Hanks,Chet Miller,4,0,4,Sam Hanks
612,615,113,1952,Andy Linden,Fred Agabashian,0,0,0,Fred Agabashian
612,628,113,1952,Andy Linden,Bob Sweikert,0,0,0,Bob Sweikert
612,629,113,1952,Andy Linden,Cliff Griffith,0,0,0,Cliff Griffith
612,656,113,1952,Andy Linden,Art Cross,0,2,2,Art Cross
612,657,113,1952,Andy Linden,Bill Vukovich,0,1,1,Bill Vukovich
612,658,113,1952,Andy Linden,Jack McGrath,0,0,0,Jack McGrath
612,699,113,1952,Andy Linden,Duke Nalon,0,0,0,Duke Nalon
612,702,113,1952,Andy Linden,Bob Scott,0,0,0,Bob Scott
612,726,113,1952,Andy Linden,George Connor,0,0,0,George Connor
612,728,113,1952,Andy Linden,Joe James,0,0,0,Joe James
612,732,113,1952,Andy Linden,Johnny McDowell,0,0,0,Johnny McDowell
612,733,113,1952,Andy Linden,Chet Miller,0,0,0,Chet Miller
615,628,113,1952,Fred Agabashian,Bob Sweikert,0,0,0,Bob Sweikert
615,629,113,1952,Fred Agabashian,Cliff Griffith,0,0,0,Cliff Griffith
615,656,113,1952,Fred Agabashian,Art Cross,0,2,2,Art Cross
615,657,113,1952,Fred Agabashian,Bill Vukovich,0,1,1,Bill Vukovich
615,658,113,1952,Fred Agabashian,Jack McGrath,0,0,0,Jack McGrath
615,699,113,1952,Fred Agabashian,Duke Nalon,0,0,0,Duke Nalon
615,702,113,1952,Fred Agabashian,Bob Scott,0,0,0,Bob Scott
615,726,113,1952,Fred Agabashian,George Connor,0,0,0,George Connor
615,728,113,1952,Fred Agabashian,Joe James,0,0,0,Joe James
615,732,113,1952,Fred Agabashian,Johnny McDowell,0,0,0,Johnny McDowell
615,733,113,1952,Fred Agabashian,Chet Miller,0,0,0,Chet Miller
628,629,113,1952,Bob Sweikert,Cliff Griffith,0,0,0,Cliff Griffith
628,656,113,1952,Bob Sweikert,Art Cross,0,2,2,Art Cross
628,657,113,1952,Bob Sweikert,Bill Vukovich,0,1,1,Bill Vukovich
628,658,113,1952,Bob Sweikert,Jack McGrath,0,0,0,Jack McGrath
628,699,113,1952,Bob Sweikert,Duke Nalon,0,0,0,Duke Nalon
628,702,113,1952,Bob Sweikert,Bob Scott,0,0,0,Bob Scott
628,726,113,1952,Bob Sweikert,George Connor,0,0,0,George Connor
628,728,113,1952,Bob Sweikert,Joe James,0,0,0,Joe James
628,732,113,1952,Bob Sweikert,Johnny McDowell,0,0,0,Johnny McDowell
628,733,113,1952,Bob Sweikert,Chet Miller,0,0,0,Chet Miller
629,656,113,1952,Cliff Griffith,Art Cross,0,2,2,Art Cross
629,657,113,1952,Cliff Griffith,Bill Vukovich,0,1,1,Bill Vukovich
629,658,113,1952,Cliff Griffith,Jack McGrath,0,0,0,Jack McGrath
629,699,113,1952,Cliff Griffith,Duke Nalon,0,0,0,Duke Nalon
629,702,113,1952,Cliff Griffith,Bob Scott,0,0,0,Bob Scott
629,726,113,1952,Cliff Griffith,George Connor,0,0,0,George Connor
629,728,113,1952,Cliff Griffith,Joe James,0,0,0,Joe James
629,732,113,1952,Cliff Griffith,Johnny McDowell,0,0,0,Johnny McDowell
629,733,113,1952,Cliff Griffith,Chet Miller,0,0,0,Chet Miller
656,657,113,1952,Art Cross,Bill Vukovich,2,1,1,Art Cross
656,658,113,1952,Art Cross,Jack McGrath,2,0,2,Art Cross
656,699,113,1952,Art Cross,Duke Nalon,2,0,2,Art Cross
656,702,113,1952,Art Cross,Bob Scott,2,0,2,Art Cross
656,726,113,1952,Art Cross,George Connor,2,0,2,Art Cross
656,728,113,1952,Art Cross,Joe James,2,0,2,Art Cross
656,732,113,1952,Art Cross,Johnny McDowell,2,0,2,Art Cross
656,733,113,1952,Art Cross,Chet Miller,2,0,2,Art Cross
657,658,113,1952,Bill Vukovich,Jack McGrath,1,0,1,Bill Vukovich
657,699,113,1952,Bill Vukovich,Duke Nalon,1,0,1,Bill Vukovich
657,702,113,1952,Bill Vukovich,Bob Scott,1,0,1,Bill Vukovich
657,726,113,1952,Bill Vukovich,George Connor,1,0,1,Bill Vukovich
657,728,113,1952,Bill Vukovich,Joe James,1,0,1,Bill Vukovich
657,732,113,1952,Bill Vukovich,Johnny McDowell,1,0,1,Bill Vukovich
657,733,113,1952,Bill Vukovich,Chet Miller,1,0,1,Bill Vukovich
658,699,113,1952,Jack McGrath,Duke Nalon,0,0,0,Duke Nalon
658,702,113,1952,Jack McGrath,Bob Scott,0,0,0,Bob Scott
658,726,113,1952,Jack McGrath,George Connor,0,0,0,George Connor
658,728,113,1952,Jack McGrath,Joe James,0,0,0,Joe James
658,732,113,1952,Jack McGrath,Johnny McDowell,0,0,0,Johnny McDowell
658,733,113,1952,Jack McGrath,Chet Miller,0,0,0,Chet Miller
699,702,113,1952,Duke Nalon,Bob Scott,0,0,0,Bob Scott
699,726,113,1952,Duke Nalon,George Connor,0,0,0,George Connor
699,728,113,1952,Duke Nalon,Joe James,0,0,0,Joe James
699,732,113,1952,Duke Nalon,Johnny McDowell,0,0,0,Johnny McDowell
699,733,113,1952,Duke Nalon,Chet Miller,0,0,0,Chet Miller
702,726,113,1952,Bob Scott,George Connor,0,0,0,George Connor
702,728,113,1952,Bob Scott,Joe James,0,0,0,Joe James
702,732,113,1952,Bob Scott,Johnny McDowell,0,0,0,Johnny McDowell
702,733,113,1952,Bob Scott,Chet Miller,0,0,0,Chet Miller
726,728,113,1952,George Connor,Joe James,0,0,0,Joe James
726,732,113,1952,George Connor,Johnny McDowell,0,0,0,Johnny McDowell
726,733,113,1952,George Connor,Chet Miller,0,0,0,Chet Miller
728,732,113,1952,Joe James,Johnny McDowell,0,0,0,Johnny McDowell
728,733,113,1952,Joe James,Chet Miller,0,0,0,Chet Miller
732,733,113,1952,Johnny McDowell,Chet Miller,0,0,0,Chet Miller
449,509,113,1953,Rodger Ward,Jim Rathmann,0,0,0,Jim Rathmann
449,512,113,1953,Rodger Ward,Johnny Thomson,0,0,0,Johnny Thomson
449,513,113,1953,Rodger Ward,Eddie Johnson,0,0,0,Eddie Johnson
449,518,113,1953,Rodger Ward,Duane Carter,0,2,2,Duane Carter
449,520,113,1953,Rodger Ward,Gene Hartley,0,0,0,Gene Hartley
449,521,113,1953,Rodger Ward,Chuck Stevenson,0,0,0,Chuck Stevenson
449,555,113,1953,Rodger Ward,Paul Russo,0,2,2,Paul Russo
449,556,113,1953,Rodger Ward,Jimmy Daywalt,0,0,0,Jimmy Daywalt
449,593,113,1953,Rodger Ward,Johnnie Parsons,0,0,0,Johnnie Parsons
449,611,113,1953,Rodger Ward,Sam Hanks,0,2,2,Sam Hanks
449,612,113,1953,Rodger Ward,Andy Linden,0,0,0,Andy Linden
449,613,113,1953,Rodger Ward,Marshall Teague,0,0,0,Marshall Teague
449,615,113,1953,Rodger Ward,Fred Agabashian,0,2,2,Fred Agabashian
449,630,113,1953,Rodger Ward,Duke Dinsmore,0,0,0,Duke Dinsmore
449,653,113,1953,Rodger Ward,Jimmy Davies,0,0,0,Jimmy Davies
449,654,113,1953,Rodger Ward,Walt Faulkner,0,0,0,Walt Faulkner
449,655,113,1953,Rodger Ward,Cal Niday,0,0,0,Cal Niday
449,656,113,1953,Rodger Ward,Art Cross,0,6,6,Art Cross
449,657,113,1953,Rodger Ward,Bill Vukovich,0,9,9,Bill Vukovich
449,658,113,1953,Rodger Ward,Jack McGrath,0,2,2,Jack McGrath
449,659,113,1953,Rodger Ward,Jerry Hoyt,0,0,0,Jerry Hoyt
449,677,113,1953,Rodger Ward,Travis Webb,0,0,0,Travis Webb
449,699,113,1953,Rodger Ward,Duke Nalon,0,0,0,Duke Nalon
449,700,113,1953,Rodger Ward,Carl Scarborough,0,0,0,Carl Scarborough
449,701,113,1953,Rodger Ward,Bill Holland,0,0,0,Bill Holland
449,702,113,1953,Rodger Ward,Bob Scott,0,0,0,Bob Scott
449,797,113,1953,Rodger Ward,Jackie Holmes,0,0,0,Jackie Holmes
449,804,113,1953,Rodger Ward,Johnny Mantz,0,0,0,Johnny Mantz
509,512,113,1953,Jim Rathmann,Johnny Thomson,0,0,0,Johnny Thomson
509,513,113,1953,Jim Rathmann,Eddie Johnson,0,0,0,Eddie Johnson
509,518,113,1953,Jim Rathmann,Duane Carter,0,2,2,Duane Carter
509,520,113,1953,Jim Rathmann,Gene Hartley,0,0,0,Gene Hartley
509,521,113,1953,Jim Rathmann,Chuck Stevenson,0,0,0,Chuck Stevenson
509,555,113,1953,Jim Rathmann,Paul Russo,0,2,2,Paul Russo
509,556,113,1953,Jim Rathmann,Jimmy Daywalt,0,0,0,Jimmy Daywalt
509,593,113,1953,Jim Rathmann,Johnnie Parsons,0,0,0,Johnnie Parsons
509,611,113,1953,Jim Rathmann,Sam Hanks,0,2,2,Sam Hanks
509,612,113,1953,Jim Rathmann,Andy Linden,0,0,0,Andy Linden
509,613,113,1953,Jim Rathmann,Marshall Teague,0,0,0,Marshall Teague
509,615,113,1953,Jim Rathmann,Fred Agabashian,0,2,2,Fred Agabashian
509,630,113,1953,Jim Rathmann,Duke Dinsmore,0,0,0,Duke Dinsmore
509,653,113,1953,Jim Rathmann,Jimmy Davies,0,0,0,Jimmy Davies
509,654,113,1953,Jim Rathmann,Walt Faulkner,0,0,0,Walt Faulkner
509,655,113,1953,Jim Rathmann,Cal Niday,0,0,0,Cal Niday
509,656,113,1953,Jim Rathmann,Art Cross,0,6,6,Art Cross
509,657,113,1953,Jim Rathmann,Bill Vukovich,0,9,9,Bill Vukovich
509,658,113,1953,Jim Rathmann,Jack McGrath,0,2,2,Jack McGrath
509,659,113,1953,Jim Rathmann,Jerry Hoyt,0,0,0,Jerry Hoyt
509,677,113,1953,Jim Rathmann,Travis Webb,0,0,0,Travis Webb
509,699,113,1953,Jim Rathmann,Duke Nalon,0,0,0,Duke Nalon
509,700,113,1953,Jim Rathmann,Carl Scarborough,0,0,0,Carl Scarborough
509,701,113,1953,Jim Rathmann,Bill Holland,0,0,0,Bill Holland
509,702,113,1953,Jim Rathmann,Bob Scott,0,0,0,Bob Scott
509,797,113,1953,Jim Rathmann,Jackie Holmes,0,0,0,Jackie Holmes
509,804,113,1953,Jim Rathmann,Johnny Mantz,0,0,0,Johnny Mantz
512,513,113,1953,Johnny Thomson,Eddie Johnson,0,0,0,Eddie Johnson
512,518,113,1953,Johnny Thomson,Duane Carter,0,2,2,Duane Carter
512,520,113,1953,Johnny Thomson,Gene Hartley,0,0,0,Gene Hartley
512,521,113,1953,Johnny Thomson,Chuck Stevenson,0,0,0,Chuck Stevenson
512,555,113,1953,Johnny Thomson,Paul Russo,0,2,2,Paul Russo
512,556,113,1953,Johnny Thomson,Jimmy Daywalt,0,0,0,Jimmy Daywalt
512,593,113,1953,Johnny Thomson,Johnnie Parsons,0,0,0,Johnnie Parsons
512,611,113,1953,Johnny Thomson,Sam Hanks,0,2,2,Sam Hanks
512,612,113,1953,Johnny Thomson,Andy Linden,0,0,0,Andy Linden
512,613,113,1953,Johnny Thomson,Marshall Teague,0,0,0,Marshall Teague
512,615,113,1953,Johnny Thomson,Fred Agabashian,0,2,2,Fred Agabashian
512,630,113,1953,Johnny Thomson,Duke Dinsmore,0,0,0,Duke Dinsmore
512,653,113,1953,Johnny Thomson,Jimmy Davies,0,0,0,Jimmy Davies
512,654,113,1953,Johnny Thomson,Walt Faulkner,0,0,0,Walt Faulkner
512,655,113,1953,Johnny Thomson,Cal Niday,0,0,0,Cal Niday
512,656,113,1953,Johnny Thomson,Art Cross,0,6,6,Art Cross
512,657,113,1953,Johnny Thomson,Bill Vukovich,0,9,9,Bill Vukovich
512,658,113,1953,Johnny Thomson,Jack McGrath,0,2,2,Jack McGrath
512,659,113,1953,Johnny Thomson,Jerry Hoyt,0,0,0,Jerry Hoyt
512,677,113,1953,Johnny Thomson,Travis Webb,0,0,0,Travis Webb
512,699,113,1953,Johnny Thomson,Duke Nalon,0,0,0,Duke Nalon
512,700,113,1953,Johnny Thomson,Carl Scarborough,0,0,0,Carl Scarborough
512,701,113,1953,Johnny Thomson,Bill Holland,0,0,0,Bill Holland
512,702,113,1953,Johnny Thomson,Bob Scott,0,0,0,Bob Scott
512,797,113,1953,Johnny Thomson,Jackie Holmes,0,0,0,Jackie Holmes
512,804,113,1953,Johnny Thomson,Johnny Mantz,0,0,0,Johnny Mantz
513,518,113,1953,Eddie Johnson,Duane Carter,0,2,2,Duane Carter
513,520,113,1953,Eddie Johnson,Gene Hartley,0,0,0,Gene Hartley
513,521,113,1953,Eddie Johnson,Chuck Stevenson,0,0,0,Chuck Stevenson
513,555,113,1953,Eddie Johnson,Paul Russo,0,2,2,Paul Russo
513,556,113,1953,Eddie Johnson,Jimmy Daywalt,0,0,0,Jimmy Daywalt
513,593,113,1953,Eddie Johnson,Johnnie Parsons,0,0,0,Johnnie Parsons
513,611,113,1953,Eddie Johnson,Sam Hanks,0,2,2,Sam Hanks
513,612,113,1953,Eddie Johnson,Andy Linden,0,0,0,Andy Linden
513,613,113,1953,Eddie Johnson,Marshall Teague,0,0,0,Marshall Teague
513,615,113,1953,Eddie Johnson,Fred Agabashian,0,2,2,Fred Agabashian
513,630,113,1953,Eddie Johnson,Duke Dinsmore,0,0,0,Duke Dinsmore
513,653,113,1953,Eddie Johnson,Jimmy Davies,0,0,0,Jimmy Davies
513,654,113,1953,Eddie Johnson,Walt Faulkner,0,0,0,Walt Faulkner
513,655,113,1953,Eddie Johnson,Cal Niday,0,0,0,Cal Niday
513,656,113,1953,Eddie Johnson,Art Cross,0,6,6,Art Cross
513,657,113,1953,Eddie Johnson,Bill Vukovich,0,9,9,Bill Vukovich
513,658,113,1953,Eddie Johnson,Jack McGrath,0,2,2,Jack McGrath
513,659,113,1953,Eddie Johnson,Jerry Hoyt,0,0,0,Jerry Hoyt
513,677,113,1953,Eddie Johnson,Travis Webb,0,0,0,Travis Webb
513,699,113,1953,Eddie Johnson,Duke Nalon,0,0,0,Duke Nalon
513,700,113,1953,Eddie Johnson,Carl Scarborough,0,0,0,Carl Scarborough
513,701,113,1953,Eddie Johnson,Bill Holland,0,0,0,Bill Holland
513,702,113,1953,Eddie Johnson,Bob Scott,0,0,0,Bob Scott
513,797,113,1953,Eddie Johnson,Jackie Holmes,0,0,0,Jackie Holmes
513,804,113,1953,Eddie Johnson,Johnny Mantz,0,0,0,Johnny Mantz
518,520,113,1953,Duane Carter,Gene Hartley,2,0,2,Duane Carter
518,521,113,1953,Duane Carter,Chuck Stevenson,2,0,2,Duane Carter
518,555,113,1953,Duane Carter,Paul Russo,2,2,0,Paul Russo
518,556,113,1953,Duane Carter,Jimmy Daywalt,2,0,2,Duane Carter
518,593,113,1953,Duane Carter,Johnnie Parsons,2,0,2,Duane Carter
518,611,113,1953,Duane Carter,Sam Hanks,2,2,0,Sam Hanks
518,612,113,1953,Duane Carter,Andy Linden,2,0,2,Duane Carter
518,613,113,1953,Duane Carter,Marshall Teague,2,0,2,Duane Carter
518,615,113,1953,Duane Carter,Fred Agabashian,2,2,0,Fred Agabashian
518,630,113,1953,Duane Carter,Duke Dinsmore,2,0,2,Duane Carter
518,653,113,1953,Duane Carter,Jimmy Davies,2,0,2,Duane Carter
518,654,113,1953,Duane Carter,Walt Faulkner,2,0,2,Duane Carter
518,655,113,1953,Duane Carter,Cal Niday,2,0,2,Duane Carter
518,656,113,1953,Duane Carter,Art Cross,2,6,4,Art Cross
518,657,113,1953,Duane Carter,Bill Vukovich,2,9,7,Bill Vukovich
518,658,113,1953,Duane Carter,Jack McGrath,2,2,0,Jack McGrath
518,659,113,1953,Duane Carter,Jerry Hoyt,2,0,2,Duane Carter
518,677,113,1953,Duane Carter,Travis Webb,2,0,2,Duane Carter
518,699,113,1953,Duane Carter,Duke Nalon,2,0,2,Duane Carter
518,700,113,1953,Duane Carter,Carl Scarborough,2,0,2,Duane Carter
518,701,113,1953,Duane Carter,Bill Holland,2,0,2,Duane Carter
518,702,113,1953,Duane Carter,Bob Scott,2,0,2,Duane Carter
518,797,113,1953,Duane Carter,Jackie Holmes,2,0,2,Duane Carter
518,804,113,1953,Duane Carter,Johnny Mantz,2,0,2,Duane Carter
520,521,113,1953,Gene Hartley,Chuck Stevenson,0,0,0,Chuck Stevenson
520,555,113,1953,Gene Hartley,Paul Russo,0,2,2,Paul Russo
520,556,113,1953,Gene Hartley,Jimmy Daywalt,0,0,0,Jimmy Daywalt
520,593,113,1953,Gene Hartley,Johnnie Parsons,0,0,0,Johnnie Parsons
520,611,113,1953,Gene Hartley,Sam Hanks,0,2,2,Sam Hanks
520,612,113,1953,Gene Hartley,Andy Linden,0,0,0,Andy Linden
520,613,113,1953,Gene Hartley,Marshall Teague,0,0,0,Marshall Teague
520,615,113,1953,Gene Hartley,Fred Agabashian,0,2,2,Fred Agabashian
520,630,113,1953,Gene Hartley,Duke Dinsmore,0,0,0,Duke Dinsmore
520,653,113,1953,Gene Hartley,Jimmy Davies,0,0,0,Jimmy Davies
520,654,113,1953,Gene Hartley,Walt Faulkner,0,0,0,Walt Faulkner
520,655,113,1953,Gene Hartley,Cal Niday,0,0,0,Cal Niday
520,656,113,1953,Gene Hartley,Art Cross,0,6,6,Art Cross
520,657,113,1953,Gene Hartley,Bill Vukovich,0,9,9,Bill Vukovich
520,658,113,1953,Gene Hartley,Jack McGrath,0,2,2,Jack McGrath
520,659,113,1953,Gene Hartley,Jerry Hoyt,0,0,0,Jerry Hoyt
520,677,113,1953,Gene Hartley,Travis Webb,0,0,0,Travis Webb
520,699,113,1953,Gene Hartley,Duke Nalon,0,0,0,Duke Nalon
520,700,113,1953,Gene Hartley,Carl Scarborough,0,0,0,Carl Scarborough
520,701,113,1953,Gene Hartley,Bill Holland,0,0,0,Bill Holland
520,702,113,1953,Gene Hartley,Bob Scott,0,0,0,Bob Scott
520,797,113,1953,Gene Hartley,Jackie Holmes,0,0,0,Jackie Holmes
520,804,113,1953,Gene Hartley,Johnny Mantz,0,0,0,Johnny Mantz
521,555,113,1953,Chuck Stevenson,Paul Russo,0,2,2,Paul Russo
521,556,113,1953,Chuck Stevenson,Jimmy Daywalt,0,0,0,Jimmy Daywalt
521,593,113,1953,Chuck Stevenson,Johnnie Parsons,0,0,0,Johnnie Parsons
521,611,113,1953,Chuck Stevenson,Sam Hanks,0,2,2,Sam Hanks
521,612,113,1953,Chuck Stevenson,Andy Linden,0,0,0,Andy Linden
521,613,113,1953,Chuck Stevenson,Marshall Teague,0,0,0,Marshall Teague
521,615,113,1953,Chuck Stevenson,Fred Agabashian,0,2,2,Fred Agabashian
521,630,113,1953,Chuck Stevenson,Duke Dinsmore,0,0,0,Duke Dinsmore
521,653,113,1953,Chuck Stevenson,Jimmy Davies,0,0,0,Jimmy Davies
521,654,113,1953,Chuck Stevenson,Walt Faulkner,0,0,0,Walt Faulkner
521,655,113,1953,Chuck Stevenson,Cal Niday,0,0,0,Cal Niday
521,656,113,1953,Chuck Stevenson,Art Cross,0,6,6,Art Cross
521,657,113,1953,Chuck Stevenson,Bill Vukovich,0,9,9,Bill Vukovich
521,658,113,1953,Chuck Stevenson,Jack McGrath,0,2,2,Jack McGrath
521,659,113,1953,Chuck Stevenson,Jerry Hoyt,0,0,0,Jerry Hoyt
521,677,113,1953,Chuck Stevenson,Travis Webb,0,0,0,Travis Webb
521,699,113,1953,Chuck Stevenson,Duke Nalon,0,0,0,Duke Nalon
521,700,113,1953,Chuck Stevenson,Carl Scarborough,0,0,0,Carl Scarborough
521,701,113,1953,Chuck Stevenson,Bill Holland,0,0,0,Bill Holland
521,702,113,1953,Chuck Stevenson,Bob Scott,0,0,0,Bob Scott
521,797,113,1953,Chuck Stevenson,Jackie Holmes,0,0,0,Jackie Holmes
521,804,113,1953,Chuck Stevenson,Johnny Mantz,0,0,0,Johnny Mantz
555,556,113,1953,Paul Russo,Jimmy Daywalt,2,0,2,Paul Russo
555,593,113,1953,Paul Russo,Johnnie Parsons,2,0,2,Paul Russo
555,611,113,1953,Paul Russo,Sam Hanks,2,2,0,Sam Hanks
555,612,113,1953,Paul Russo,Andy Linden,2,0,2,Paul Russo
555,613,113,1953,Paul Russo,Marshall Teague,2,0,2,Paul Russo
555,615,113,1953,Paul Russo,Fred Agabashian,2,2,0,Fred Agabashian
555,630,113,1953,Paul Russo,Duke Dinsmore,2,0,2,Paul Russo
555,653,113,1953,Paul Russo,Jimmy Davies,2,0,2,Paul Russo
555,654,113,1953,Paul Russo,Walt Faulkner,2,0,2,Paul Russo
555,655,113,1953,Paul Russo,Cal Niday,2,0,2,Paul Russo
555,656,113,1953,Paul Russo,Art Cross,2,6,4,Art Cross
555,657,113,1953,Paul Russo,Bill Vukovich,2,9,7,Bill Vukovich
555,658,113,1953,Paul Russo,Jack McGrath,2,2,0,Jack McGrath
555,659,113,1953,Paul Russo,Jerry Hoyt,2,0,2,Paul Russo
555,677,113,1953,Paul Russo,Travis Webb,2,0,2,Paul Russo
555,699,113,1953,Paul Russo,Duke Nalon,2,0,2,Paul Russo
555,700,113,1953,Paul Russo,Carl Scarborough,2,0,2,Paul Russo
555,701,113,1953,Paul Russo,Bill Holland,2,0,2,Paul Russo
555,702,113,1953,Paul Russo,Bob Scott,2,0,2,Paul Russo
555,797,113,1953,Paul Russo,Jackie Holmes,2,0,2,Paul Russo
555,804,113,1953,Paul Russo,Johnny Mantz,2,0,2,Paul Russo
556,593,113,1953,Jimmy Daywalt,Johnnie Parsons,0,0,0,Johnnie Parsons
556,611,113,1953,Jimmy Daywalt,Sam Hanks,0,2,2,Sam Hanks
556,612,113,1953,Jimmy Daywalt,Andy Linden,0,0,0,Andy Linden
556,613,113,1953,Jimmy Daywalt,Marshall Teague,0,0,0,Marshall Teague
556,615,113,1953,Jimmy Daywalt,Fred Agabashian,0,2,2,Fred Agabashian
556,630,113,1953,Jimmy Daywalt,Duke Dinsmore,0,0,0,Duke Dinsmore
556,653,113,1953,Jimmy Daywalt,Jimmy Davies,0,0,0,Jimmy Davies
556,654,113,1953,Jimmy Daywalt,Walt Faulkner,0,0,0,Walt Faulkner
556,655,113,1953,Jimmy Daywalt,Cal Niday,0,0,0,Cal Niday
556,656,113,1953,Jimmy Daywalt,Art Cross,0,6,6,Art Cross
556,657,113,1953,Jimmy Daywalt,Bill Vukovich,0,9,9,Bill Vukovich
556,658,113,1953,Jimmy Daywalt,Jack McGrath,0,2,2,Jack McGrath
556,659,113,1953,Jimmy Daywalt,Jerry Hoyt,0,0,0,Jerry Hoyt
556,677,113,1953,Jimmy Daywalt,Travis Webb,0,0,0,Travis Webb
556,699,113,1953,Jimmy Daywalt,Duke Nalon,0,0,0,Duke Nalon
556,700,113,1953,Jimmy Daywalt,Carl Scarborough,0,0,0,Carl Scarborough
556,701,113,1953,Jimmy Daywalt,Bill Holland,0,0,0,Bill Holland
556,702,113,1953,Jimmy Daywalt,Bob Scott,0,0,0,Bob Scott
556,797,113,1953,Jimmy Daywalt,Jackie Holmes,0,0,0,Jackie Holmes
556,804,113,1953,Jimmy Daywalt,Johnny Mantz,0,0,0,Johnny Mantz
593,611,113,1953,Johnnie Parsons,Sam Hanks,0,2,2,Sam Hanks
593,612,113,1953,Johnnie Parsons,Andy Linden,0,0,0,Andy Linden
593,613,113,1953,Johnnie Parsons,Marshall Teague,0,0,0,Marshall Teague
593,615,113,1953,Johnnie Parsons,Fred Agabashian,0,2,2,Fred Agabashian
593,630,113,1953,Johnnie Parsons,Duke Dinsmore,0,0,0,Duke Dinsmore
593,653,113,1953,Johnnie Parsons,Jimmy Davies,0,0,0,Jimmy Davies
593,654,113,1953,Johnnie Parsons,Walt Faulkner,0,0,0,Walt Faulkner
593,655,113,1953,Johnnie Parsons,Cal Niday,0,0,0,Cal Niday
593,656,113,1953,Johnnie Parsons,Art Cross,0,6,6,Art Cross
593,657,113,1953,Johnnie Parsons,Bill Vukovich,0,9,9,Bill Vukovich
593,658,113,1953,Johnnie Parsons,Jack McGrath,0,2,2,Jack McGrath
593,659,113,1953,Johnnie Parsons,Jerry Hoyt,0,0,0,Jerry Hoyt
593,677,113,1953,Johnnie Parsons,Travis Webb,0,0,0,Travis Webb
593,699,113,1953,Johnnie Parsons,Duke Nalon,0,0,0,Duke Nalon
593,700,113,1953,Johnnie Parsons,Carl Scarborough,0,0,0,Carl Scarborough
593,701,113,1953,Johnnie Parsons,Bill Holland,0,0,0,Bill Holland
593,702,113,1953,Johnnie Parsons,Bob Scott,0,0,0,Bob Scott
593,797,113,1953,Johnnie Parsons,Jackie Holmes,0,0,0,Jackie Holmes
593,804,113,1953,Johnnie Parsons,Johnny Mantz,0,0,0,Johnny Mantz
611,612,113,1953,Sam Hanks,Andy Linden,2,0,2,Sam Hanks
611,613,113,1953,Sam Hanks,Marshall Teague,2,0,2,Sam Hanks
611,615,113,1953,Sam Hanks,Fred Agabashian,2,2,0,Fred Agabashian
611,630,113,1953,Sam Hanks,Duke Dinsmore,2,0,2,Sam Hanks
611,653,113,1953,Sam Hanks,Jimmy Davies,2,0,2,Sam Hanks
611,654,113,1953,Sam Hanks,Walt Faulkner,2,0,2,Sam Hanks
611,655,113,1953,Sam Hanks,Cal Niday,2,0,2,Sam Hanks
611,656,113,1953,Sam Hanks,Art Cross,2,6,4,Art Cross
611,657,113,1953,Sam Hanks,Bill Vukovich,2,9,7,Bill Vukovich
611,658,113,1953,Sam Hanks,Jack McGrath,2,2,0,Jack McGrath
611,659,113,1953,Sam Hanks,Jerry Hoyt,2,0,2,Sam Hanks
611,677,113,1953,Sam Hanks,Travis Webb,2,0,2,Sam Hanks
611,699,113,1953,Sam Hanks,Duke Nalon,2,0,2,Sam Hanks
611,700,113,1953,Sam Hanks,Carl Scarborough,2,0,2,Sam Hanks
611,701,113,1953,Sam Hanks,Bill Holland,2,0,2,Sam Hanks
611,702,113,1953,Sam Hanks,Bob Scott,2,0,2,Sam Hanks
611,797,113,1953,Sam Hanks,Jackie Holmes,2,0,2,Sam Hanks
611,804,113,1953,Sam Hanks,Johnny Mantz,2,0,2,Sam Hanks
612,613,113,1953,Andy Linden,Marshall Teague,0,0,0,Marshall Teague
612,615,113,1953,Andy Linden,Fred Agabashian,0,2,2,Fred Agabashian
612,630,113,1953,Andy Linden,Duke Dinsmore,0,0,0,Duke Dinsmore
612,653,113,1953,Andy Linden,Jimmy Davies,0,0,0,Jimmy Davies
612,654,113,1953,Andy Linden,Walt Faulkner,0,0,0,Walt Faulkner
612,655,113,1953,Andy Linden,Cal Niday,0,0,0,Cal Niday
612,656,113,1953,Andy Linden,Art Cross,0,6,6,Art Cross
612,657,113,1953,Andy Linden,Bill Vukovich,0,9,9,Bill Vukovich
612,658,113,1953,Andy Linden,Jack McGrath,0,2,2,Jack McGrath
612,659,113,1953,Andy Linden,Jerry Hoyt,0,0,0,Jerry Hoyt
612,677,113,1953,Andy Linden,Travis Webb,0,0,0,Travis Webb
612,699,113,1953,Andy Linden,Duke Nalon,0,0,0,Duke Nalon
612,700,113,1953,Andy Linden,Carl Scarborough,0,0,0,Carl Scarborough
612,701,113,1953,Andy Linden,Bill Holland,0,0,0,Bill Holland
612,702,113,1953,Andy Linden,Bob Scott,0,0,0,Bob Scott
612,797,113,1953,Andy Linden,Jackie Holmes,0,0,0,Jackie Holmes
612,804,113,1953,Andy Linden,Johnny Mantz,0,0,0,Johnny Mantz
613,615,113,1953,Marshall Teague,Fred Agabashian,0,2,2,Fred Agabashian
613,630,113,1953,Marshall Teague,Duke Dinsmore,0,0,0,Duke Dinsmore
613,653,113,1953,Marshall Teague,Jimmy Davies,0,0,0,Jimmy Davies
613,654,113,1953,Marshall Teague,Walt Faulkner,0,0,0,Walt Faulkner
613,655,113,1953,Marshall Teague,Cal Niday,0,0,0,Cal Niday
613,656,113,1953,Marshall Teague,Art Cross,0,6,6,Art Cross
613,657,113,1953,Marshall Teague,Bill Vukovich,0,9,9,Bill Vukovich
613,658,113,1953,Marshall Teague,Jack McGrath,0,2,2,Jack McGrath
613,659,113,1953,Marshall Teague,Jerry Hoyt,0,0,0,Jerry Hoyt
613,677,113,1953,Marshall Teague,Travis Webb,0,0,0,Travis Webb
613,699,113,1953,Marshall Teague,Duke Nalon,0,0,0,Duke Nalon
613,700,113,1953,Marshall Teague,Carl Scarborough,0,0,0,Carl Scarborough
613,701,113,1953,Marshall Teague,Bill Holland,0,0,0,Bill Holland
613,702,113,1953,Marshall Teague,Bob Scott,0,0,0,Bob Scott
613,797,113,1953,Marshall Teague,Jackie Holmes,0,0,0,Jackie Holmes
613,804,113,1953,Marshall Teague,Johnny Mantz,0,0,0,Johnny Mantz
615,630,113,1953,Fred Agabashian,Duke Dinsmore,2,0,2,Fred Agabashian
615,653,113,1953,Fred Agabashian,Jimmy Davies,2,0,2,Fred Agabashian
615,654,113,1953,Fred Agabashian,Walt Faulkner,2,0,2,Fred Agabashian
615,655,113,1953,Fred Agabashian,Cal Niday,2,0,2,Fred Agabashian
615,656,113,1953,Fred Agabashian,Art Cross,2,6,4,Art Cross
615,657,113,1953,Fred Agabashian,Bill Vukovich,2,9,7,Bill Vukovich
615,658,113,1953,Fred Agabashian,Jack McGrath,2,2,0,Jack McGrath
615,659,113,1953,Fred Agabashian,Jerry Hoyt,2,0,2,Fred Agabashian
615,677,113,1953,Fred Agabashian,Travis Webb,2,0,2,Fred Agabashian
615,699,113,1953,Fred Agabashian,Duke Nalon,2,0,2,Fred Agabashian
615,700,113,1953,Fred Agabashian,Carl Scarborough,2,0,2,Fred Agabashian
615,701,113,1953,Fred Agabashian,Bill Holland,2,0,2,Fred Agabashian
615,702,113,1953,Fred Agabashian,Bob Scott,2,0,2,Fred Agabashian
615,797,113,1953,Fred Agabashian,Jackie Holmes,2,0,2,Fred Agabashian
615,804,113,1953,Fred Agabashian,Johnny Mantz,2,0,2,Fred Agabashian
630,653,113,1953,Duke Dinsmore,Jimmy Davies,0,0,0,Jimmy Davies
630,654,113,1953,Duke Dinsmore,Walt Faulkner,0,0,0,Walt Faulkner
630,655,113,1953,Duke Dinsmore,Cal Niday,0,0,0,Cal Niday
630,656,113,1953,Duke Dinsmore,Art Cross,0,6,6,Art Cross
630,657,113,1953,Duke Dinsmore,Bill Vukovich,0,9,9,Bill Vukovich
630,658,113,1953,Duke Dinsmore,Jack McGrath,0,2,2,Jack McGrath
630,659,113,1953,Duke Dinsmore,Jerry Hoyt,0,0,0,Jerry Hoyt
630,677,113,1953,Duke Dinsmore,Travis Webb,0,0,0,Travis Webb
630,699,113,1953,Duke Dinsmore,Duke Nalon,0,0,0,Duke Nalon
630,700,113,1953,Duke Dinsmore,Carl Scarborough,0,0,0,Carl Scarborough
630,701,113,1953,Duke Dinsmore,Bill Holland,0,0,0,Bill Holland
630,702,113,1953,Duke Dinsmore,Bob Scott,0,0,0,Bob Scott
630,797,113,1953,Duke Dinsmore,Jackie Holmes,0,0,0,Jackie Holmes
630,804,113,1953,Duke Dinsmore,Johnny Mantz,0,0,0,Johnny Mantz
653,654,113,1953,Jimmy Davies,Walt Faulkner,0,0,0,Walt Faulkner
653,655,113,1953,Jimmy Davies,Cal Niday,0,0,0,Cal Niday
653,656,113,1953,Jimmy Davies,Art Cross,0,6,6,Art Cross
653,657,113,1953,Jimmy Davies,Bill Vukovich,0,9,9,Bill Vukovich
653,658,113,1953,Jimmy Davies,Jack McGrath,0,2,2,Jack McGrath
653,659,113,1953,Jimmy Davies,Jerry Hoyt,0,0,0,Jerry Hoyt
653,677,113,1953,Jimmy Davies,Travis Webb,0,0,0,Travis Webb
653,699,113,1953,Jimmy Davies,Duke Nalon,0,0,0,Duke Nalon
653,700,113,1953,Jimmy Davies,Carl Scarborough,0,0,0,Carl Scarborough
653,701,113,1953,Jimmy Davies,Bill Holland,0,0,0,Bill Holland
653,702,113,1953,Jimmy Davies,Bob Scott,0,0,0,Bob Scott
653,797,113,1953,Jimmy Davies,Jackie Holmes,0,0,0,Jackie Holmes
653,804,113,1953,Jimmy Davies,Johnny Mantz,0,0,0,Johnny Mantz
654,655,113,1953,Walt Faulkner,Cal Niday,0,0,0,Cal Niday
654,656,113,1953,Walt Faulkner,Art Cross,0,6,6,Art Cross
654,657,113,1953,Walt Faulkner,Bill Vukovich,0,9,9,Bill Vukovich
654,658,113,1953,Walt Faulkner,Jack McGrath,0,2,2,Jack McGrath
654,659,113,1953,Walt Faulkner,Jerry Hoyt,0,0,0,Jerry Hoyt
654,677,113,1953,Walt Faulkner,Travis Webb,0,0,0,Travis Webb
654,699,113,1953,Walt Faulkner,Duke Nalon,0,0,0,Duke Nalon
654,700,113,1953,Walt Faulkner,Carl Scarborough,0,0,0,Carl Scarborough
654,701,113,1953,Walt Faulkner,Bill Holland,0,0,0,Bill Holland
654,702,113,1953,Walt Faulkner,Bob Scott,0,0,0,Bob Scott
654,797,113,1953,Walt Faulkner,Jackie Holmes,0,0,0,Jackie Holmes
654,804,113,1953,Walt Faulkner,Johnny Mantz,0,0,0,Johnny Mantz
655,656,113,1953,Cal Niday,Art Cross,0,6,6,Art Cross
655,657,113,1953,Cal Niday,Bill Vukovich,0,9,9,Bill Vukovich
655,658,113,1953,Cal Niday,Jack McGrath,0,2,2,Jack McGrath
655,659,113,1953,Cal Niday,Jerry Hoyt,0,0,0,Jerry Hoyt
655,677,113,1953,Cal Niday,Travis Webb,0,0,0,Travis Webb
655,699,113,1953,Cal Niday,Duke Nalon,0,0,0,Duke Nalon
655,700,113,1953,Cal Niday,Carl Scarborough,0,0,0,Carl Scarborough
655,701,113,1953,Cal Niday,Bill Holland,0,0,0,Bill Holland
655,702,113,1953,Cal Niday,Bob Scott,0,0,0,Bob Scott
655,797,113,1953,Cal Niday,Jackie Holmes,0,0,0,Jackie Holmes
655,804,113,1953,Cal Niday,Johnny Mantz,0,0,0,Johnny Mantz
656,657,113,1953,Art Cross,Bill Vukovich,6,9,3,Bill Vukovich
656,658,113,1953,Art Cross,Jack McGrath,6,2,4,Art Cross
656,659,113,1953,Art Cross,Jerry Hoyt,6,0,6,Art Cross
656,677,113,1953,Art Cross,Travis Webb,6,0,6,Art Cross
656,699,113,1953,Art Cross,Duke Nalon,6,0,6,Art Cross
656,700,113,1953,Art Cross,Carl Scarborough,6,0,6,Art Cross
656,701,113,1953,Art Cross,Bill Holland,6,0,6,Art Cross
656,702,113,1953,Art Cross,Bob Scott,6,0,6,Art Cross
656,797,113,1953,Art Cross,Jackie Holmes,6,0,6,Art Cross
656,804,113,1953,Art Cross,Johnny Mantz,6,0,6,Art Cross
657,658,113,1953,Bill Vukovich,Jack McGrath,9,2,7,Bill Vukovich
657,659,113,1953,Bill Vukovich,Jerry Hoyt,9,0,9,Bill Vukovich
657,677,113,1953,Bill Vukovich,Travis Webb,9,0,9,Bill Vukovich
657,699,113,1953,Bill Vukovich,Duke Nalon,9,0,9,Bill Vukovich
657,700,113,1953,Bill Vukovich,Carl Scarborough,9,0,9,Bill Vukovich
657,701,113,1953,Bill Vukovich,Bill Holland,9,0,9,Bill Vukovich
657,702,113,1953,Bill Vukovich,Bob Scott,9,0,9,Bill Vukovich
657,797,113,1953,Bill Vukovich,Jackie Holmes,9,0,9,Bill Vukovich
657,804,113,1953,Bill Vukovich,Johnny Mantz,9,0,9,Bill Vukovich
658,659,113,1953,Jack McGrath,Jerry Hoyt,2,0,2,Jack McGrath
658,677,113,1953,Jack McGrath,Travis Webb,2,0,2,Jack McGrath
658,699,113,1953,Jack McGrath,Duke Nalon,2,0,2,Jack McGrath
658,700,113,1953,Jack McGrath,Carl Scarborough,2,0,2,Jack McGrath
658,701,113,1953,Jack McGrath,Bill Holland,2,0,2,Jack McGrath
658,702,113,1953,Jack McGrath,Bob Scott,2,0,2,Jack McGrath
658,797,113,1953,Jack McGrath,Jackie Holmes,2,0,2,Jack McGrath
658,804,113,1953,Jack McGrath,Johnny Mantz,2,0,2,Jack McGrath
659,677,113,1953,Jerry Hoyt,Travis Webb,0,0,0,Travis Webb
659,699,113,1953,Jerry Hoyt,Duke Nalon,0,0,0,Duke Nalon
659,700,113,1953,Jerry Hoyt,Carl Scarborough,0,0,0,Carl Scarborough
659,701,113,1953,Jerry Hoyt,Bill Holland,0,0,0,Bill Holland
659,702,113,1953,Jerry Hoyt,Bob Scott,0,0,0,Bob Scott
659,797,113,1953,Jerry Hoyt,Jackie Holmes,0,0,0,Jackie Holmes
659,804,113,1953,Jerry Hoyt,Johnny Mantz,0,0,0,Johnny Mantz
677,699,113,1953,Travis Webb,Duke Nalon,0,0,0,Duke Nalon
677,700,113,1953,Travis Webb,Carl Scarborough,0,0,0,Carl Scarborough
677,701,113,1953,Travis Webb,Bill Holland,0,0,0,Bill Holland
677,702,113,1953,Travis Webb,Bob Scott,0,0,0,Bob Scott
677,797,113,1953,Travis Webb,Jackie Holmes,0,0,0,Jackie Holmes
677,804,113,1953,Travis Webb,Johnny Mantz,0,0,0,Johnny Mantz
699,700,113,1953,Duke Nalon,Carl Scarborough,0,0,0,Carl Scarborough
699,701,113,1953,Duke Nalon,Bill Holland,0,0,0,Bill Holland
699,702,113,1953,Duke Nalon,Bob Scott,0,0,0,Bob Scott
699,797,113,1953,Duke Nalon,Jackie Holmes,0,0,0,Jackie Holmes
699,804,113,1953,Duke Nalon,Johnny Mantz,0,0,0,Johnny Mantz
700,701,113,1953,Carl Scarborough,Bill Holland,0,0,0,Bill Holland
700,702,113,1953,Carl Scarborough,Bob Scott,0,0,0,Bob Scott
700,797,113,1953,Carl Scarborough,Jackie Holmes,0,0,0,Jackie Holmes
700,804,113,1953,Carl Scarborough,Johnny Mantz,0,0,0,Johnny Mantz
701,702,113,1953,Bill Holland,Bob Scott,0,0,0,Bob Scott
701,797,113,1953,Bill Holland,Jackie Holmes,0,0,0,Jackie Holmes
701,804,113,1953,Bill Holland,Johnny Mantz,0,0,0,Johnny Mantz
702,797,113,1953,Bob Scott,Jackie Holmes,0,0,0,Jackie Holmes
702,804,113,1953,Bob Scott,Johnny Mantz,0,0,0,Johnny Mantz
797,804,113,1953,Jackie Holmes,Johnny Mantz,0,0,0,Johnny Mantz
509,518,113,1954,Jim Rathmann,Duane Carter,0,2,2,Duane Carter
509,519,113,1954,Jim Rathmann,Bill Homeier,0,0,0,Bill Homeier
509,520,113,1954,Jim Rathmann,Gene Hartley,0,0,0,Gene Hartley
509,526,113,1954,Jim Rathmann,Troy Ruttman,0,2,2,Troy Ruttman
509,529,113,1954,Jim Rathmann,Tony Bettenhausen,0,0,0,Tony Bettenhausen
509,555,113,1954,Jim Rathmann,Paul Russo,0,0,0,Paul Russo
509,556,113,1954,Jim Rathmann,Jimmy Daywalt,0,0,0,Jimmy Daywalt
509,559,113,1954,Jim Rathmann,Pat Flaherty,0,0,0,Pat Flaherty
509,593,113,1954,Jim Rathmann,Johnnie Parsons,0,0,0,Johnnie Parsons
509,597,113,1954,Jim Rathmann,Pat O'Connor,0,0,0,Pat O'Connor
509,611,113,1954,Jim Rathmann,Sam Hanks,0,0,0,Sam Hanks
509,612,113,1954,Jim Rathmann,Andy Linden,0,0,0,Andy Linden
509,613,113,1954,Jim Rathmann,Marshall Teague,0,0,0,Marshall Teague
509,615,113,1954,Jim Rathmann,Fred Agabashian,0,0,0,Fred Agabashian
509,628,113,1954,Jim Rathmann,Bob Sweikert,0,0,0,Bob Sweikert
509,653,113,1954,Jim Rathmann,Jimmy Davies,0,0,0,Jimmy Davies
509,656,113,1954,Jim Rathmann,Art Cross,0,0,0,Art Cross
509,657,113,1954,Jim Rathmann,Bill Vukovich,0,8,8,Bill Vukovich
509,658,113,1954,Jim Rathmann,Jack McGrath,0,5,5,Jack McGrath
509,659,113,1954,Jim Rathmann,Jerry Hoyt,0,0,0,Jerry Hoyt
509,673,113,1954,Jim Rathmann,Mike Nazaruk,0,2,2,Mike Nazaruk
509,674,113,1954,Jim Rathmann,Larry Crockett,0,0,0,Larry Crockett
509,676,113,1954,Jim Rathmann,Frank Armi,0,0,0,Frank Armi
509,679,113,1954,Jim Rathmann,Ernie McCoy,0,0,0,Ernie McCoy
509,730,113,1954,Jim Rathmann,George Fonder,0,0,0,George Fonder
509,799,113,1954,Jim Rathmann,Jimmy Jackson,0,0,0,Jimmy Jackson
518,519,113,1954,Duane Carter,Bill Homeier,2,0,2,Duane Carter
518,520,113,1954,Duane Carter,Gene Hartley,2,0,2,Duane Carter
518,526,113,1954,Duane Carter,Troy Ruttman,2,2,0,Troy Ruttman
518,529,113,1954,Duane Carter,Tony Bettenhausen,2,0,2,Duane Carter
518,555,113,1954,Duane Carter,Paul Russo,2,0,2,Duane Carter
518,556,113,1954,Duane Carter,Jimmy Daywalt,2,0,2,Duane Carter
518,559,113,1954,Duane Carter,Pat Flaherty,2,0,2,Duane Carter
518,593,113,1954,Duane Carter,Johnnie Parsons,2,0,2,Duane Carter
518,597,113,1954,Duane Carter,Pat O'Connor,2,0,2,Duane Carter
518,611,113,1954,Duane Carter,Sam Hanks,2,0,2,Duane Carter
518,612,113,1954,Duane Carter,Andy Linden,2,0,2,Duane Carter
518,613,113,1954,Duane Carter,Marshall Teague,2,0,2,Duane Carter
518,615,113,1954,Duane Carter,Fred Agabashian,2,0,2,Duane Carter
518,628,113,1954,Duane Carter,Bob Sweikert,2,0,2,Duane Carter
518,653,113,1954,Duane Carter,Jimmy Davies,2,0,2,Duane Carter
518,656,113,1954,Duane Carter,Art Cross,2,0,2,Duane Carter
518,657,113,1954,Duane Carter,Bill Vukovich,2,8,6,Bill Vukovich
518,658,113,1954,Duane Carter,Jack McGrath,2,5,3,Jack McGrath
518,659,113,1954,Duane Carter,Jerry Hoyt,2,0,2,Duane Carter
518,673,113,1954,Duane Carter,Mike Nazaruk,2,2,0,Mike Nazaruk
518,674,113,1954,Duane Carter,Larry Crockett,2,0,2,Duane Carter
518,676,113,1954,Duane Carter,Frank Armi,2,0,2,Duane Carter
518,679,113,1954,Duane Carter,Ernie McCoy,2,0,2,Duane Carter
518,730,113,1954,Duane Carter,George Fonder,2,0,2,Duane Carter
518,799,113,1954,Duane Carter,Jimmy Jackson,2,0,2,Duane Carter
519,520,113,1954,Bill Homeier,Gene Hartley,0,0,0,Gene Hartley
519,526,113,1954,Bill Homeier,Troy Ruttman,0,2,2,Troy Ruttman
519,529,113,1954,Bill Homeier,Tony Bettenhausen,0,0,0,Tony Bettenhausen
519,555,113,1954,Bill Homeier,Paul Russo,0,0,0,Paul Russo
519,556,113,1954,Bill Homeier,Jimmy Daywalt,0,0,0,Jimmy Daywalt
519,559,113,1954,Bill Homeier,Pat Flaherty,0,0,0,Pat Flaherty
519,593,113,1954,Bill Homeier,Johnnie Parsons,0,0,0,Johnnie Parsons
519,597,113,1954,Bill Homeier,Pat O'Connor,0,0,0,Pat O'Connor
519,611,113,1954,Bill Homeier,Sam Hanks,0,0,0,Sam Hanks
519,612,113,1954,Bill Homeier,Andy Linden,0,0,0,Andy Linden
519,613,113,1954,Bill Homeier,Marshall Teague,0,0,0,Marshall Teague
519,615,113,1954,Bill Homeier,Fred Agabashian,0,0,0,Fred Agabashian
519,628,113,1954,Bill Homeier,Bob Sweikert,0,0,0,Bob Sweikert
519,653,113,1954,Bill Homeier,Jimmy Davies,0,0,0,Jimmy Davies
519,656,113,1954,Bill Homeier,Art Cross,0,0,0,Art Cross
519,657,113,1954,Bill Homeier,Bill Vukovich,0,8,8,Bill Vukovich
519,658,113,1954,Bill Homeier,Jack McGrath,0,5,5,Jack McGrath
519,659,113,1954,Bill Homeier,Jerry Hoyt,0,0,0,Jerry Hoyt
519,673,113,1954,Bill Homeier,Mike Nazaruk,0,2,2,Mike Nazaruk
519,674,113,1954,Bill Homeier,Larry Crockett,0,0,0,Larry Crockett
519,676,113,1954,Bill Homeier,Frank Armi,0,0,0,Frank Armi
519,679,113,1954,Bill Homeier,Ernie McCoy,0,0,0,Ernie McCoy
519,730,113,1954,Bill Homeier,George Fonder,0,0,0,George Fonder
519,799,113,1954,Bill Homeier,Jimmy Jackson,0,0,0,Jimmy Jackson
520,526,113,1954,Gene Hartley,Troy Ruttman,0,2,2,Troy Ruttman
520,529,113,1954,Gene Hartley,Tony Bettenhausen,0,0,0,Tony Bettenhausen
520,555,113,1954,Gene Hartley,Paul Russo,0,0,0,Paul Russo
520,556,113,1954,Gene Hartley,Jimmy Daywalt,0,0,0,Jimmy Daywalt
520,559,113,1954,Gene Hartley,Pat Flaherty,0,0,0,Pat Flaherty
520,593,113,1954,Gene Hartley,Johnnie Parsons,0,0,0,Johnnie Parsons
520,597,113,1954,Gene Hartley,Pat O'Connor,0,0,0,Pat O'Connor
520,611,113,1954,Gene Hartley,Sam Hanks,0,0,0,Sam Hanks
520,612,113,1954,Gene Hartley,Andy Linden,0,0,0,Andy Linden
520,613,113,1954,Gene Hartley,Marshall Teague,0,0,0,Marshall Teague
520,615,113,1954,Gene Hartley,Fred Agabashian,0,0,0,Fred Agabashian
520,628,113,1954,Gene Hartley,Bob Sweikert,0,0,0,Bob Sweikert
520,653,113,1954,Gene Hartley,Jimmy Davies,0,0,0,Jimmy Davies
520,656,113,1954,Gene Hartley,Art Cross,0,0,0,Art Cross
520,657,113,1954,Gene Hartley,Bill Vukovich,0,8,8,Bill Vukovich
520,658,113,1954,Gene Hartley,Jack McGrath,0,5,5,Jack McGrath
520,659,113,1954,Gene Hartley,Jerry Hoyt,0,0,0,Jerry Hoyt
520,673,113,1954,Gene Hartley,Mike Nazaruk,0,2,2,Mike Nazaruk
520,674,113,1954,Gene Hartley,Larry Crockett,0,0,0,Larry Crockett
520,676,113,1954,Gene Hartley,Frank Armi,0,0,0,Frank Armi
520,679,113,1954,Gene Hartley,Ernie McCoy,0,0,0,Ernie McCoy
520,730,113,1954,Gene Hartley,George Fonder,0,0,0,George Fonder
520,799,113,1954,Gene Hartley,Jimmy Jackson,0,0,0,Jimmy Jackson
526,529,113,1954,Troy Ruttman,Tony Bettenhausen,2,0,2,Troy Ruttman
526,555,113,1954,Troy Ruttman,Paul Russo,2,0,2,Troy Ruttman
526,556,113,1954,Troy Ruttman,Jimmy Daywalt,2,0,2,Troy Ruttman
526,559,113,1954,Troy Ruttman,Pat Flaherty,2,0,2,Troy Ruttman
526,593,113,1954,Troy Ruttman,Johnnie Parsons,2,0,2,Troy Ruttman
526,597,113,1954,Troy Ruttman,Pat O'Connor,2,0,2,Troy Ruttman
526,611,113,1954,Troy Ruttman,Sam Hanks,2,0,2,Troy Ruttman
526,612,113,1954,Troy Ruttman,Andy Linden,2,0,2,Troy Ruttman
526,613,113,1954,Troy Ruttman,Marshall Teague,2,0,2,Troy Ruttman
526,615,113,1954,Troy Ruttman,Fred Agabashian,2,0,2,Troy Ruttman
526,628,113,1954,Troy Ruttman,Bob Sweikert,2,0,2,Troy Ruttman
526,653,113,1954,Troy Ruttman,Jimmy Davies,2,0,2,Troy Ruttman
526,656,113,1954,Troy Ruttman,Art Cross,2,0,2,Troy Ruttman
526,657,113,1954,Troy Ruttman,Bill Vukovich,2,8,6,Bill Vukovich
526,658,113,1954,Troy Ruttman,Jack McGrath,2,5,3,Jack McGrath
526,659,113,1954,Troy Ruttman,Jerry Hoyt,2,0,2,Troy Ruttman
526,673,113,1954,Troy Ruttman,Mike Nazaruk,2,2,0,Mike Nazaruk
526,674,113,1954,Troy Ruttman,Larry Crockett,2,0,2,Troy Ruttman
526,676,113,1954,Troy Ruttman,Frank Armi,2,0,2,Troy Ruttman
526,679,113,1954,Troy Ruttman,Ernie McCoy,2,0,2,Troy Ruttman
526,730,113,1954,Troy Ruttman,George Fonder,2,0,2,Troy Ruttman
526,799,113,1954,Troy Ruttman,Jimmy Jackson,2,0,2,Troy Ruttman
529,555,113,1954,Tony Bettenhausen,Paul Russo,0,0,0,Paul Russo
529,556,113,1954,Tony Bettenhausen,Jimmy Daywalt,0,0,0,Jimmy Daywalt
529,559,113,1954,Tony Bettenhausen,Pat Flaherty,0,0,0,Pat Flaherty
529,593,113,1954,Tony Bettenhausen,Johnnie Parsons,0,0,0,Johnnie Parsons
529,597,113,1954,Tony Bettenhausen,Pat O'Connor,0,0,0,Pat O'Connor
529,611,113,1954,Tony Bettenhausen,Sam Hanks,0,0,0,Sam Hanks
529,612,113,1954,Tony Bettenhausen,Andy Linden,0,0,0,Andy Linden
529,613,113,1954,Tony Bettenhausen,Marshall Teague,0,0,0,Marshall Teague
529,615,113,1954,Tony Bettenhausen,Fred Agabashian,0,0,0,Fred Agabashian
529,628,113,1954,Tony Bettenhausen,Bob Sweikert,0,0,0,Bob Sweikert
529,653,113,1954,Tony Bettenhausen,Jimmy Davies,0,0,0,Jimmy Davies
529,656,113,1954,Tony Bettenhausen,Art Cross,0,0,0,Art Cross
529,657,113,1954,Tony Bettenhausen,Bill Vukovich,0,8,8,Bill Vukovich
529,658,113,1954,Tony Bettenhausen,Jack McGrath,0,5,5,Jack McGrath
529,659,113,1954,Tony Bettenhausen,Jerry Hoyt,0,0,0,Jerry Hoyt
529,673,113,1954,Tony Bettenhausen,Mike Nazaruk,0,2,2,Mike Nazaruk
529,674,113,1954,Tony Bettenhausen,Larry Crockett,0,0,0,Larry Crockett
529,676,113,1954,Tony Bettenhausen,Frank Armi,0,0,0,Frank Armi
529,679,113,1954,Tony Bettenhausen,Ernie McCoy,0,0,0,Ernie McCoy
529,730,113,1954,Tony Bettenhausen,George Fonder,0,0,0,George Fonder
529,799,113,1954,Tony Bettenhausen,Jimmy Jackson,0,0,0,Jimmy Jackson
555,556,113,1954,Paul Russo,Jimmy Daywalt,0,0,0,Jimmy Daywalt
555,559,113,1954,Paul Russo,Pat Flaherty,0,0,0,Pat Flaherty
555,593,113,1954,Paul Russo,Johnnie Parsons,0,0,0,Johnnie Parsons
555,597,113,1954,Paul Russo,Pat O'Connor,0,0,0,Pat O'Connor
555,611,113,1954,Paul Russo,Sam Hanks,0,0,0,Sam Hanks
555,612,113,1954,Paul Russo,Andy Linden,0,0,0,Andy Linden
555,613,113,1954,Paul Russo,Marshall Teague,0,0,0,Marshall Teague
555,615,113,1954,Paul Russo,Fred Agabashian,0,0,0,Fred Agabashian
555,628,113,1954,Paul Russo,Bob Sweikert,0,0,0,Bob Sweikert
555,653,113,1954,Paul Russo,Jimmy Davies,0,0,0,Jimmy Davies
555,656,113,1954,Paul Russo,Art Cross,0,0,0,Art Cross
555,657,113,1954,Paul Russo,Bill Vukovich,0,8,8,Bill Vukovich
555,658,113,1954,Paul Russo,Jack McGrath,0,5,5,Jack McGrath
555,659,113,1954,Paul Russo,Jerry Hoyt,0,0,0,Jerry Hoyt
555,673,113,1954,Paul Russo,Mike Nazaruk,0,2,2,Mike Nazaruk
555,674,113,1954,Paul Russo,Larry Crockett,0,0,0,Larry Crockett
555,676,113,1954,Paul Russo,Frank Armi,0,0,0,Frank Armi
555,679,113,1954,Paul Russo,Ernie McCoy,0,0,0,Ernie McCoy
555,730,113,1954,Paul Russo,George Fonder,0,0,0,George Fonder
555,799,113,1954,Paul Russo,Jimmy Jackson,0,0,0,Jimmy Jackson
556,559,113,1954,Jimmy Daywalt,Pat Flaherty,0,0,0,Pat Flaherty
556,593,113,1954,Jimmy Daywalt,Johnnie Parsons,0,0,0,Johnnie Parsons
556,597,113,1954,Jimmy Daywalt,Pat O'Connor,0,0,0,Pat O'Connor
556,611,113,1954,Jimmy Daywalt,Sam Hanks,0,0,0,Sam Hanks
556,612,113,1954,Jimmy Daywalt,Andy Linden,0,0,0,Andy Linden
556,613,113,1954,Jimmy Daywalt,Marshall Teague,0,0,0,Marshall Teague
556,615,113,1954,Jimmy Daywalt,Fred Agabashian,0,0,0,Fred Agabashian
556,628,113,1954,Jimmy Daywalt,Bob Sweikert,0,0,0,Bob Sweikert
556,653,113,1954,Jimmy Daywalt,Jimmy Davies,0,0,0,Jimmy Davies
556,656,113,1954,Jimmy Daywalt,Art Cross,0,0,0,Art Cross
556,657,113,1954,Jimmy Daywalt,Bill Vukovich,0,8,8,Bill Vukovich
556,658,113,1954,Jimmy Daywalt,Jack McGrath,0,5,5,Jack McGrath
556,659,113,1954,Jimmy Daywalt,Jerry Hoyt,0,0,0,Jerry Hoyt
556,673,113,1954,Jimmy Daywalt,Mike Nazaruk,0,2,2,Mike Nazaruk
556,674,113,1954,Jimmy Daywalt,Larry Crockett,0,0,0,Larry Crockett
556,676,113,1954,Jimmy Daywalt,Frank Armi,0,0,0,Frank Armi
556,679,113,1954,Jimmy Daywalt,Ernie McCoy,0,0,0,Ernie McCoy
556,730,113,1954,Jimmy Daywalt,George Fonder,0,0,0,George Fonder
556,799,113,1954,Jimmy Daywalt,Jimmy Jackson,0,0,0,Jimmy Jackson
559,593,113,1954,Pat Flaherty,Johnnie Parsons,0,0,0,Johnnie Parsons
559,597,113,1954,Pat Flaherty,Pat O'Connor,0,0,0,Pat O'Connor
559,611,113,1954,Pat Flaherty,Sam Hanks,0,0,0,Sam Hanks
559,612,113,1954,Pat Flaherty,Andy Linden,0,0,0,Andy Linden
559,613,113,1954,Pat Flaherty,Marshall Teague,0,0,0,Marshall Teague
559,615,113,1954,Pat Flaherty,Fred Agabashian,0,0,0,Fred Agabashian
559,628,113,1954,Pat Flaherty,Bob Sweikert,0,0,0,Bob Sweikert
559,653,113,1954,Pat Flaherty,Jimmy Davies,0,0,0,Jimmy Davies
559,656,113,1954,Pat Flaherty,Art Cross,0,0,0,Art Cross
559,657,113,1954,Pat Flaherty,Bill Vukovich,0,8,8,Bill Vukovich
559,658,113,1954,Pat Flaherty,Jack McGrath,0,5,5,Jack McGrath
559,659,113,1954,Pat Flaherty,Jerry Hoyt,0,0,0,Jerry Hoyt
559,673,113,1954,Pat Flaherty,Mike Nazaruk,0,2,2,Mike Nazaruk
559,674,113,1954,Pat Flaherty,Larry Crockett,0,0,0,Larry Crockett
559,676,113,1954,Pat Flaherty,Frank Armi,0,0,0,Frank Armi
559,679,113,1954,Pat Flaherty,Ernie McCoy,0,0,0,Ernie McCoy
559,730,113,1954,Pat Flaherty,George Fonder,0,0,0,George Fonder
559,799,113,1954,Pat Flaherty,Jimmy Jackson,0,0,0,Jimmy Jackson
593,597,113,1954,Johnnie Parsons,Pat O'Connor,0,0,0,Pat O'Connor
593,611,113,1954,Johnnie Parsons,Sam Hanks,0,0,0,Sam Hanks
593,612,113,1954,Johnnie Parsons,Andy Linden,0,0,0,Andy Linden
593,613,113,1954,Johnnie Parsons,Marshall Teague,0,0,0,Marshall Teague
593,615,113,1954,Johnnie Parsons,Fred Agabashian,0,0,0,Fred Agabashian
593,628,113,1954,Johnnie Parsons,Bob Sweikert,0,0,0,Bob Sweikert
593,653,113,1954,Johnnie Parsons,Jimmy Davies,0,0,0,Jimmy Davies
593,656,113,1954,Johnnie Parsons,Art Cross,0,0,0,Art Cross
593,657,113,1954,Johnnie Parsons,Bill Vukovich,0,8,8,Bill Vukovich
593,658,113,1954,Johnnie Parsons,Jack McGrath,0,5,5,Jack McGrath
593,659,113,1954,Johnnie Parsons,Jerry Hoyt,0,0,0,Jerry Hoyt
593,673,113,1954,Johnnie Parsons,Mike Nazaruk,0,2,2,Mike Nazaruk
593,674,113,1954,Johnnie Parsons,Larry Crockett,0,0,0,Larry Crockett
593,676,113,1954,Johnnie Parsons,Frank Armi,0,0,0,Frank Armi
593,679,113,1954,Johnnie Parsons,Ernie McCoy,0,0,0,Ernie McCoy
593,730,113,1954,Johnnie Parsons,George Fonder,0,0,0,George Fonder
593,799,113,1954,Johnnie Parsons,Jimmy Jackson,0,0,0,Jimmy Jackson
597,611,113,1954,Pat O'Connor,Sam Hanks,0,0,0,Sam Hanks
597,612,113,1954,Pat O'Connor,Andy Linden,0,0,0,Andy Linden
597,613,113,1954,Pat O'Connor,Marshall Teague,0,0,0,Marshall Teague
597,615,113,1954,Pat O'Connor,Fred Agabashian,0,0,0,Fred Agabashian
597,628,113,1954,Pat O'Connor,Bob Sweikert,0,0,0,Bob Sweikert
597,653,113,1954,Pat O'Connor,Jimmy Davies,0,0,0,Jimmy Davies
597,656,113,1954,Pat O'Connor,Art Cross,0,0,0,Art Cross
597,657,113,1954,Pat O'Connor,Bill Vukovich,0,8,8,Bill Vukovich
597,658,113,1954,Pat O'Connor,Jack McGrath,0,5,5,Jack McGrath
597,659,113,1954,Pat O'Connor,Jerry Hoyt,0,0,0,Jerry Hoyt
597,673,113,1954,Pat O'Connor,Mike Nazaruk,0,2,2,Mike Nazaruk
597,674,113,1954,Pat O'Connor,Larry Crockett,0,0,0,Larry Crockett
597,676,113,1954,Pat O'Connor,Frank Armi,0,0,0,Frank Armi
597,679,113,1954,Pat O'Connor,Ernie McCoy,0,0,0,Ernie McCoy
597,730,113,1954,Pat O'Connor,George Fonder,0,0,0,George Fonder
597,799,113,1954,Pat O'Connor,Jimmy Jackson,0,0,0,Jimmy Jackson
611,612,113,1954,Sam Hanks,Andy Linden,0,0,0,Andy Linden
611,613,113,1954,Sam Hanks,Marshall Teague,0,0,0,Marshall Teague
611,615,113,1954,Sam Hanks,Fred Agabashian,0,0,0,Fred Agabashian
611,628,113,1954,Sam Hanks,Bob Sweikert,0,0,0,Bob Sweikert
611,653,113,1954,Sam Hanks,Jimmy Davies,0,0,0,Jimmy Davies
611,656,113,1954,Sam Hanks,Art Cross,0,0,0,Art Cross
611,657,113,1954,Sam Hanks,Bill Vukovich,0,8,8,Bill Vukovich
611,658,113,1954,Sam Hanks,Jack McGrath,0,5,5,Jack McGrath
611,659,113,1954,Sam Hanks,Jerry Hoyt,0,0,0,Jerry Hoyt
611,673,113,1954,Sam Hanks,Mike Nazaruk,0,2,2,Mike Nazaruk
611,674,113,1954,Sam Hanks,Larry Crockett,0,0,0,Larry Crockett
611,676,113,1954,Sam Hanks,Frank Armi,0,0,0,Frank Armi
611,679,113,1954,Sam Hanks,Ernie McCoy,0,0,0,Ernie McCoy
611,730,113,1954,Sam Hanks,George Fonder,0,0,0,George Fonder
611,799,113,1954,Sam Hanks,Jimmy Jackson,0,0,0,Jimmy Jackson
612,613,113,1954,Andy Linden,Marshall Teague,0,0,0,Marshall Teague
612,615,113,1954,Andy Linden,Fred Agabashian,0,0,0,Fred Agabashian
612,628,113,1954,Andy Linden,Bob Sweikert,0,0,0,Bob Sweikert
612,653,113,1954,Andy Linden,Jimmy Davies,0,0,0,Jimmy Davies
612,656,113,1954,Andy Linden,Art Cross,0,0,0,Art Cross
612,657,113,1954,Andy Linden,Bill Vukovich,0,8,8,Bill Vukovich
612,658,113,1954,Andy Linden,Jack McGrath,0,5,5,Jack McGrath
612,659,113,1954,Andy Linden,Jerry Hoyt,0,0,0,Jerry Hoyt
612,673,113,1954,Andy Linden,Mike Nazaruk,0,2,2,Mike Nazaruk
612,674,113,1954,Andy Linden,Larry Crockett,0,0,0,Larry Crockett
612,676,113,1954,Andy Linden,Frank Armi,0,0,0,Frank Armi
612,679,113,1954,Andy Linden,Ernie McCoy,0,0,0,Ernie McCoy
612,730,113,1954,Andy Linden,George Fonder,0,0,0,George Fonder
612,799,113,1954,Andy Linden,Jimmy Jackson,0,0,0,Jimmy Jackson
613,615,113,1954,Marshall Teague,Fred Agabashian,0,0,0,Fred Agabashian
613,628,113,1954,Marshall Teague,Bob Sweikert,0,0,0,Bob Sweikert
613,653,113,1954,Marshall Teague,Jimmy Davies,0,0,0,Jimmy Davies
613,656,113,1954,Marshall Teague,Art Cross,0,0,0,Art Cross
613,657,113,1954,Marshall Teague,Bill Vukovich,0,8,8,Bill Vukovich
613,658,113,1954,Marshall Teague,Jack McGrath,0,5,5,Jack McGrath
613,659,113,1954,Marshall Teague,Jerry Hoyt,0,0,0,Jerry Hoyt
613,673,113,1954,Marshall Teague,Mike Nazaruk,0,2,2,Mike Nazaruk
613,674,113,1954,Marshall Teague,Larry Crockett,0,0,0,Larry Crockett
613,676,113,1954,Marshall Teague,Frank Armi,0,0,0,Frank Armi
613,679,113,1954,Marshall Teague,Ernie McCoy,0,0,0,Ernie McCoy
613,730,113,1954,Marshall Teague,George Fonder,0,0,0,George Fonder
613,799,113,1954,Marshall Teague,Jimmy Jackson,0,0,0,Jimmy Jackson
615,628,113,1954,Fred Agabashian,Bob Sweikert,0,0,0,Bob Sweikert
615,653,113,1954,Fred Agabashian,Jimmy Davies,0,0,0,Jimmy Davies
615,656,113,1954,Fred Agabashian,Art Cross,0,0,0,Art Cross
615,657,113,1954,Fred Agabashian,Bill Vukovich,0,8,8,Bill Vukovich
615,658,113,1954,Fred Agabashian,Jack McGrath,0,5,5,Jack McGrath
615,659,113,1954,Fred Agabashian,Jerry Hoyt,0,0,0,Jerry Hoyt
615,673,113,1954,Fred Agabashian,Mike Nazaruk,0,2,2,Mike Nazaruk
615,674,113,1954,Fred Agabashian,Larry Crockett,0,0,0,Larry Crockett
615,676,113,1954,Fred Agabashian,Frank Armi,0,0,0,Frank Armi
615,679,113,1954,Fred Agabashian,Ernie McCoy,0,0,0,Ernie McCoy
615,730,113,1954,Fred Agabashian,George Fonder,0,0,0,George Fonder
615,799,113,1954,Fred Agabashian,Jimmy Jackson,0,0,0,Jimmy Jackson
628,653,113,1954,Bob Sweikert,Jimmy Davies,0,0,0,Jimmy Davies
628,656,113,1954,Bob Sweikert,Art Cross,0,0,0,Art Cross
628,657,113,1954,Bob Sweikert,Bill Vukovich,0,8,8,Bill Vukovich
628,658,113,1954,Bob Sweikert,Jack McGrath,0,5,5,Jack McGrath
628,659,113,1954,Bob Sweikert,Jerry Hoyt,0,0,0,Jerry Hoyt
628,673,113,1954,Bob Sweikert,Mike Nazaruk,0,2,2,Mike Nazaruk
628,674,113,1954,Bob Sweikert,Larry Crockett,0,0,0,Larry Crockett
628,676,113,1954,Bob Sweikert,Frank Armi,0,0,0,Frank Armi
628,679,113,1954,Bob Sweikert,Ernie McCoy,0,0,0,Ernie McCoy
628,730,113,1954,Bob Sweikert,George Fonder,0,0,0,George Fonder
628,799,113,1954,Bob Sweikert,Jimmy Jackson,0,0,0,Jimmy Jackson
653,656,113,1954,Jimmy Davies,Art Cross,0,0,0,Art Cross
653,657,113,1954,Jimmy Davies,Bill Vukovich,0,8,8,Bill Vukovich
653,658,113,1954,Jimmy Davies,Jack McGrath,0,5,5,Jack McGrath
653,659,113,1954,Jimmy Davies,Jerry Hoyt,0,0,0,Jerry Hoyt
653,673,113,1954,Jimmy Davies,Mike Nazaruk,0,2,2,Mike Nazaruk
653,674,113,1954,Jimmy Davies,Larry Crockett,0,0,0,Larry Crockett
653,676,113,1954,Jimmy Davies,Frank Armi,0,0,0,Frank Armi
653,679,113,1954,Jimmy Davies,Ernie McCoy,0,0,0,Ernie McCoy
653,730,113,1954,Jimmy Davies,George Fonder,0,0,0,George Fonder
653,799,113,1954,Jimmy Davies,Jimmy Jackson,0,0,0,Jimmy Jackson
656,657,113,1954,Art Cross,Bill Vukovich,0,8,8,Bill Vukovich
656,658,113,1954,Art Cross,Jack McGrath,0,5,5,Jack McGrath
656,659,113,1954,Art Cross,Jerry Hoyt,0,0,0,Jerry Hoyt
656,673,113,1954,Art Cross,Mike Nazaruk,0,2,2,Mike Nazaruk
656,674,113,1954,Art Cross,Larry Crockett,0,0,0,Larry Crockett
656,676,113,1954,Art Cross,Frank Armi,0,0,0,Frank Armi
656,679,113,1954,Art Cross,Ernie McCoy,0,0,0,Ernie McCoy
656,730,113,1954,Art Cross,George Fonder,0,0,0,George Fonder
656,799,113,1954,Art Cross,Jimmy Jackson,0,0,0,Jimmy Jackson
657,658,113,1954,Bill Vukovich,Jack McGrath,8,5,3,Bill Vukovich
657,659,113,1954,Bill Vukovich,Jerry Hoyt,8,0,8,Bill Vukovich
657,673,113,1954,Bill Vukovich,Mike Nazaruk,8,2,6,Bill Vukovich
657,674,113,1954,Bill Vukovich,Larry Crockett,8,0,8,Bill Vukovich
657,676,113,1954,Bill Vukovich,Frank Armi,8,0,8,Bill Vukovich
657,679,113,1954,Bill Vukovich,Ernie McCoy,8,0,8,Bill Vukovich
657,730,113,1954,Bill Vukovich,George Fonder,8,0,8,Bill Vukovich
657,799,113,1954,Bill Vukovich,Jimmy Jackson,8,0,8,Bill Vukovich
658,659,113,1954,Jack McGrath,Jerry Hoyt,5,0,5,Jack McGrath
658,673,113,1954,Jack McGrath,Mike Nazaruk,5,2,3,Jack McGrath
658,674,113,1954,Jack McGrath,Larry Crockett,5,0,5,Jack McGrath
658,676,113,1954,Jack McGrath,Frank Armi,5,0,5,Jack McGrath
658,679,113,1954,Jack McGrath,Ernie McCoy,5,0,5,Jack McGrath
658,730,113,1954,Jack McGrath,George Fonder,5,0,5,Jack McGrath
658,799,113,1954,Jack McGrath,Jimmy Jackson,5,0,5,Jack McGrath
659,673,113,1954,Jerry Hoyt,Mike Nazaruk,0,2,2,Mike Nazaruk
659,674,113,1954,Jerry Hoyt,Larry Crockett,0,0,0,Larry Crockett
659,676,113,1954,Jerry Hoyt,Frank Armi,0,0,0,Frank Armi
659,679,113,1954,Jerry Hoyt,Ernie McCoy,0,0,0,Ernie McCoy
659,730,113,1954,Jerry Hoyt,George Fonder,0,0,0,George Fonder
659,799,113,1954,Jerry Hoyt,Jimmy Jackson,0,0,0,Jimmy Jackson
673,674,113,1954,Mike Nazaruk,Larry Crockett,2,0,2,Mike Nazaruk
673,676,113,1954,Mike Nazaruk,Frank Armi,2,0,2,Mike Nazaruk
673,679,113,1954,Mike Nazaruk,Ernie McCoy,2,0,2,Mike Nazaruk
673,730,113,1954,Mike Nazaruk,George Fonder,2,0,2,Mike Nazaruk
673,799,113,1954,Mike Nazaruk,Jimmy Jackson,2,0,2,Mike Nazaruk
674,676,113,1954,Larry Crockett,Frank Armi,0,0,0,Frank Armi
674,679,113,1954,Larry Crockett,Ernie McCoy,0,0,0,Ernie McCoy
674,730,113,1954,Larry Crockett,George Fonder,0,0,0,George Fonder
674,799,113,1954,Larry Crockett,Jimmy Jackson,0,0,0,Jimmy Jackson
676,679,113,1954,Frank Armi,Ernie McCoy,0,0,0,Ernie McCoy
676,730,113,1954,Frank Armi,George Fonder,0,0,0,George Fonder
676,799,113,1954,Frank Armi,Jimmy Jackson,0,0,0,Jimmy Jackson
679,730,113,1954,Ernie McCoy,George Fonder,0,0,0,George Fonder
679,799,113,1954,Ernie McCoy,Jimmy Jackson,0,0,0,Jimmy Jackson
730,799,113,1954,George Fonder,Jimmy Jackson,0,0,0,Jimmy Jackson
519,529,113,1955,Bill Homeier,Tony Bettenhausen,1,3,2,Tony Bettenhausen
519,533,113,1955,Bill Homeier,Johnny Boyd,1,0,1,Bill Homeier
519,538,113,1955,Bill Homeier,Al Herman,1,0,1,Bill Homeier
519,555,113,1955,Bill Homeier,Paul Russo,1,3,2,Paul Russo
519,556,113,1955,Bill Homeier,Jimmy Daywalt,1,0,1,Bill Homeier
519,558,113,1955,Bill Homeier,Al Keller,1,0,1,Bill Homeier
519,559,113,1955,Bill Homeier,Pat Flaherty,1,0,1,Bill Homeier
519,561,113,1955,Bill Homeier,Ray Crawford,1,0,1,Bill Homeier
519,563,113,1955,Bill Homeier,Chuck Weyant,1,0,1,Bill Homeier
519,593,113,1955,Bill Homeier,Johnnie Parsons,1,0,1,Bill Homeier
519,596,113,1955,Bill Homeier,Ed Elisian,1,0,1,Bill Homeier
519,597,113,1955,Bill Homeier,Pat O'Connor,1,0,1,Bill Homeier
519,611,113,1955,Bill Homeier,Sam Hanks,1,0,1,Bill Homeier
519,612,113,1955,Bill Homeier,Andy Linden,1,0,1,Bill Homeier
519,615,113,1955,Bill Homeier,Fred Agabashian,1,0,1,Bill Homeier
519,628,113,1955,Bill Homeier,Bob Sweikert,1,8,7,Bob Sweikert
519,653,113,1955,Bill Homeier,Jimmy Davies,1,4,3,Jimmy Davies
519,654,113,1955,Bill Homeier,Walt Faulkner,1,1,0,Walt Faulkner
519,655,113,1955,Bill Homeier,Cal Niday,1,0,1,Bill Homeier
519,656,113,1955,Bill Homeier,Art Cross,1,0,1,Bill Homeier
519,657,113,1955,Bill Homeier,Bill Vukovich,1,1,0,Bill Vukovich
519,658,113,1955,Bill Homeier,Jack McGrath,1,0,1,Bill Homeier
529,533,113,1955,Tony Bettenhausen,Johnny Boyd,3,0,3,Tony Bettenhausen
529,538,113,1955,Tony Bettenhausen,Al Herman,3,0,3,Tony Bettenhausen
529,555,113,1955,Tony Bettenhausen,Paul Russo,3,3,0,Paul Russo
529,556,113,1955,Tony Bettenhausen,Jimmy Daywalt,3,0,3,Tony Bettenhausen
529,558,113,1955,Tony Bettenhausen,Al Keller,3,0,3,Tony Bettenhausen
529,559,113,1955,Tony Bettenhausen,Pat Flaherty,3,0,3,Tony Bettenhausen
529,561,113,1955,Tony Bettenhausen,Ray Crawford,3,0,3,Tony Bettenhausen
529,563,113,1955,Tony Bettenhausen,Chuck Weyant,3,0,3,Tony Bettenhausen
529,593,113,1955,Tony Bettenhausen,Johnnie Parsons,3,0,3,Tony Bettenhausen
529,596,113,1955,Tony Bettenhausen,Ed Elisian,3,0,3,Tony Bettenhausen
529,597,113,1955,Tony Bettenhausen,Pat O'Connor,3,0,3,Tony Bettenhausen
529,611,113,1955,Tony Bettenhausen,Sam Hanks,3,0,3,Tony Bettenhausen
529,612,113,1955,Tony Bettenhausen,Andy Linden,3,0,3,Tony Bettenhausen
529,615,113,1955,Tony Bettenhausen,Fred Agabashian,3,0,3,Tony Bettenhausen
529,628,113,1955,Tony Bettenhausen,Bob Sweikert,3,8,5,Bob Sweikert
529,653,113,1955,Tony Bettenhausen,Jimmy Davies,3,4,1,Jimmy Davies
529,654,113,1955,Tony Bettenhausen,Walt Faulkner,3,1,2,Tony Bettenhausen
529,655,113,1955,Tony Bettenhausen,Cal Niday,3,0,3,Tony Bettenhausen
529,656,113,1955,Tony Bettenhausen,Art Cross,3,0,3,Tony Bettenhausen
529,657,113,1955,Tony Bettenhausen,Bill Vukovich,3,1,2,Tony Bettenhausen
529,658,113,1955,Tony Bettenhausen,Jack McGrath,3,0,3,Tony Bettenhausen
533,538,113,1955,Johnny Boyd,Al Herman,0,0,0,Al Herman
533,555,113,1955,Johnny Boyd,Paul Russo,0,3,3,Paul Russo
533,556,113,1955,Johnny Boyd,Jimmy Daywalt,0,0,0,Jimmy Daywalt
533,558,113,1955,Johnny Boyd,Al Keller,0,0,0,Al Keller
533,559,113,1955,Johnny Boyd,Pat Flaherty,0,0,0,Pat Flaherty
533,561,113,1955,Johnny Boyd,Ray Crawford,0,0,0,Ray Crawford
533,563,113,1955,Johnny Boyd,Chuck Weyant,0,0,0,Chuck Weyant
533,593,113,1955,Johnny Boyd,Johnnie Parsons,0,0,0,Johnnie Parsons
533,596,113,1955,Johnny Boyd,Ed Elisian,0,0,0,Ed Elisian
533,597,113,1955,Johnny Boyd,Pat O'Connor,0,0,0,Pat O'Connor
533,611,113,1955,Johnny Boyd,Sam Hanks,0,0,0,Sam Hanks
533,612,113,1955,Johnny Boyd,Andy Linden,0,0,0,Andy Linden
533,615,113,1955,Johnny Boyd,Fred Agabashian,0,0,0,Fred Agabashian
533,628,113,1955,Johnny Boyd,Bob Sweikert,0,8,8,Bob Sweikert
533,653,113,1955,Johnny Boyd,Jimmy Davies,0,4,4,Jimmy Davies
533,654,113,1955,Johnny Boyd,Walt Faulkner,0,1,1,Walt Faulkner
533,655,113,1955,Johnny Boyd,Cal Niday,0,0,0,Cal Niday
533,656,113,1955,Johnny Boyd,Art Cross,0,0,0,Art Cross
533,657,113,1955,Johnny Boyd,Bill Vukovich,0,1,1,Bill Vukovich
533,658,113,1955,Johnny Boyd,Jack McGrath,0,0,0,Jack McGrath
538,555,113,1955,Al Herman,Paul Russo,0,3,3,Paul Russo
538,556,113,1955,Al Herman,Jimmy Daywalt,0,0,0,Jimmy Daywalt
538,558,113,1955,Al Herman,Al Keller,0,0,0,Al Keller
538,559,113,1955,Al Herman,Pat Flaherty,0,0,0,Pat Flaherty
538,561,113,1955,Al Herman,Ray Crawford,0,0,0,Ray Crawford
538,563,113,1955,Al Herman,Chuck Weyant,0,0,0,Chuck Weyant
538,593,113,1955,Al Herman,Johnnie Parsons,0,0,0,Johnnie Parsons
538,596,113,1955,Al Herman,Ed Elisian,0,0,0,Ed Elisian
538,597,113,1955,Al Herman,Pat O'Connor,0,0,0,Pat O'Connor
538,611,113,1955,Al Herman,Sam Hanks,0,0,0,Sam Hanks
538,612,113,1955,Al Herman,Andy Linden,0,0,0,Andy Linden
538,615,113,1955,Al Herman,Fred Agabashian,0,0,0,Fred Agabashian
538,628,113,1955,Al Herman,Bob Sweikert,0,8,8,Bob Sweikert
538,653,113,1955,Al Herman,Jimmy Davies,0,4,4,Jimmy Davies
538,654,113,1955,Al Herman,Walt Faulkner,0,1,1,Walt Faulkner
538,655,113,1955,Al Herman,Cal Niday,0,0,0,Cal Niday
538,656,113,1955,Al Herman,Art Cross,0,0,0,Art Cross
538,657,113,1955,Al Herman,Bill Vukovich,0,1,1,Bill Vukovich
538,658,113,1955,Al Herman,Jack McGrath,0,0,0,Jack McGrath
555,556,113,1955,Paul Russo,Jimmy Daywalt,3,0,3,Paul Russo
555,558,113,1955,Paul Russo,Al Keller,3,0,3,Paul Russo
555,559,113,1955,Paul Russo,Pat Flaherty,3,0,3,Paul Russo
555,561,113,1955,Paul Russo,Ray Crawford,3,0,3,Paul Russo
555,563,113,1955,Paul Russo,Chuck Weyant,3,0,3,Paul Russo
555,593,113,1955,Paul Russo,Johnnie Parsons,3,0,3,Paul Russo
555,596,113,1955,Paul Russo,Ed Elisian,3,0,3,Paul Russo
555,597,113,1955,Paul Russo,Pat O'Connor,3,0,3,Paul Russo
555,611,113,1955,Paul Russo,Sam Hanks,3,0,3,Paul Russo
555,612,113,1955,Paul Russo,Andy Linden,3,0,3,Paul Russo
555,615,113,1955,Paul Russo,Fred Agabashian,3,0,3,Paul Russo
555,628,113,1955,Paul Russo,Bob Sweikert,3,8,5,Bob Sweikert
555,653,113,1955,Paul Russo,Jimmy Davies,3,4,1,Jimmy Davies
555,654,113,1955,Paul Russo,Walt Faulkner,3,1,2,Paul Russo
555,655,113,1955,Paul Russo,Cal Niday,3,0,3,Paul Russo
555,656,113,1955,Paul Russo,Art Cross,3,0,3,Paul Russo
555,657,113,1955,Paul Russo,Bill Vukovich,3,1,2,Paul Russo
555,658,113,1955,Paul Russo,Jack McGrath,3,0,3,Paul Russo
556,558,113,1955,Jimmy Daywalt,Al Keller,0,0,0,Al Keller
556,559,113,1955,Jimmy Daywalt,Pat Flaherty,0,0,0,Pat Flaherty
556,561,113,1955,Jimmy Daywalt,Ray Crawford,0,0,0,Ray Crawford
556,563,113,1955,Jimmy Daywalt,Chuck Weyant,0,0,0,Chuck Weyant
556,593,113,1955,Jimmy Daywalt,Johnnie Parsons,0,0,0,Johnnie Parsons
556,596,113,1955,Jimmy Daywalt,Ed Elisian,0,0,0,Ed Elisian
556,597,113,1955,Jimmy Daywalt,Pat O'Connor,0,0,0,Pat O'Connor
556,611,113,1955,Jimmy Daywalt,Sam Hanks,0,0,0,Sam Hanks
556,612,113,1955,Jimmy Daywalt,Andy Linden,0,0,0,Andy Linden
556,615,113,1955,Jimmy Daywalt,Fred Agabashian,0,0,0,Fred Agabashian
556,628,113,1955,Jimmy Daywalt,Bob Sweikert,0,8,8,Bob Sweikert
556,653,113,1955,Jimmy Daywalt,Jimmy Davies,0,4,4,Jimmy Davies
556,654,113,1955,Jimmy Daywalt,Walt Faulkner,0,1,1,Walt Faulkner
556,655,113,1955,Jimmy Daywalt,Cal Niday,0,0,0,Cal Niday
556,656,113,1955,Jimmy Daywalt,Art Cross,0,0,0,Art Cross
556,657,113,1955,Jimmy Daywalt,Bill Vukovich,0,1,1,Bill Vukovich
556,658,113,1955,Jimmy Daywalt,Jack McGrath,0,0,0,Jack McGrath
558,559,113,1955,Al Keller,Pat Flaherty,0,0,0,Pat Flaherty
558,561,113,1955,Al Keller,Ray Crawford,0,0,0,Ray Crawford
558,563,113,1955,Al Keller,Chuck Weyant,0,0,0,Chuck Weyant
558,593,113,1955,Al Keller,Johnnie Parsons,0,0,0,Johnnie Parsons
558,596,113,1955,Al Keller,Ed Elisian,0,0,0,Ed Elisian
558,597,113,1955,Al Keller,Pat O'Connor,0,0,0,Pat O'Connor
558,611,113,1955,Al Keller,Sam Hanks,0,0,0,Sam Hanks
558,612,113,1955,Al Keller,Andy Linden,0,0,0,Andy Linden
558,615,113,1955,Al Keller,Fred Agabashian,0,0,0,Fred Agabashian
558,628,113,1955,Al Keller,Bob Sweikert,0,8,8,Bob Sweikert
558,653,113,1955,Al Keller,Jimmy Davies,0,4,4,Jimmy Davies
558,654,113,1955,Al Keller,Walt Faulkner,0,1,1,Walt Faulkner
558,655,113,1955,Al Keller,Cal Niday,0,0,0,Cal Niday
558,656,113,1955,Al Keller,Art Cross,0,0,0,Art Cross
558,657,113,1955,Al Keller,Bill Vukovich,0,1,1,Bill Vukovich
558,658,113,1955,Al Keller,Jack McGrath,0,0,0,Jack McGrath
559,561,113,1955,Pat Flaherty,Ray Crawford,0,0,0,Ray Crawford
559,563,113,1955,Pat Flaherty,Chuck Weyant,0,0,0,Chuck Weyant
559,593,113,1955,Pat Flaherty,Johnnie Parsons,0,0,0,Johnnie Parsons
559,596,113,1955,Pat Flaherty,Ed Elisian,0,0,0,Ed Elisian
559,597,113,1955,Pat Flaherty,Pat O'Connor,0,0,0,Pat O'Connor
559,611,113,1955,Pat Flaherty,Sam Hanks,0,0,0,Sam Hanks
559,612,113,1955,Pat Flaherty,Andy Linden,0,0,0,Andy Linden
559,615,113,1955,Pat Flaherty,Fred Agabashian,0,0,0,Fred Agabashian
559,628,113,1955,Pat Flaherty,Bob Sweikert,0,8,8,Bob Sweikert
559,653,113,1955,Pat Flaherty,Jimmy Davies,0,4,4,Jimmy Davies
559,654,113,1955,Pat Flaherty,Walt Faulkner,0,1,1,Walt Faulkner
559,655,113,1955,Pat Flaherty,Cal Niday,0,0,0,Cal Niday
559,656,113,1955,Pat Flaherty,Art Cross,0,0,0,Art Cross
559,657,113,1955,Pat Flaherty,Bill Vukovich,0,1,1,Bill Vukovich
559,658,113,1955,Pat Flaherty,Jack McGrath,0,0,0,Jack McGrath
561,563,113,1955,Ray Crawford,Chuck Weyant,0,0,0,Chuck Weyant
561,593,113,1955,Ray Crawford,Johnnie Parsons,0,0,0,Johnnie Parsons
561,596,113,1955,Ray Crawford,Ed Elisian,0,0,0,Ed Elisian
561,597,113,1955,Ray Crawford,Pat O'Connor,0,0,0,Pat O'Connor
561,611,113,1955,Ray Crawford,Sam Hanks,0,0,0,Sam Hanks
561,612,113,1955,Ray Crawford,Andy Linden,0,0,0,Andy Linden
561,615,113,1955,Ray Crawford,Fred Agabashian,0,0,0,Fred Agabashian
561,628,113,1955,Ray Crawford,Bob Sweikert,0,8,8,Bob Sweikert
561,653,113,1955,Ray Crawford,Jimmy Davies,0,4,4,Jimmy Davies
561,654,113,1955,Ray Crawford,Walt Faulkner,0,1,1,Walt Faulkner
561,655,113,1955,Ray Crawford,Cal Niday,0,0,0,Cal Niday
561,656,113,1955,Ray Crawford,Art Cross,0,0,0,Art Cross
561,657,113,1955,Ray Crawford,Bill Vukovich,0,1,1,Bill Vukovich
561,658,113,1955,Ray Crawford,Jack McGrath,0,0,0,Jack McGrath
563,593,113,1955,Chuck Weyant,Johnnie Parsons,0,0,0,Johnnie Parsons
563,596,113,1955,Chuck Weyant,Ed Elisian,0,0,0,Ed Elisian
563,597,113,1955,Chuck Weyant,Pat O'Connor,0,0,0,Pat O'Connor
563,611,113,1955,Chuck Weyant,Sam Hanks,0,0,0,Sam Hanks
563,612,113,1955,Chuck Weyant,Andy Linden,0,0,0,Andy Linden
563,615,113,1955,Chuck Weyant,Fred Agabashian,0,0,0,Fred Agabashian
563,628,113,1955,Chuck Weyant,Bob Sweikert,0,8,8,Bob Sweikert
563,653,113,1955,Chuck Weyant,Jimmy Davies,0,4,4,Jimmy Davies
563,654,113,1955,Chuck Weyant,Walt Faulkner,0,1,1,Walt Faulkner
563,655,113,1955,Chuck Weyant,Cal Niday,0,0,0,Cal Niday
563,656,113,1955,Chuck Weyant,Art Cross,0,0,0,Art Cross
563,657,113,1955,Chuck Weyant,Bill Vukovich,0,1,1,Bill Vukovich
563,658,113,1955,Chuck Weyant,Jack McGrath,0,0,0,Jack McGrath
593,596,113,1955,Johnnie Parsons,Ed Elisian,0,0,0,Ed Elisian
593,597,113,1955,Johnnie Parsons,Pat O'Connor,0,0,0,Pat O'Connor
593,611,113,1955,Johnnie Parsons,Sam Hanks,0,0,0,Sam Hanks
593,612,113,1955,Johnnie Parsons,Andy Linden,0,0,0,Andy Linden
593,615,113,1955,Johnnie Parsons,Fred Agabashian,0,0,0,Fred Agabashian
593,628,113,1955,Johnnie Parsons,Bob Sweikert,0,8,8,Bob Sweikert
593,653,113,1955,Johnnie Parsons,Jimmy Davies,0,4,4,Jimmy Davies
593,654,113,1955,Johnnie Parsons,Walt Faulkner,0,1,1,Walt Faulkner
593,655,113,1955,Johnnie Parsons,Cal Niday,0,0,0,Cal Niday
593,656,113,1955,Johnnie Parsons,Art Cross,0,0,0,Art Cross
593,657,113,1955,Johnnie Parsons,Bill Vukovich,0,1,1,Bill Vukovich
593,658,113,1955,Johnnie Parsons,Jack McGrath,0,0,0,Jack McGrath
596,597,113,1955,Ed Elisian,Pat O'Connor,0,0,0,Pat O'Connor
596,611,113,1955,Ed Elisian,Sam Hanks,0,0,0,Sam Hanks
596,612,113,1955,Ed Elisian,Andy Linden,0,0,0,Andy Linden
596,615,113,1955,Ed Elisian,Fred Agabashian,0,0,0,Fred Agabashian
596,628,113,1955,Ed Elisian,Bob Sweikert,0,8,8,Bob Sweikert
596,653,113,1955,Ed Elisian,Jimmy Davies,0,4,4,Jimmy Davies
596,654,113,1955,Ed Elisian,Walt Faulkner,0,1,1,Walt Faulkner
596,655,113,1955,Ed Elisian,Cal Niday,0,0,0,Cal Niday
596,656,113,1955,Ed Elisian,Art Cross,0,0,0,Art Cross
596,657,113,1955,Ed Elisian,Bill Vukovich,0,1,1,Bill Vukovich
596,658,113,1955,Ed Elisian,Jack McGrath,0,0,0,Jack McGrath
597,611,113,1955,Pat O'Connor,Sam Hanks,0,0,0,Sam Hanks
597,612,113,1955,Pat O'Connor,Andy Linden,0,0,0,Andy Linden
597,615,113,1955,Pat O'Connor,Fred Agabashian,0,0,0,Fred Agabashian
597,628,113,1955,Pat O'Connor,Bob Sweikert,0,8,8,Bob Sweikert
597,653,113,1955,Pat O'Connor,Jimmy Davies,0,4,4,Jimmy Davies
597,654,113,1955,Pat O'Connor,Walt Faulkner,0,1,1,Walt Faulkner
597,655,113,1955,Pat O'Connor,Cal Niday,0,0,0,Cal Niday
597,656,113,1955,Pat O'Connor,Art Cross,0,0,0,Art Cross
597,657,113,1955,Pat O'Connor,Bill Vukovich,0,1,1,Bill Vukovich
597,658,113,1955,Pat O'Connor,Jack McGrath,0,0,0,Jack McGrath
611,612,113,1955,Sam Hanks,Andy Linden,0,0,0,Andy Linden
611,615,113,1955,Sam Hanks,Fred Agabashian,0,0,0,Fred Agabashian
611,628,113,1955,Sam Hanks,Bob Sweikert,0,8,8,Bob Sweikert
611,653,113,1955,Sam Hanks,Jimmy Davies,0,4,4,Jimmy Davies
611,654,113,1955,Sam Hanks,Walt Faulkner,0,1,1,Walt Faulkner
611,655,113,1955,Sam Hanks,Cal Niday,0,0,0,Cal Niday
611,656,113,1955,Sam Hanks,Art Cross,0,0,0,Art Cross
611,657,113,1955,Sam Hanks,Bill Vukovich,0,1,1,Bill Vukovich
611,658,113,1955,Sam Hanks,Jack McGrath,0,0,0,Jack McGrath
612,615,113,1955,Andy Linden,Fred Agabashian,0,0,0,Fred Agabashian
612,628,113,1955,Andy Linden,Bob Sweikert,0,8,8,Bob Sweikert
612,653,113,1955,Andy Linden,Jimmy Davies,0,4,4,Jimmy Davies
612,654,113,1955,Andy Linden,Walt Faulkner,0,1,1,Walt Faulkner
612,655,113,1955,Andy Linden,Cal Niday,0,0,0,Cal Niday
612,656,113,1955,Andy Linden,Art Cross,0,0,0,Art Cross
612,657,113,1955,Andy Linden,Bill Vukovich,0,1,1,Bill Vukovich
612,658,113,1955,Andy Linden,Jack McGrath,0,0,0,Jack McGrath
615,628,113,1955,Fred Agabashian,Bob Sweikert,0,8,8,Bob Sweikert
615,653,113,1955,Fred Agabashian,Jimmy Davies,0,4,4,Jimmy Davies
615,654,113,1955,Fred Agabashian,Walt Faulkner,0,1,1,Walt Faulkner
615,655,113,1955,Fred Agabashian,Cal Niday,0,0,0,Cal Niday
615,656,113,1955,Fred Agabashian,Art Cross,0,0,0,Art Cross
615,657,113,1955,Fred Agabashian,Bill Vukovich,0,1,1,Bill Vukovich
615,658,113,1955,Fred Agabashian,Jack McGrath,0,0,0,Jack McGrath
628,653,113,1955,Bob Sweikert,Jimmy Davies,8,4,4,Bob Sweikert
628,654,113,1955,Bob Sweikert,Walt Faulkner,8,1,7,Bob Sweikert
628,655,113,1955,Bob Sweikert,Cal Niday,8,0,8,Bob Sweikert
628,656,113,1955,Bob Sweikert,Art Cross,8,0,8,Bob Sweikert
628,657,113,1955,Bob Sweikert,Bill Vukovich,8,1,7,Bob Sweikert
628,658,113,1955,Bob Sweikert,Jack McGrath,8,0,8,Bob Sweikert
653,654,113,1955,Jimmy Davies,Walt Faulkner,4,1,3,Jimmy Davies
653,655,113,1955,Jimmy Davies,Cal Niday,4,0,4,Jimmy Davies
653,656,113,1955,Jimmy Davies,Art Cross,4,0,4,Jimmy Davies
653,657,113,1955,Jimmy Davies,Bill Vukovich,4,1,3,Jimmy Davies
653,658,113,1955,Jimmy Davies,Jack McGrath,4,0,4,Jimmy Davies
654,655,113,1955,Walt Faulkner,Cal Niday,1,0,1,Walt Faulkner
654,656,113,1955,Walt Faulkner,Art Cross,1,0,1,Walt Faulkner
654,657,113,1955,Walt Faulkner,Bill Vukovich,1,1,0,Bill Vukovich
654,658,113,1955,Walt Faulkner,Jack McGrath,1,0,1,Walt Faulkner
655,656,113,1955,Cal Niday,Art Cross,0,0,0,Art Cross
655,657,113,1955,Cal Niday,Bill Vukovich,0,1,1,Bill Vukovich
655,658,113,1955,Cal Niday,Jack McGrath,0,0,0,Jack McGrath
656,657,113,1955,Art Cross,Bill Vukovich,0,1,1,Bill Vukovich
656,658,113,1955,Art Cross,Jack McGrath,0,0,0,Jack McGrath
657,658,113,1955,Bill Vukovich,Jack McGrath,1,0,1,Bill Vukovich
449,509,113,1956,Rodger Ward,Jim Rathmann,0,0,0,Jim Rathmann
449,514,113,1956,Rodger Ward,Bob Veith,0,0,0,Bob Veith
449,516,113,1956,Rodger Ward,Bob Christie,0,0,0,Bob Christie
449,526,113,1956,Rodger Ward,Troy Ruttman,0,0,0,Troy Ruttman
449,529,113,1956,Rodger Ward,Tony Bettenhausen,0,0,0,Tony Bettenhausen
449,532,113,1956,Rodger Ward,Eddie Russo,0,0,0,Eddie Russo
449,533,113,1956,Rodger Ward,Johnny Boyd,0,0,0,Johnny Boyd
449,537,113,1956,Rodger Ward,Dick Rathmann,0,2,2,Dick Rathmann
449,538,113,1956,Rodger Ward,Al Herman,0,0,0,Al Herman
449,555,113,1956,Rodger Ward,Paul Russo,0,1,1,Paul Russo
449,556,113,1956,Rodger Ward,Jimmy Daywalt,0,0,0,Jimmy Daywalt
449,558,113,1956,Rodger Ward,Al Keller,0,0,0,Al Keller
449,561,113,1956,Rodger Ward,Ray Crawford,0,0,0,Ray Crawford
449,562,113,1956,Rodger Ward,Jack Turner,0,0,0,Jack Turner
449,593,113,1956,Rodger Ward,Johnnie Parsons,0,3,3,Johnnie Parsons
449,594,113,1956,Rodger Ward,Johnnie Tolan,0,0,0,Johnnie Tolan
449,596,113,1956,Rodger Ward,Ed Elisian,0,0,0,Ed Elisian
449,597,113,1956,Rodger Ward,Pat O'Connor,0,0,0,Pat O'Connor
449,611,113,1956,Rodger Ward,Sam Hanks,0,6,6,Sam Hanks
449,612,113,1956,Rodger Ward,Andy Linden,0,0,0,Andy Linden
449,615,113,1956,Rodger Ward,Fred Agabashian,0,0,0,Fred Agabashian
449,630,113,1956,Rodger Ward,Duke Dinsmore,0,0,0,Duke Dinsmore
449,631,113,1956,Rodger Ward,Keith Andrews,0,0,0,Keith Andrews
509,514,113,1956,Jim Rathmann,Bob Veith,0,0,0,Bob Veith
509,516,113,1956,Jim Rathmann,Bob Christie,0,0,0,Bob Christie
509,526,113,1956,Jim Rathmann,Troy Ruttman,0,0,0,Troy Ruttman
509,529,113,1956,Jim Rathmann,Tony Bettenhausen,0,0,0,Tony Bettenhausen
509,532,113,1956,Jim Rathmann,Eddie Russo,0,0,0,Eddie Russo
509,533,113,1956,Jim Rathmann,Johnny Boyd,0,0,0,Johnny Boyd
509,537,113,1956,Jim Rathmann,Dick Rathmann,0,2,2,Dick Rathmann
509,538,113,1956,Jim Rathmann,Al Herman,0,0,0,Al Herman
509,555,113,1956,Jim Rathmann,Paul Russo,0,1,1,Paul Russo
509,556,113,1956,Jim Rathmann,Jimmy Daywalt,0,0,0,Jimmy Daywalt
509,558,113,1956,Jim Rathmann,Al Keller,0,0,0,Al Keller
509,561,113,1956,Jim Rathmann,Ray Crawford,0,0,0,Ray Crawford
509,562,113,1956,Jim Rathmann,Jack Turner,0,0,0,Jack Turner
509,593,113,1956,Jim Rathmann,Johnnie Parsons,0,3,3,Johnnie Parsons
509,594,113,1956,Jim Rathmann,Johnnie Tolan,0,0,0,Johnnie Tolan
509,596,113,1956,Jim Rathmann,Ed Elisian,0,0,0,Ed Elisian
509,597,113,1956,Jim Rathmann,Pat O'Connor,0,0,0,Pat O'Connor
509,611,113,1956,Jim Rathmann,Sam Hanks,0,6,6,Sam Hanks
509,612,113,1956,Jim Rathmann,Andy Linden,0,0,0,Andy Linden
509,615,113,1956,Jim Rathmann,Fred Agabashian,0,0,0,Fred Agabashian
509,630,113,1956,Jim Rathmann,Duke Dinsmore,0,0,0,Duke Dinsmore
509,631,113,1956,Jim Rathmann,Keith Andrews,0,0,0,Keith Andrews
514,516,113,1956,Bob Veith,Bob Christie,0,0,0,Bob Christie
514,526,113,1956,Bob Veith,Troy Ruttman,0,0,0,Troy Ruttman
514,529,113,1956,Bob Veith,Tony Bettenhausen,0,0,0,Tony Bettenhausen
514,532,113,1956,Bob Veith,Eddie Russo,0,0,0,Eddie Russo
514,533,113,1956,Bob Veith,Johnny Boyd,0,0,0,Johnny Boyd
514,537,113,1956,Bob Veith,Dick Rathmann,0,2,2,Dick Rathmann
514,538,113,1956,Bob Veith,Al Herman,0,0,0,Al Herman
514,555,113,1956,Bob Veith,Paul Russo,0,1,1,Paul Russo
514,556,113,1956,Bob Veith,Jimmy Daywalt,0,0,0,Jimmy Daywalt
514,558,113,1956,Bob Veith,Al Keller,0,0,0,Al Keller
514,561,113,1956,Bob Veith,Ray Crawford,0,0,0,Ray Crawford
514,562,113,1956,Bob Veith,Jack Turner,0,0,0,Jack Turner
514,593,113,1956,Bob Veith,Johnnie Parsons,0,3,3,Johnnie Parsons
514,594,113,1956,Bob Veith,Johnnie Tolan,0,0,0,Johnnie Tolan
514,596,113,1956,Bob Veith,Ed Elisian,0,0,0,Ed Elisian
514,597,113,1956,Bob Veith,Pat O'Connor,0,0,0,Pat O'Connor
514,611,113,1956,Bob Veith,Sam Hanks,0,6,6,Sam Hanks
514,612,113,1956,Bob Veith,Andy Linden,0,0,0,Andy Linden
514,615,113,1956,Bob Veith,Fred Agabashian,0,0,0,Fred Agabashian
514,630,113,1956,Bob Veith,Duke Dinsmore,0,0,0,Duke Dinsmore
514,631,113,1956,Bob Veith,Keith Andrews,0,0,0,Keith Andrews
516,526,113,1956,Bob Christie,Troy Ruttman,0,0,0,Troy Ruttman
516,529,113,1956,Bob Christie,Tony Bettenhausen,0,0,0,Tony Bettenhausen
516,532,113,1956,Bob Christie,Eddie Russo,0,0,0,Eddie Russo
516,533,113,1956,Bob Christie,Johnny Boyd,0,0,0,Johnny Boyd
516,537,113,1956,Bob Christie,Dick Rathmann,0,2,2,Dick Rathmann
516,538,113,1956,Bob Christie,Al Herman,0,0,0,Al Herman
516,555,113,1956,Bob Christie,Paul Russo,0,1,1,Paul Russo
516,556,113,1956,Bob Christie,Jimmy Daywalt,0,0,0,Jimmy Daywalt
516,558,113,1956,Bob Christie,Al Keller,0,0,0,Al Keller
516,561,113,1956,Bob Christie,Ray Crawford,0,0,0,Ray Crawford
516,562,113,1956,Bob Christie,Jack Turner,0,0,0,Jack Turner
516,593,113,1956,Bob Christie,Johnnie Parsons,0,3,3,Johnnie Parsons
516,594,113,1956,Bob Christie,Johnnie Tolan,0,0,0,Johnnie Tolan
516,596,113,1956,Bob Christie,Ed Elisian,0,0,0,Ed Elisian
516,597,113,1956,Bob Christie,Pat O'Connor,0,0,0,Pat O'Connor
516,611,113,1956,Bob Christie,Sam Hanks,0,6,6,Sam Hanks
516,612,113,1956,Bob Christie,Andy Linden,0,0,0,Andy Linden
516,615,113,1956,Bob Christie,Fred Agabashian,0,0,0,Fred Agabashian
516,630,113,1956,Bob Christie,Duke Dinsmore,0,0,0,Duke Dinsmore
516,631,113,1956,Bob Christie,Keith Andrews,0,0,0,Keith Andrews
526,529,113,1956,Troy Ruttman,Tony Bettenhausen,0,0,0,Tony Bettenhausen
526,532,113,1956,Troy Ruttman,Eddie Russo,0,0,0,Eddie Russo
526,533,113,1956,Troy Ruttman,Johnny Boyd,0,0,0,Johnny Boyd
526,537,113,1956,Troy Ruttman,Dick Rathmann,0,2,2,Dick Rathmann
526,538,113,1956,Troy Ruttman,Al Herman,0,0,0,Al Herman
526,555,113,1956,Troy Ruttman,Paul Russo,0,1,1,Paul Russo
526,556,113,1956,Troy Ruttman,Jimmy Daywalt,0,0,0,Jimmy Daywalt
526,558,113,1956,Troy Ruttman,Al Keller,0,0,0,Al Keller
526,561,113,1956,Troy Ruttman,Ray Crawford,0,0,0,Ray Crawford
526,562,113,1956,Troy Ruttman,Jack Turner,0,0,0,Jack Turner
526,593,113,1956,Troy Ruttman,Johnnie Parsons,0,3,3,Johnnie Parsons
526,594,113,1956,Troy Ruttman,Johnnie Tolan,0,0,0,Johnnie Tolan
526,596,113,1956,Troy Ruttman,Ed Elisian,0,0,0,Ed Elisian
526,597,113,1956,Troy Ruttman,Pat O'Connor,0,0,0,Pat O'Connor
526,611,113,1956,Troy Ruttman,Sam Hanks,0,6,6,Sam Hanks
526,612,113,1956,Troy Ruttman,Andy Linden,0,0,0,Andy Linden
526,615,113,1956,Troy Ruttman,Fred Agabashian,0,0,0,Fred Agabashian
526,630,113,1956,Troy Ruttman,Duke Dinsmore,0,0,0,Duke Dinsmore
526,631,113,1956,Troy Ruttman,Keith Andrews,0,0,0,Keith Andrews
529,532,113,1956,Tony Bettenhausen,Eddie Russo,0,0,0,Eddie Russo
529,533,113,1956,Tony Bettenhausen,Johnny Boyd,0,0,0,Johnny Boyd
529,537,113,1956,Tony Bettenhausen,Dick Rathmann,0,2,2,Dick Rathmann
529,538,113,1956,Tony Bettenhausen,Al Herman,0,0,0,Al Herman
529,555,113,1956,Tony Bettenhausen,Paul Russo,0,1,1,Paul Russo
529,556,113,1956,Tony Bettenhausen,Jimmy Daywalt,0,0,0,Jimmy Daywalt
529,558,113,1956,Tony Bettenhausen,Al Keller,0,0,0,Al Keller
529,561,113,1956,Tony Bettenhausen,Ray Crawford,0,0,0,Ray Crawford
529,562,113,1956,Tony Bettenhausen,Jack Turner,0,0,0,Jack Turner
529,593,113,1956,Tony Bettenhausen,Johnnie Parsons,0,3,3,Johnnie Parsons
529,594,113,1956,Tony Bettenhausen,Johnnie Tolan,0,0,0,Johnnie Tolan
529,596,113,1956,Tony Bettenhausen,Ed Elisian,0,0,0,Ed Elisian
529,597,113,1956,Tony Bettenhausen,Pat O'Connor,0,0,0,Pat O'Connor
529,611,113,1956,Tony Bettenhausen,Sam Hanks,0,6,6,Sam Hanks
529,612,113,1956,Tony Bettenhausen,Andy Linden,0,0,0,Andy Linden
529,615,113,1956,Tony Bettenhausen,Fred Agabashian,0,0,0,Fred Agabashian
529,630,113,1956,Tony Bettenhausen,Duke Dinsmore,0,0,0,Duke Dinsmore
529,631,113,1956,Tony Bettenhausen,Keith Andrews,0,0,0,Keith Andrews
532,533,113,1956,Eddie Russo,Johnny Boyd,0,0,0,Johnny Boyd
532,537,113,1956,Eddie Russo,Dick Rathmann,0,2,2,Dick Rathmann
532,538,113,1956,Eddie Russo,Al Herman,0,0,0,Al Herman
532,555,113,1956,Eddie Russo,Paul Russo,0,1,1,Paul Russo
532,556,113,1956,Eddie Russo,Jimmy Daywalt,0,0,0,Jimmy Daywalt
532,558,113,1956,Eddie Russo,Al Keller,0,0,0,Al Keller
532,561,113,1956,Eddie Russo,Ray Crawford,0,0,0,Ray Crawford
532,562,113,1956,Eddie Russo,Jack Turner,0,0,0,Jack Turner
532,593,113,1956,Eddie Russo,Johnnie Parsons,0,3,3,Johnnie Parsons
532,594,113,1956,Eddie Russo,Johnnie Tolan,0,0,0,Johnnie Tolan
532,596,113,1956,Eddie Russo,Ed Elisian,0,0,0,Ed Elisian
532,597,113,1956,Eddie Russo,Pat O'Connor,0,0,0,Pat O'Connor
532,611,113,1956,Eddie Russo,Sam Hanks,0,6,6,Sam Hanks
532,612,113,1956,Eddie Russo,Andy Linden,0,0,0,Andy Linden
532,615,113,1956,Eddie Russo,Fred Agabashian,0,0,0,Fred Agabashian
532,630,113,1956,Eddie Russo,Duke Dinsmore,0,0,0,Duke Dinsmore
532,631,113,1956,Eddie Russo,Keith Andrews,0,0,0,Keith Andrews
533,537,113,1956,Johnny Boyd,Dick Rathmann,0,2,2,Dick Rathmann
533,538,113,1956,Johnny Boyd,Al Herman,0,0,0,Al Herman
533,555,113,1956,Johnny Boyd,Paul Russo,0,1,1,Paul Russo
533,556,113,1956,Johnny Boyd,Jimmy Daywalt,0,0,0,Jimmy Daywalt
533,558,113,1956,Johnny Boyd,Al Keller,0,0,0,Al Keller
533,561,113,1956,Johnny Boyd,Ray Crawford,0,0,0,Ray Crawford
533,562,113,1956,Johnny Boyd,Jack Turner,0,0,0,Jack Turner
533,593,113,1956,Johnny Boyd,Johnnie Parsons,0,3,3,Johnnie Parsons
533,594,113,1956,Johnny Boyd,Johnnie Tolan,0,0,0,Johnnie Tolan
533,596,113,1956,Johnny Boyd,Ed Elisian,0,0,0,Ed Elisian
533,597,113,1956,Johnny Boyd,Pat O'Connor,0,0,0,Pat O'Connor
533,611,113,1956,Johnny Boyd,Sam Hanks,0,6,6,Sam Hanks
533,612,113,1956,Johnny Boyd,Andy Linden,0,0,0,Andy Linden
533,615,113,1956,Johnny Boyd,Fred Agabashian,0,0,0,Fred Agabashian
533,630,113,1956,Johnny Boyd,Duke Dinsmore,0,0,0,Duke Dinsmore
533,631,113,1956,Johnny Boyd,Keith Andrews,0,0,0,Keith Andrews
537,538,113,1956,Dick Rathmann,Al Herman,2,0,2,Dick Rathmann
537,555,113,1956,Dick Rathmann,Paul Russo,2,1,1,Dick Rathmann
537,556,113,1956,Dick Rathmann,Jimmy Daywalt,2,0,2,Dick Rathmann
537,558,113,1956,Dick Rathmann,Al Keller,2,0,2,Dick Rathmann
537,561,113,1956,Dick Rathmann,Ray Crawford,2,0,2,Dick Rathmann
537,562,113,1956,Dick Rathmann,Jack Turner,2,0,2,Dick Rathmann
537,593,113,1956,Dick Rathmann,Johnnie Parsons,2,3,1,Johnnie Parsons
537,594,113,1956,Dick Rathmann,Johnnie Tolan,2,0,2,Dick Rathmann
537,596,113,1956,Dick Rathmann,Ed Elisian,2,0,2,Dick Rathmann
537,597,113,1956,Dick Rathmann,Pat O'Connor,2,0,2,Dick Rathmann
537,611,113,1956,Dick Rathmann,Sam Hanks,2,6,4,Sam Hanks
537,612,113,1956,Dick Rathmann,Andy Linden,2,0,2,Dick Rathmann
537,615,113,1956,Dick Rathmann,Fred Agabashian,2,0,2,Dick Rathmann
537,630,113,1956,Dick Rathmann,Duke Dinsmore,2,0,2,Dick Rathmann
537,631,113,1956,Dick Rathmann,Keith Andrews,2,0,2,Dick Rathmann
538,555,113,1956,Al Herman,Paul Russo,0,1,1,Paul Russo
538,556,113,1956,Al Herman,Jimmy Daywalt,0,0,0,Jimmy Daywalt
538,558,113,1956,Al Herman,Al Keller,0,0,0,Al Keller
538,561,113,1956,Al Herman,Ray Crawford,0,0,0,Ray Crawford
538,562,113,1956,Al Herman,Jack Turner,0,0,0,Jack Turner
538,593,113,1956,Al Herman,Johnnie Parsons,0,3,3,Johnnie Parsons
538,594,113,1956,Al Herman,Johnnie Tolan,0,0,0,Johnnie Tolan
538,596,113,1956,Al Herman,Ed Elisian,0,0,0,Ed Elisian
538,597,113,1956,Al Herman,Pat O'Connor,0,0,0,Pat O'Connor
538,611,113,1956,Al Herman,Sam Hanks,0,6,6,Sam Hanks
538,612,113,1956,Al Herman,Andy Linden,0,0,0,Andy Linden
538,615,113,1956,Al Herman,Fred Agabashian,0,0,0,Fred Agabashian
538,630,113,1956,Al Herman,Duke Dinsmore,0,0,0,Duke Dinsmore
538,631,113,1956,Al Herman,Keith Andrews,0,0,0,Keith Andrews
555,556,113,1956,Paul Russo,Jimmy Daywalt,1,0,1,Paul Russo
555,558,113,1956,Paul Russo,Al Keller,1,0,1,Paul Russo
555,561,113,1956,Paul Russo,Ray Crawford,1,0,1,Paul Russo
555,562,113,1956,Paul Russo,Jack Turner,1,0,1,Paul Russo
555,593,113,1956,Paul Russo,Johnnie Parsons,1,3,2,Johnnie Parsons
555,594,113,1956,Paul Russo,Johnnie Tolan,1,0,1,Paul Russo
555,596,113,1956,Paul Russo,Ed Elisian,1,0,1,Paul Russo
555,597,113,1956,Paul Russo,Pat O'Connor,1,0,1,Paul Russo
555,611,113,1956,Paul Russo,Sam Hanks,1,6,5,Sam Hanks
555,612,113,1956,Paul Russo,Andy Linden,1,0,1,Paul Russo
555,615,113,1956,Paul Russo,Fred Agabashian,1,0,1,Paul Russo
555,630,113,1956,Paul Russo,Duke Dinsmore,1,0,1,Paul Russo
555,631,113,1956,Paul Russo,Keith Andrews,1,0,1,Paul Russo
556,558,113,1956,Jimmy Daywalt,Al Keller,0,0,0,Al Keller
556,561,113,1956,Jimmy Daywalt,Ray Crawford,0,0,0,Ray Crawford
556,562,113,1956,Jimmy Daywalt,Jack Turner,0,0,0,Jack Turner
556,593,113,1956,Jimmy Daywalt,Johnnie Parsons,0,3,3,Johnnie Parsons
556,594,113,1956,Jimmy Daywalt,Johnnie Tolan,0,0,0,Johnnie Tolan
556,596,113,1956,Jimmy Daywalt,Ed Elisian,0,0,0,Ed Elisian
556,597,113,1956,Jimmy Daywalt,Pat O'Connor,0,0,0,Pat O'Connor
556,611,113,1956,Jimmy Daywalt,Sam Hanks,0,6,6,Sam Hanks
556,612,113,1956,Jimmy Daywalt,Andy Linden,0,0,0,Andy Linden
556,615,113,1956,Jimmy Daywalt,Fred Agabashian,0,0,0,Fred Agabashian
556,630,113,1956,Jimmy Daywalt,Duke Dinsmore,0,0,0,Duke Dinsmore
556,631,113,1956,Jimmy Daywalt,Keith Andrews,0,0,0,Keith Andrews
558,561,113,1956,Al Keller,Ray Crawford,0,0,0,Ray Crawford
558,562,113,1956,Al Keller,Jack Turner,0,0,0,Jack Turner
558,593,113,1956,Al Keller,Johnnie Parsons,0,3,3,Johnnie Parsons
558,594,113,1956,Al Keller,Johnnie Tolan,0,0,0,Johnnie Tolan
558,596,113,1956,Al Keller,Ed Elisian,0,0,0,Ed Elisian
558,597,113,1956,Al Keller,Pat O'Connor,0,0,0,Pat O'Connor
558,611,113,1956,Al Keller,Sam Hanks,0,6,6,Sam Hanks
558,612,113,1956,Al Keller,Andy Linden,0,0,0,Andy Linden
558,615,113,1956,Al Keller,Fred Agabashian,0,0,0,Fred Agabashian
558,630,113,1956,Al Keller,Duke Dinsmore,0,0,0,Duke Dinsmore
558,631,113,1956,Al Keller,Keith Andrews,0,0,0,Keith Andrews
561,562,113,1956,Ray Crawford,Jack Turner,0,0,0,Jack Turner
561,593,113,1956,Ray Crawford,Johnnie Parsons,0,3,3,Johnnie Parsons
561,594,113,1956,Ray Crawford,Johnnie Tolan,0,0,0,Johnnie Tolan
561,596,113,1956,Ray Crawford,Ed Elisian,0,0,0,Ed Elisian
561,597,113,1956,Ray Crawford,Pat O'Connor,0,0,0,Pat O'Connor
561,611,113,1956,Ray Crawford,Sam Hanks,0,6,6,Sam Hanks
561,612,113,1956,Ray Crawford,Andy Linden,0,0,0,Andy Linden
561,615,113,1956,Ray Crawford,Fred Agabashian,0,0,0,Fred Agabashian
561,630,113,1956,Ray Crawford,Duke Dinsmore,0,0,0,Duke Dinsmore
561,631,113,1956,Ray Crawford,Keith Andrews,0,0,0,Keith Andrews
562,593,113,1956,Jack Turner,Johnnie Parsons,0,3,3,Johnnie Parsons
562,594,113,1956,Jack Turner,Johnnie Tolan,0,0,0,Johnnie Tolan
562,596,113,1956,Jack Turner,Ed Elisian,0,0,0,Ed Elisian
562,597,113,1956,Jack Turner,Pat O'Connor,0,0,0,Pat O'Connor
562,611,113,1956,Jack Turner,Sam Hanks,0,6,6,Sam Hanks
562,612,113,1956,Jack Turner,Andy Linden,0,0,0,Andy Linden
562,615,113,1956,Jack Turner,Fred Agabashian,0,0,0,Fred Agabashian
562,630,113,1956,Jack Turner,Duke Dinsmore,0,0,0,Duke Dinsmore
562,631,113,1956,Jack Turner,Keith Andrews,0,0,0,Keith Andrews
593,594,113,1956,Johnnie Parsons,Johnnie Tolan,3,0,3,Johnnie Parsons
593,596,113,1956,Johnnie Parsons,Ed Elisian,3,0,3,Johnnie Parsons
593,597,113,1956,Johnnie Parsons,Pat O'Connor,3,0,3,Johnnie Parsons
593,611,113,1956,Johnnie Parsons,Sam Hanks,3,6,3,Sam Hanks
593,612,113,1956,Johnnie Parsons,Andy Linden,3,0,3,Johnnie Parsons
593,615,113,1956,Johnnie Parsons,Fred Agabashian,3,0,3,Johnnie Parsons
593,630,113,1956,Johnnie Parsons,Duke Dinsmore,3,0,3,Johnnie Parsons
593,631,113,1956,Johnnie Parsons,Keith Andrews,3,0,3,Johnnie Parsons
594,596,113,1956,Johnnie Tolan,Ed Elisian,0,0,0,Ed Elisian
594,597,113,1956,Johnnie Tolan,Pat O'Connor,0,0,0,Pat O'Connor
594,611,113,1956,Johnnie Tolan,Sam Hanks,0,6,6,Sam Hanks
594,612,113,1956,Johnnie Tolan,Andy Linden,0,0,0,Andy Linden
594,615,113,1956,Johnnie Tolan,Fred Agabashian,0,0,0,Fred Agabashian
594,630,113,1956,Johnnie Tolan,Duke Dinsmore,0,0,0,Duke Dinsmore
594,631,113,1956,Johnnie Tolan,Keith Andrews,0,0,0,Keith Andrews
596,597,113,1956,Ed Elisian,Pat O'Connor,0,0,0,Pat O'Connor
596,611,113,1956,Ed Elisian,Sam Hanks,0,6,6,Sam Hanks
596,612,113,1956,Ed Elisian,Andy Linden,0,0,0,Andy Linden
596,615,113,1956,Ed Elisian,Fred Agabashian,0,0,0,Fred Agabashian
596,630,113,1956,Ed Elisian,Duke Dinsmore,0,0,0,Duke Dinsmore
596,631,113,1956,Ed Elisian,Keith Andrews,0,0,0,Keith Andrews
597,611,113,1956,Pat O'Connor,Sam Hanks,0,6,6,Sam Hanks
597,612,113,1956,Pat O'Connor,Andy Linden,0,0,0,Andy Linden
597,615,113,1956,Pat O'Connor,Fred Agabashian,0,0,0,Fred Agabashian
597,630,113,1956,Pat O'Connor,Duke Dinsmore,0,0,0,Duke Dinsmore
597,631,113,1956,Pat O'Connor,Keith Andrews,0,0,0,Keith Andrews
611,612,113,1956,Sam Hanks,Andy Linden,6,0,6,Sam Hanks
611,615,113,1956,Sam Hanks,Fred Agabashian,6,0,6,Sam Hanks
611,630,113,1956,Sam Hanks,Duke Dinsmore,6,0,6,Sam Hanks
611,631,113,1956,Sam Hanks,Keith Andrews,6,0,6,Sam Hanks
612,615,113,1956,Andy Linden,Fred Agabashian,0,0,0,Fred Agabashian
612,630,113,1956,Andy Linden,Duke Dinsmore,0,0,0,Duke Dinsmore
612,631,113,1956,Andy Linden,Keith Andrews,0,0,0,Keith Andrews
615,630,113,1956,Fred Agabashian,Duke Dinsmore,0,0,0,Duke Dinsmore
615,631,113,1956,Fred Agabashian,Keith Andrews,0,0,0,Keith Andrews
630,631,113,1956,Duke Dinsmore,Keith Andrews,0,0,0,Keith Andrews
513,516,113,1957,Eddie Johnson,Bob Christie,0,0,0,Bob Christie
513,528,113,1957,Eddie Johnson,Don Freeland,0,0,0,Don Freeland
513,529,113,1957,Eddie Johnson,Tony Bettenhausen,0,0,0,Tony Bettenhausen
513,532,113,1957,Eddie Johnson,Eddie Russo,0,0,0,Eddie Russo
513,533,113,1957,Eddie Johnson,Johnny Boyd,0,0,0,Johnny Boyd
513,555,113,1957,Eddie Johnson,Paul Russo,0,3,3,Paul Russo
513,556,113,1957,Eddie Johnson,Jimmy Daywalt,0,0,0,Jimmy Daywalt
513,558,113,1957,Eddie Johnson,Al Keller,0,0,0,Al Keller
513,560,113,1957,Eddie Johnson,Bill Cheesbourg,0,0,0,Bill Cheesbourg
513,562,113,1957,Eddie Johnson,Jack Turner,0,0,0,Jack Turner
513,565,113,1957,Eddie Johnson,Mike Magill,0,0,0,Mike Magill
513,592,113,1957,Eddie Johnson,Jimmy Reece,0,0,0,Jimmy Reece
513,593,113,1957,Eddie Johnson,Johnnie Parsons,0,0,0,Johnnie Parsons
513,594,113,1957,Eddie Johnson,Johnnie Tolan,0,0,0,Johnnie Tolan
513,596,113,1957,Eddie Johnson,Ed Elisian,0,0,0,Ed Elisian
513,597,113,1957,Eddie Johnson,Pat O'Connor,0,0,0,Pat O'Connor
513,612,113,1957,Eddie Johnson,Andy Linden,0,2,2,Andy Linden
513,613,113,1957,Eddie Johnson,Marshall Teague,0,0,0,Marshall Teague
513,614,113,1957,Eddie Johnson,Don Edmunds,0,0,0,Don Edmunds
513,615,113,1957,Eddie Johnson,Fred Agabashian,0,0,0,Fred Agabashian
513,616,113,1957,Eddie Johnson,Elmer George,0,0,0,Elmer George
516,528,113,1957,Bob Christie,Don Freeland,0,0,0,Don Freeland
516,529,113,1957,Bob Christie,Tony Bettenhausen,0,0,0,Tony Bettenhausen
516,532,113,1957,Bob Christie,Eddie Russo,0,0,0,Eddie Russo
516,533,113,1957,Bob Christie,Johnny Boyd,0,0,0,Johnny Boyd
516,555,113,1957,Bob Christie,Paul Russo,0,3,3,Paul Russo
516,556,113,1957,Bob Christie,Jimmy Daywalt,0,0,0,Jimmy Daywalt
516,558,113,1957,Bob Christie,Al Keller,0,0,0,Al Keller
516,560,113,1957,Bob Christie,Bill Cheesbourg,0,0,0,Bill Cheesbourg
516,562,113,1957,Bob Christie,Jack Turner,0,0,0,Jack Turner
516,565,113,1957,Bob Christie,Mike Magill,0,0,0,Mike Magill
516,592,113,1957,Bob Christie,Jimmy Reece,0,0,0,Jimmy Reece
516,593,113,1957,Bob Christie,Johnnie Parsons,0,0,0,Johnnie Parsons
516,594,113,1957,Bob Christie,Johnnie Tolan,0,0,0,Johnnie Tolan
516,596,113,1957,Bob Christie,Ed Elisian,0,0,0,Ed Elisian
516,597,113,1957,Bob Christie,Pat O'Connor,0,0,0,Pat O'Connor
516,612,113,1957,Bob Christie,Andy Linden,0,2,2,Andy Linden
516,613,113,1957,Bob Christie,Marshall Teague,0,0,0,Marshall Teague
516,614,113,1957,Bob Christie,Don Edmunds,0,0,0,Don Edmunds
516,615,113,1957,Bob Christie,Fred Agabashian,0,0,0,Fred Agabashian
516,616,113,1957,Bob Christie,Elmer George,0,0,0,Elmer George
528,529,113,1957,Don Freeland,Tony Bettenhausen,0,0,0,Tony Bettenhausen
528,532,113,1957,Don Freeland,Eddie Russo,0,0,0,Eddie Russo
528,533,113,1957,Don Freeland,Johnny Boyd,0,0,0,Johnny Boyd
528,555,113,1957,Don Freeland,Paul Russo,0,3,3,Paul Russo
528,556,113,1957,Don Freeland,Jimmy Daywalt,0,0,0,Jimmy Daywalt
528,558,113,1957,Don Freeland,Al Keller,0,0,0,Al Keller
528,560,113,1957,Don Freeland,Bill Cheesbourg,0,0,0,Bill Cheesbourg
528,562,113,1957,Don Freeland,Jack Turner,0,0,0,Jack Turner
528,565,113,1957,Don Freeland,Mike Magill,0,0,0,Mike Magill
528,592,113,1957,Don Freeland,Jimmy Reece,0,0,0,Jimmy Reece
528,593,113,1957,Don Freeland,Johnnie Parsons,0,0,0,Johnnie Parsons
528,594,113,1957,Don Freeland,Johnnie Tolan,0,0,0,Johnnie Tolan
528,596,113,1957,Don Freeland,Ed Elisian,0,0,0,Ed Elisian
528,597,113,1957,Don Freeland,Pat O'Connor,0,0,0,Pat O'Connor
528,612,113,1957,Don Freeland,Andy Linden,0,2,2,Andy Linden
528,613,113,1957,Don Freeland,Marshall Teague,0,0,0,Marshall Teague
528,614,113,1957,Don Freeland,Don Edmunds,0,0,0,Don Edmunds
528,615,113,1957,Don Freeland,Fred Agabashian,0,0,0,Fred Agabashian
528,616,113,1957,Don Freeland,Elmer George,0,0,0,Elmer George
529,532,113,1957,Tony Bettenhausen,Eddie Russo,0,0,0,Eddie Russo
529,533,113,1957,Tony Bettenhausen,Johnny Boyd,0,0,0,Johnny Boyd
529,555,113,1957,Tony Bettenhausen,Paul Russo,0,3,3,Paul Russo
529,556,113,1957,Tony Bettenhausen,Jimmy Daywalt,0,0,0,Jimmy Daywalt
529,558,113,1957,Tony Bettenhausen,Al Keller,0,0,0,Al Keller
529,560,113,1957,Tony Bettenhausen,Bill Cheesbourg,0,0,0,Bill Cheesbourg
529,562,113,1957,Tony Bettenhausen,Jack Turner,0,0,0,Jack Turner
529,565,113,1957,Tony Bettenhausen,Mike Magill,0,0,0,Mike Magill
529,592,113,1957,Tony Bettenhausen,Jimmy Reece,0,0,0,Jimmy Reece
529,593,113,1957,Tony Bettenhausen,Johnnie Parsons,0,0,0,Johnnie Parsons
529,594,113,1957,Tony Bettenhausen,Johnnie Tolan,0,0,0,Johnnie Tolan
529,596,113,1957,Tony Bettenhausen,Ed Elisian,0,0,0,Ed Elisian
529,597,113,1957,Tony Bettenhausen,Pat O'Connor,0,0,0,Pat O'Connor
529,612,113,1957,Tony Bettenhausen,Andy Linden,0,2,2,Andy Linden
529,613,113,1957,Tony Bettenhausen,Marshall Teague,0,0,0,Marshall Teague
529,614,113,1957,Tony Bettenhausen,Don Edmunds,0,0,0,Don Edmunds
529,615,113,1957,Tony Bettenhausen,Fred Agabashian,0,0,0,Fred Agabashian
529,616,113,1957,Tony Bettenhausen,Elmer George,0,0,0,Elmer George
532,533,113,1957,Eddie Russo,Johnny Boyd,0,0,0,Johnny Boyd
532,555,113,1957,Eddie Russo,Paul Russo,0,3,3,Paul Russo
532,556,113,1957,Eddie Russo,Jimmy Daywalt,0,0,0,Jimmy Daywalt
532,558,113,1957,Eddie Russo,Al Keller,0,0,0,Al Keller
532,560,113,1957,Eddie Russo,Bill Cheesbourg,0,0,0,Bill Cheesbourg
532,562,113,1957,Eddie Russo,Jack Turner,0,0,0,Jack Turner
532,565,113,1957,Eddie Russo,Mike Magill,0,0,0,Mike Magill
532,592,113,1957,Eddie Russo,Jimmy Reece,0,0,0,Jimmy Reece
532,593,113,1957,Eddie Russo,Johnnie Parsons,0,0,0,Johnnie Parsons
532,594,113,1957,Eddie Russo,Johnnie Tolan,0,0,0,Johnnie Tolan
532,596,113,1957,Eddie Russo,Ed Elisian,0,0,0,Ed Elisian
532,597,113,1957,Eddie Russo,Pat O'Connor,0,0,0,Pat O'Connor
532,612,113,1957,Eddie Russo,Andy Linden,0,2,2,Andy Linden
532,613,113,1957,Eddie Russo,Marshall Teague,0,0,0,Marshall Teague
532,614,113,1957,Eddie Russo,Don Edmunds,0,0,0,Don Edmunds
532,615,113,1957,Eddie Russo,Fred Agabashian,0,0,0,Fred Agabashian
532,616,113,1957,Eddie Russo,Elmer George,0,0,0,Elmer George
533,555,113,1957,Johnny Boyd,Paul Russo,0,3,3,Paul Russo
533,556,113,1957,Johnny Boyd,Jimmy Daywalt,0,0,0,Jimmy Daywalt
533,558,113,1957,Johnny Boyd,Al Keller,0,0,0,Al Keller
533,560,113,1957,Johnny Boyd,Bill Cheesbourg,0,0,0,Bill Cheesbourg
533,562,113,1957,Johnny Boyd,Jack Turner,0,0,0,Jack Turner
533,565,113,1957,Johnny Boyd,Mike Magill,0,0,0,Mike Magill
533,592,113,1957,Johnny Boyd,Jimmy Reece,0,0,0,Jimmy Reece
533,593,113,1957,Johnny Boyd,Johnnie Parsons,0,0,0,Johnnie Parsons
533,594,113,1957,Johnny Boyd,Johnnie Tolan,0,0,0,Johnnie Tolan
533,596,113,1957,Johnny Boyd,Ed Elisian,0,0,0,Ed Elisian
533,597,113,1957,Johnny Boyd,Pat O'Connor,0,0,0,Pat O'Connor
533,612,113,1957,Johnny Boyd,Andy Linden,0,2,2,Andy Linden
533,613,113,1957,Johnny Boyd,Marshall Teague,0,0,0,Marshall Teague
533,614,113,1957,Johnny Boyd,Don Edmunds,0,0,0,Don Edmunds
533,615,113,1957,Johnny Boyd,Fred Agabashian,0,0,0,Fred Agabashian
533,616,113,1957,Johnny Boyd,Elmer George,0,0,0,Elmer George
555,556,113,1957,Paul Russo,Jimmy Daywalt,3,0,3,Paul Russo
555,558,113,1957,Paul Russo,Al Keller,3,0,3,Paul Russo
555,560,113,1957,Paul Russo,Bill Cheesbourg,3,0,3,Paul Russo
555,562,113,1957,Paul Russo,Jack Turner,3,0,3,Paul Russo
555,565,113,1957,Paul Russo,Mike Magill,3,0,3,Paul Russo
555,592,113,1957,Paul Russo,Jimmy Reece,3,0,3,Paul Russo
555,593,113,1957,Paul Russo,Johnnie Parsons,3,0,3,Paul Russo
555,594,113,1957,Paul Russo,Johnnie Tolan,3,0,3,Paul Russo
555,596,113,1957,Paul Russo,Ed Elisian,3,0,3,Paul Russo
555,597,113,1957,Paul Russo,Pat O'Connor,3,0,3,Paul Russo
555,612,113,1957,Paul Russo,Andy Linden,3,2,1,Paul Russo
555,613,113,1957,Paul Russo,Marshall Teague,3,0,3,Paul Russo
555,614,113,1957,Paul Russo,Don Edmunds,3,0,3,Paul Russo
555,615,113,1957,Paul Russo,Fred Agabashian,3,0,3,Paul Russo
555,616,113,1957,Paul Russo,Elmer George,3,0,3,Paul Russo
556,558,113,1957,Jimmy Daywalt,Al Keller,0,0,0,Al Keller
556,560,113,1957,Jimmy Daywalt,Bill Cheesbourg,0,0,0,Bill Cheesbourg
556,562,113,1957,Jimmy Daywalt,Jack Turner,0,0,0,Jack Turner
556,565,113,1957,Jimmy Daywalt,Mike Magill,0,0,0,Mike Magill
556,592,113,1957,Jimmy Daywalt,Jimmy Reece,0,0,0,Jimmy Reece
556,593,113,1957,Jimmy Daywalt,Johnnie Parsons,0,0,0,Johnnie Parsons
556,594,113,1957,Jimmy Daywalt,Johnnie Tolan,0,0,0,Johnnie Tolan
556,596,113,1957,Jimmy Daywalt,Ed Elisian,0,0,0,Ed Elisian
556,597,113,1957,Jimmy Daywalt,Pat O'Connor,0,0,0,Pat O'Connor
556,612,113,1957,Jimmy Daywalt,Andy Linden,0,2,2,Andy Linden
556,613,113,1957,Jimmy Daywalt,Marshall Teague,0,0,0,Marshall Teague
556,614,113,1957,Jimmy Daywalt,Don Edmunds,0,0,0,Don Edmunds
556,615,113,1957,Jimmy Daywalt,Fred Agabashian,0,0,0,Fred Agabashian
556,616,113,1957,Jimmy Daywalt,Elmer George,0,0,0,Elmer George
558,560,113,1957,Al Keller,Bill Cheesbourg,0,0,0,Bill Cheesbourg
558,562,113,1957,Al Keller,Jack Turner,0,0,0,Jack Turner
558,565,113,1957,Al Keller,Mike Magill,0,0,0,Mike Magill
558,592,113,1957,Al Keller,Jimmy Reece,0,0,0,Jimmy Reece
558,593,113,1957,Al Keller,Johnnie Parsons,0,0,0,Johnnie Parsons
558,594,113,1957,Al Keller,Johnnie Tolan,0,0,0,Johnnie Tolan
558,596,113,1957,Al Keller,Ed Elisian,0,0,0,Ed Elisian
558,597,113,1957,Al Keller,Pat O'Connor,0,0,0,Pat O'Connor
558,612,113,1957,Al Keller,Andy Linden,0,2,2,Andy Linden
558,613,113,1957,Al Keller,Marshall Teague,0,0,0,Marshall Teague
558,614,113,1957,Al Keller,Don Edmunds,0,0,0,Don Edmunds
558,615,113,1957,Al Keller,Fred Agabashian,0,0,0,Fred Agabashian
558,616,113,1957,Al Keller,Elmer George,0,0,0,Elmer George
560,562,113,1957,Bill Cheesbourg,Jack Turner,0,0,0,Jack Turner
560,565,113,1957,Bill Cheesbourg,Mike Magill,0,0,0,Mike Magill
560,592,113,1957,Bill Cheesbourg,Jimmy Reece,0,0,0,Jimmy Reece
560,593,113,1957,Bill Cheesbourg,Johnnie Parsons,0,0,0,Johnnie Parsons
560,594,113,1957,Bill Cheesbourg,Johnnie Tolan,0,0,0,Johnnie Tolan
560,596,113,1957,Bill Cheesbourg,Ed Elisian,0,0,0,Ed Elisian
560,597,113,1957,Bill Cheesbourg,Pat O'Connor,0,0,0,Pat O'Connor
560,612,113,1957,Bill Cheesbourg,Andy Linden,0,2,2,Andy Linden
560,613,113,1957,Bill Cheesbourg,Marshall Teague,0,0,0,Marshall Teague
560,614,113,1957,Bill Cheesbourg,Don Edmunds,0,0,0,Don Edmunds
560,615,113,1957,Bill Cheesbourg,Fred Agabashian,0,0,0,Fred Agabashian
560,616,113,1957,Bill Cheesbourg,Elmer George,0,0,0,Elmer George
562,565,113,1957,Jack Turner,Mike Magill,0,0,0,Mike Magill
562,592,113,1957,Jack Turner,Jimmy Reece,0,0,0,Jimmy Reece
562,593,113,1957,Jack Turner,Johnnie Parsons,0,0,0,Johnnie Parsons
562,594,113,1957,Jack Turner,Johnnie Tolan,0,0,0,Johnnie Tolan
562,596,113,1957,Jack Turner,Ed Elisian,0,0,0,Ed Elisian
562,597,113,1957,Jack Turner,Pat O'Connor,0,0,0,Pat O'Connor
562,612,113,1957,Jack Turner,Andy Linden,0,2,2,Andy Linden
562,613,113,1957,Jack Turner,Marshall Teague,0,0,0,Marshall Teague
562,614,113,1957,Jack Turner,Don Edmunds,0,0,0,Don Edmunds
562,615,113,1957,Jack Turner,Fred Agabashian,0,0,0,Fred Agabashian
562,616,113,1957,Jack Turner,Elmer George,0,0,0,Elmer George
565,592,113,1957,Mike Magill,Jimmy Reece,0,0,0,Jimmy Reece
565,593,113,1957,Mike Magill,Johnnie Parsons,0,0,0,Johnnie Parsons
565,594,113,1957,Mike Magill,Johnnie Tolan,0,0,0,Johnnie Tolan
565,596,113,1957,Mike Magill,Ed Elisian,0,0,0,Ed Elisian
565,597,113,1957,Mike Magill,Pat O'Connor,0,0,0,Pat O'Connor
565,612,113,1957,Mike Magill,Andy Linden,0,2,2,Andy Linden
565,613,113,1957,Mike Magill,Marshall Teague,0,0,0,Marshall Teague
565,614,113,1957,Mike Magill,Don Edmunds,0,0,0,Don Edmunds
565,615,113,1957,Mike Magill,Fred Agabashian,0,0,0,Fred Agabashian
565,616,113,1957,Mike Magill,Elmer George,0,0,0,Elmer George
592,593,113,1957,Jimmy Reece,Johnnie Parsons,0,0,0,Johnnie Parsons
592,594,113,1957,Jimmy Reece,Johnnie Tolan,0,0,0,Johnnie Tolan
592,596,113,1957,Jimmy Reece,Ed Elisian,0,0,0,Ed Elisian
592,597,113,1957,Jimmy Reece,Pat O'Connor,0,0,0,Pat O'Connor
592,612,113,1957,Jimmy Reece,Andy Linden,0,2,2,Andy Linden
592,613,113,1957,Jimmy Reece,Marshall Teague,0,0,0,Marshall Teague
592,614,113,1957,Jimmy Reece,Don Edmunds,0,0,0,Don Edmunds
592,615,113,1957,Jimmy Reece,Fred Agabashian,0,0,0,Fred Agabashian
592,616,113,1957,Jimmy Reece,Elmer George,0,0,0,Elmer George
593,594,113,1957,Johnnie Parsons,Johnnie Tolan,0,0,0,Johnnie Tolan
593,596,113,1957,Johnnie Parsons,Ed Elisian,0,0,0,Ed Elisian
593,597,113,1957,Johnnie Parsons,Pat O'Connor,0,0,0,Pat O'Connor
593,612,113,1957,Johnnie Parsons,Andy Linden,0,2,2,Andy Linden
593,613,113,1957,Johnnie Parsons,Marshall Teague,0,0,0,Marshall Teague
593,614,113,1957,Johnnie Parsons,Don Edmunds,0,0,0,Don Edmunds
593,615,113,1957,Johnnie Parsons,Fred Agabashian,0,0,0,Fred Agabashian
593,616,113,1957,Johnnie Parsons,Elmer George,0,0,0,Elmer George
594,596,113,1957,Johnnie Tolan,Ed Elisian,0,0,0,Ed Elisian
594,597,113,1957,Johnnie Tolan,Pat O'Connor,0,0,0,Pat O'Connor
594,612,113,1957,Johnnie Tolan,Andy Linden,0,2,2,Andy Linden
594,613,113,1957,Johnnie Tolan,Marshall Teague,0,0,0,Marshall Teague
594,614,113,1957,Johnnie Tolan,Don Edmunds,0,0,0,Don Edmunds
594,615,113,1957,Johnnie Tolan,Fred Agabashian,0,0,0,Fred Agabashian
594,616,113,1957,Johnnie Tolan,Elmer George,0,0,0,Elmer George
596,597,113,1957,Ed Elisian,Pat O'Connor,0,0,0,Pat O'Connor
596,612,113,1957,Ed Elisian,Andy Linden,0,2,2,Andy Linden
596,613,113,1957,Ed Elisian,Marshall Teague,0,0,0,Marshall Teague
596,614,113,1957,Ed Elisian,Don Edmunds,0,0,0,Don Edmunds
596,615,113,1957,Ed Elisian,Fred Agabashian,0,0,0,Fred Agabashian
596,616,113,1957,Ed Elisian,Elmer George,0,0,0,Elmer George
597,612,113,1957,Pat O'Connor,Andy Linden,0,2,2,Andy Linden
597,613,113,1957,Pat O'Connor,Marshall Teague,0,0,0,Marshall Teague
597,614,113,1957,Pat O'Connor,Don Edmunds,0,0,0,Don Edmunds
597,615,113,1957,Pat O'Connor,Fred Agabashian,0,0,0,Fred Agabashian
597,616,113,1957,Pat O'Connor,Elmer George,0,0,0,Elmer George
612,613,113,1957,Andy Linden,Marshall Teague,2,0,2,Andy Linden
612,614,113,1957,Andy Linden,Don Edmunds,2,0,2,Andy Linden
612,615,113,1957,Andy Linden,Fred Agabashian,2,0,2,Andy Linden
612,616,113,1957,Andy Linden,Elmer George,2,0,2,Andy Linden
613,614,113,1957,Marshall Teague,Don Edmunds,0,0,0,Don Edmunds
613,615,113,1957,Marshall Teague,Fred Agabashian,0,0,0,Fred Agabashian
613,616,113,1957,Marshall Teague,Elmer George,0,0,0,Elmer George
614,615,113,1957,Don Edmunds,Fred Agabashian,0,0,0,Fred Agabashian
614,616,113,1957,Don Edmunds,Elmer George,0,0,0,Elmer George
615,616,113,1957,Fred Agabashian,Elmer George,0,0,0,Elmer George
510,512,113,1958,Paul Goldsmith,Johnny Thomson,0,0,0,Johnny Thomson
510,513,113,1958,Paul Goldsmith,Eddie Johnson,0,0,0,Eddie Johnson
510,514,113,1958,Paul Goldsmith,Bob Veith,0,0,0,Bob Veith
510,516,113,1958,Paul Goldsmith,Bob Christie,0,0,0,Bob Christie
510,523,113,1958,Paul Goldsmith,Shorty Templeman,0,0,0,Shorty Templeman
510,533,113,1958,Paul Goldsmith,Johnny Boyd,0,4,4,Johnny Boyd
510,536,113,1958,Paul Goldsmith,Len Sutton,0,0,0,Len Sutton
510,555,113,1958,Paul Goldsmith,Paul Russo,0,0,0,Paul Russo
510,558,113,1958,Paul Goldsmith,Al Keller,0,0,0,Al Keller
510,560,113,1958,Paul Goldsmith,Bill Cheesbourg,0,0,0,Bill Cheesbourg
510,565,113,1958,Paul Goldsmith,Mike Magill,0,0,0,Mike Magill
510,593,113,1958,Paul Goldsmith,Johnnie Parsons,0,0,0,Johnnie Parsons
510,595,113,1958,Paul Goldsmith,Billy Garrett,0,0,0,Billy Garrett
510,597,113,1958,Paul Goldsmith,Pat O'Connor,0,0,0,Pat O'Connor
510,598,113,1958,Paul Goldsmith,Jerry Unser,0,0,0,Jerry Unser
512,513,113,1958,Johnny Thomson,Eddie Johnson,0,0,0,Eddie Johnson
512,514,113,1958,Johnny Thomson,Bob Veith,0,0,0,Bob Veith
512,516,113,1958,Johnny Thomson,Bob Christie,0,0,0,Bob Christie
512,523,113,1958,Johnny Thomson,Shorty Templeman,0,0,0,Shorty Templeman
512,533,113,1958,Johnny Thomson,Johnny Boyd,0,4,4,Johnny Boyd
512,536,113,1958,Johnny Thomson,Len Sutton,0,0,0,Len Sutton
512,555,113,1958,Johnny Thomson,Paul Russo,0,0,0,Paul Russo
512,558,113,1958,Johnny Thomson,Al Keller,0,0,0,Al Keller
512,560,113,1958,Johnny Thomson,Bill Cheesbourg,0,0,0,Bill Cheesbourg
512,565,113,1958,Johnny Thomson,Mike Magill,0,0,0,Mike Magill
512,593,113,1958,Johnny Thomson,Johnnie Parsons,0,0,0,Johnnie Parsons
512,595,113,1958,Johnny Thomson,Billy Garrett,0,0,0,Billy Garrett
512,597,113,1958,Johnny Thomson,Pat O'Connor,0,0,0,Pat O'Connor
512,598,113,1958,Johnny Thomson,Jerry Unser,0,0,0,Jerry Unser
513,514,113,1958,Eddie Johnson,Bob Veith,0,0,0,Bob Veith
513,516,113,1958,Eddie Johnson,Bob Christie,0,0,0,Bob Christie
513,523,113,1958,Eddie Johnson,Shorty Templeman,0,0,0,Shorty Templeman
513,533,113,1958,Eddie Johnson,Johnny Boyd,0,4,4,Johnny Boyd
513,536,113,1958,Eddie Johnson,Len Sutton,0,0,0,Len Sutton
513,555,113,1958,Eddie Johnson,Paul Russo,0,0,0,Paul Russo
513,558,113,1958,Eddie Johnson,Al Keller,0,0,0,Al Keller
513,560,113,1958,Eddie Johnson,Bill Cheesbourg,0,0,0,Bill Cheesbourg
513,565,113,1958,Eddie Johnson,Mike Magill,0,0,0,Mike Magill
513,593,113,1958,Eddie Johnson,Johnnie Parsons,0,0,0,Johnnie Parsons
513,595,113,1958,Eddie Johnson,Billy Garrett,0,0,0,Billy Garrett
513,597,113,1958,Eddie Johnson,Pat O'Connor,0,0,0,Pat O'Connor
513,598,113,1958,Eddie Johnson,Jerry Unser,0,0,0,Jerry Unser
514,516,113,1958,Bob Veith,Bob Christie,0,0,0,Bob Christie
514,523,113,1958,Bob Veith,Shorty Templeman,0,0,0,Shorty Templeman
514,533,113,1958,Bob Veith,Johnny Boyd,0,4,4,Johnny Boyd
514,536,113,1958,Bob Veith,Len Sutton,0,0,0,Len Sutton
514,555,113,1958,Bob Veith,Paul Russo,0,0,0,Paul Russo
514,558,113,1958,Bob Veith,Al Keller,0,0,0,Al Keller
514,560,113,1958,Bob Veith,Bill Cheesbourg,0,0,0,Bill Cheesbourg
514,565,113,1958,Bob Veith,Mike Magill,0,0,0,Mike Magill
514,593,113,1958,Bob Veith,Johnnie Parsons,0,0,0,Johnnie Parsons
514,595,113,1958,Bob Veith,Billy Garrett,0,0,0,Billy Garrett
514,597,113,1958,Bob Veith,Pat O'Connor,0,0,0,Pat O'Connor
514,598,113,1958,Bob Veith,Jerry Unser,0,0,0,Jerry Unser
516,523,113,1958,Bob Christie,Shorty Templeman,0,0,0,Shorty Templeman
516,533,113,1958,Bob Christie,Johnny Boyd,0,4,4,Johnny Boyd
516,536,113,1958,Bob Christie,Len Sutton,0,0,0,Len Sutton
516,555,113,1958,Bob Christie,Paul Russo,0,0,0,Paul Russo
516,558,113,1958,Bob Christie,Al Keller,0,0,0,Al Keller
516,560,113,1958,Bob Christie,Bill Cheesbourg,0,0,0,Bill Cheesbourg
516,565,113,1958,Bob Christie,Mike Magill,0,0,0,Mike Magill
516,593,113,1958,Bob Christie,Johnnie Parsons,0,0,0,Johnnie Parsons
516,595,113,1958,Bob Christie,Billy Garrett,0,0,0,Billy Garrett
516,597,113,1958,Bob Christie,Pat O'Connor,0,0,0,Pat O'Connor
516,598,113,1958,Bob Christie,Jerry Unser,0,0,0,Jerry Unser
523,533,113,1958,Shorty Templeman,Johnny Boyd,0,4,4,Johnny Boyd
523,536,113,1958,Shorty Templeman,Len Sutton,0,0,0,Len Sutton
523,555,113,1958,Shorty Templeman,Paul Russo,0,0,0,Paul Russo
523,558,113,1958,Shorty Templeman,Al Keller,0,0,0,Al Keller
523,560,113,1958,Shorty Templeman,Bill Cheesbourg,0,0,0,Bill Cheesbourg
523,565,113,1958,Shorty Templeman,Mike Magill,0,0,0,Mike Magill
523,593,113,1958,Shorty Templeman,Johnnie Parsons,0,0,0,Johnnie Parsons
523,595,113,1958,Shorty Templeman,Billy Garrett,0,0,0,Billy Garrett
523,597,113,1958,Shorty Templeman,Pat O'Connor,0,0,0,Pat O'Connor
523,598,113,1958,Shorty Templeman,Jerry Unser,0,0,0,Jerry Unser
533,536,113,1958,Johnny Boyd,Len Sutton,4,0,4,Johnny Boyd
533,555,113,1958,Johnny Boyd,Paul Russo,4,0,4,Johnny Boyd
533,558,113,1958,Johnny Boyd,Al Keller,4,0,4,Johnny Boyd
533,560,113,1958,Johnny Boyd,Bill Cheesbourg,4,0,4,Johnny Boyd
533,565,113,1958,Johnny Boyd,Mike Magill,4,0,4,Johnny Boyd
533,593,113,1958,Johnny Boyd,Johnnie Parsons,4,0,4,Johnny Boyd
533,595,113,1958,Johnny Boyd,Billy Garrett,4,0,4,Johnny Boyd
533,597,113,1958,Johnny Boyd,Pat O'Connor,4,0,4,Johnny Boyd
533,598,113,1958,Johnny Boyd,Jerry Unser,4,0,4,Johnny Boyd
536,555,113,1958,Len Sutton,Paul Russo,0,0,0,Paul Russo
536,558,113,1958,Len Sutton,Al Keller,0,0,0,Al Keller
536,560,113,1958,Len Sutton,Bill Cheesbourg,0,0,0,Bill Cheesbourg
536,565,113,1958,Len Sutton,Mike Magill,0,0,0,Mike Magill
536,593,113,1958,Len Sutton,Johnnie Parsons,0,0,0,Johnnie Parsons
536,595,113,1958,Len Sutton,Billy Garrett,0,0,0,Billy Garrett
536,597,113,1958,Len Sutton,Pat O'Connor,0,0,0,Pat O'Connor
536,598,113,1958,Len Sutton,Jerry Unser,0,0,0,Jerry Unser
555,558,113,1958,Paul Russo,Al Keller,0,0,0,Al Keller
555,560,113,1958,Paul Russo,Bill Cheesbourg,0,0,0,Bill Cheesbourg
555,565,113,1958,Paul Russo,Mike Magill,0,0,0,Mike Magill
555,593,113,1958,Paul Russo,Johnnie Parsons,0,0,0,Johnnie Parsons
555,595,113,1958,Paul Russo,Billy Garrett,0,0,0,Billy Garrett
555,597,113,1958,Paul Russo,Pat O'Connor,0,0,0,Pat O'Connor
555,598,113,1958,Paul Russo,Jerry Unser,0,0,0,Jerry Unser
558,560,113,1958,Al Keller,Bill Cheesbourg,0,0,0,Bill Cheesbourg
558,565,113,1958,Al Keller,Mike Magill,0,0,0,Mike Magill
558,593,113,1958,Al Keller,Johnnie Parsons,0,0,0,Johnnie Parsons
558,595,113,1958,Al Keller,Billy Garrett,0,0,0,Billy Garrett
558,597,113,1958,Al Keller,Pat O'Connor,0,0,0,Pat O'Connor
558,598,113,1958,Al Keller,Jerry Unser,0,0,0,Jerry Unser
560,565,113,1958,Bill Cheesbourg,Mike Magill,0,0,0,Mike Magill
560,593,113,1958,Bill Cheesbourg,Johnnie Parsons,0,0,0,Johnnie Parsons
560,595,113,1958,Bill Cheesbourg,Billy Garrett,0,0,0,Billy Garrett
560,597,113,1958,Bill Cheesbourg,Pat O'Connor,0,0,0,Pat O'Connor
560,598,113,1958,Bill Cheesbourg,Jerry Unser,0,0,0,Jerry Unser
565,593,113,1958,Mike Magill,Johnnie Parsons,0,0,0,Johnnie Parsons
565,595,113,1958,Mike Magill,Billy Garrett,0,0,0,Billy Garrett
565,597,113,1958,Mike Magill,Pat O'Connor,0,0,0,Pat O'Connor
565,598,113,1958,Mike Magill,Jerry Unser,0,0,0,Jerry Unser
593,595,113,1958,Johnnie Parsons,Billy Garrett,0,0,0,Billy Garrett
593,597,113,1958,Johnnie Parsons,Pat O'Connor,0,0,0,Pat O'Connor
593,598,113,1958,Johnnie Parsons,Jerry Unser,0,0,0,Jerry Unser
595,597,113,1958,Billy Garrett,Pat O'Connor,0,0,0,Pat O'Connor
595,598,113,1958,Billy Garrett,Jerry Unser,0,0,0,Jerry Unser
597,598,113,1958,Pat O'Connor,Jerry Unser,0,0,0,Jerry Unser
449,513,113,1959,Rodger Ward,Eddie Johnson,0,0,0,Eddie Johnson
449,516,113,1959,Rodger Ward,Bob Christie,0,0,0,Bob Christie
449,517,113,1959,Rodger Ward,Red Amick,0,0,0,Red Amick
449,518,113,1959,Rodger Ward,Duane Carter,0,0,0,Duane Carter
449,522,113,1959,Rodger Ward,Bobby Grim,0,0,0,Bobby Grim
449,528,113,1959,Rodger Ward,Don Freeland,0,0,0,Don Freeland
449,535,113,1959,Rodger Ward,Jim McWithey,0,0,0,Jim McWithey
449,555,113,1959,Rodger Ward,Paul Russo,0,0,0,Paul Russo
449,556,113,1959,Rodger Ward,Jimmy Daywalt,0,0,0,Jimmy Daywalt
449,557,113,1959,Rodger Ward,Chuck Arnold,0,0,0,Chuck Arnold
449,563,113,1959,Rodger Ward,Chuck Weyant,0,0,0,Chuck Weyant
449,564,113,1959,Rodger Ward,Jud Larson,0,0,0,Jud Larson
513,516,113,1959,Eddie Johnson,Bob Christie,0,0,0,Bob Christie
513,517,113,1959,Eddie Johnson,Red Amick,0,0,0,Red Amick
513,518,113,1959,Eddie Johnson,Duane Carter,0,0,0,Duane Carter
513,522,113,1959,Eddie Johnson,Bobby Grim,0,0,0,Bobby Grim
513,528,113,1959,Eddie Johnson,Don Freeland,0,0,0,Don Freeland
513,535,113,1959,Eddie Johnson,Jim McWithey,0,0,0,Jim McWithey
513,555,113,1959,Eddie Johnson,Paul Russo,0,0,0,Paul Russo
513,556,113,1959,Eddie Johnson,Jimmy Daywalt,0,0,0,Jimmy Daywalt
513,557,113,1959,Eddie Johnson,Chuck Arnold,0,0,0,Chuck Arnold
513,563,113,1959,Eddie Johnson,Chuck Weyant,0,0,0,Chuck Weyant
513,564,113,1959,Eddie Johnson,Jud Larson,0,0,0,Jud Larson
516,517,113,1959,Bob Christie,Red Amick,0,0,0,Red Amick
516,518,113,1959,Bob Christie,Duane Carter,0,0,0,Duane Carter
516,522,113,1959,Bob Christie,Bobby Grim,0,0,0,Bobby Grim
516,528,113,1959,Bob Christie,Don Freeland,0,0,0,Don Freeland
516,535,113,1959,Bob Christie,Jim McWithey,0,0,0,Jim McWithey
516,555,113,1959,Bob Christie,Paul Russo,0,0,0,Paul Russo
516,556,113,1959,Bob Christie,Jimmy Daywalt,0,0,0,Jimmy Daywalt
516,557,113,1959,Bob Christie,Chuck Arnold,0,0,0,Chuck Arnold
516,563,113,1959,Bob Christie,Chuck Weyant,0,0,0,Chuck Weyant
516,564,113,1959,Bob Christie,Jud Larson,0,0,0,Jud Larson
517,518,113,1959,Red Amick,Duane Carter,0,0,0,Duane Carter
517,522,113,1959,Red Amick,Bobby Grim,0,0,0,Bobby Grim
517,528,113,1959,Red Amick,Don Freeland,0,0,0,Don Freeland
517,535,113,1959,Red Amick,Jim McWithey,0,0,0,Jim McWithey
517,555,113,1959,Red Amick,Paul Russo,0,0,0,Paul Russo
517,556,113,1959,Red Amick,Jimmy Daywalt,0,0,0,Jimmy Daywalt
517,557,113,1959,Red Amick,Chuck Arnold,0,0,0,Chuck Arnold
517,563,113,1959,Red Amick,Chuck Weyant,0,0,0,Chuck Weyant
517,564,113,1959,Red Amick,Jud Larson,0,0,0,Jud Larson
518,522,113,1959,Duane Carter,Bobby Grim,0,0,0,Bobby Grim
518,528,113,1959,Duane Carter,Don Freeland,0,0,0,Don Freeland
518,535,113,1959,Duane Carter,Jim McWithey,0,0,0,Jim McWithey
518,555,113,1959,Duane Carter,Paul Russo,0,0,0,Paul Russo
518,556,113,1959,Duane Carter,Jimmy Daywalt,0,0,0,Jimmy Daywalt
518,557,113,1959,Duane Carter,Chuck Arnold,0,0,0,Chuck Arnold
518,563,113,1959,Duane Carter,Chuck Weyant,0,0,0,Chuck Weyant
518,564,113,1959,Duane Carter,Jud Larson,0,0,0,Jud Larson
522,528,113,1959,Bobby Grim,Don Freeland,0,0,0,Don Freeland
522,535,113,1959,Bobby Grim,Jim McWithey,0,0,0,Jim McWithey
522,555,113,1959,Bobby Grim,Paul Russo,0,0,0,Paul Russo
522,556,113,1959,Bobby Grim,Jimmy Daywalt,0,0,0,Jimmy Daywalt
522,557,113,1959,Bobby Grim,Chuck Arnold,0,0,0,Chuck Arnold
522,563,113,1959,Bobby Grim,Chuck Weyant,0,0,0,Chuck Weyant
522,564,113,1959,Bobby Grim,Jud Larson,0,0,0,Jud Larson
528,535,113,1959,Don Freeland,Jim McWithey,0,0,0,Jim McWithey
528,555,113,1959,Don Freeland,Paul Russo,0,0,0,Paul Russo
528,556,113,1959,Don Freeland,Jimmy Daywalt,0,0,0,Jimmy Daywalt
528,557,113,1959,Don Freeland,Chuck Arnold,0,0,0,Chuck Arnold
528,563,113,1959,Don Freeland,Chuck Weyant,0,0,0,Chuck Weyant
528,564,113,1959,Don Freeland,Jud Larson,0,0,0,Jud Larson
535,555,113,1959,Jim McWithey,Paul Russo,0,0,0,Paul Russo
535,556,113,1959,Jim McWithey,Jimmy Daywalt,0,0,0,Jimmy Daywalt
535,557,113,1959,Jim McWithey,Chuck Arnold,0,0,0,Chuck Arnold
535,563,113,1959,Jim McWithey,Chuck Weyant,0,0,0,Chuck Weyant
535,564,113,1959,Jim McWithey,Jud Larson,0,0,0,Jud Larson
555,556,113,1959,Paul Russo,Jimmy Daywalt,0,0,0,Jimmy Daywalt
555,557,113,1959,Paul Russo,Chuck Arnold,0,0,0,Chuck Arnold
555,563,113,1959,Paul Russo,Chuck Weyant,0,0,0,Chuck Weyant
555,564,113,1959,Paul Russo,Jud Larson,0,0,0,Jud Larson
556,557,113,1959,Jimmy Daywalt,Chuck Arnold,0,0,0,Chuck Arnold
556,563,113,1959,Jimmy Daywalt,Chuck Weyant,0,0,0,Chuck Weyant
556,564,113,1959,Jimmy Daywalt,Jud Larson,0,0,0,Jud Larson
557,563,113,1959,Chuck Arnold,Chuck Weyant,0,0,0,Chuck Weyant
557,564,113,1959,Chuck Arnold,Jud Larson,0,0,0,Jud Larson
563,564,113,1959,Chuck Weyant,Jud Larson,0,0,0,Jud Larson
516,520,113,1960,Bob Christie,Gene Hartley,0,0,0,Gene Hartley
516,523,113,1960,Bob Christie,Shorty Templeman,0,0,0,Shorty Templeman
516,528,113,1960,Bob Christie,Don Freeland,0,0,0,Don Freeland
516,531,113,1960,Bob Christie,Anthony Foyt,0,0,0,Anthony Foyt
516,532,113,1960,Bob Christie,Eddie Russo,0,0,0,Eddie Russo
516,534,113,1960,Bob Christie,Gene Force,0,0,0,Gene Force
516,539,113,1960,Bob Christie,Dempsey Wilson,0,0,0,Dempsey Wilson
520,523,113,1960,Gene Hartley,Shorty Templeman,0,0,0,Shorty Templeman
520,528,113,1960,Gene Hartley,Don Freeland,0,0,0,Don Freeland
520,531,113,1960,Gene Hartley,Anthony Foyt,0,0,0,Anthony Foyt
520,532,113,1960,Gene Hartley,Eddie Russo,0,0,0,Eddie Russo
520,534,113,1960,Gene Hartley,Gene Force,0,0,0,Gene Force
520,539,113,1960,Gene Hartley,Dempsey Wilson,0,0,0,Dempsey Wilson
523,528,113,1960,Shorty Templeman,Don Freeland,0,0,0,Don Freeland
523,531,113,1960,Shorty Templeman,Anthony Foyt,0,0,0,Anthony Foyt
523,532,113,1960,Shorty Templeman,Eddie Russo,0,0,0,Eddie Russo
523,534,113,1960,Shorty Templeman,Gene Force,0,0,0,Gene Force
523,539,113,1960,Shorty Templeman,Dempsey Wilson,0,0,0,Dempsey Wilson
528,531,113,1960,Don Freeland,Anthony Foyt,0,0,0,Anthony Foyt
528,532,113,1960,Don Freeland,Eddie Russo,0,0,0,Eddie Russo
528,534,113,1960,Don Freeland,Gene Force,0,0,0,Gene Force
528,539,113,1960,Don Freeland,Dempsey Wilson,0,0,0,Dempsey Wilson
531,532,113,1960,Anthony Foyt,Eddie Russo,0,0,0,Eddie Russo
531,534,113,1960,Anthony Foyt,Gene Force,0,0,0,Gene Force
531,539,113,1960,Anthony Foyt,Dempsey Wilson,0,0,0,Dempsey Wilson
532,534,113,1960,Eddie Russo,Gene Force,0,0,0,Gene Force
532,539,113,1960,Eddie Russo,Dempsey Wilson,0,0,0,Dempsey Wilson
534,539,113,1960,Gene Force,Dempsey Wilson,0,0,0,Dempsey Wilson
520,521,114,1953,Gene Hartley,Chuck Stevenson,0,0,0,Chuck Stevenson
520,529,114,1953,Gene Hartley,Tony Bettenhausen,0,0,0,Tony Bettenhausen
520,559,114,1953,Gene Hartley,Pat Flaherty,0,0,0,Pat Flaherty
520,628,114,1953,Gene Hartley,Bob Sweikert,0,0,0,Bob Sweikert
520,675,114,1953,Gene Hartley,Manny Ayulo,0,0,0,Manny Ayulo
521,529,114,1953,Chuck Stevenson,Tony Bettenhausen,0,0,0,Tony Bettenhausen
521,559,114,1953,Chuck Stevenson,Pat Flaherty,0,0,0,Pat Flaherty
521,628,114,1953,Chuck Stevenson,Bob Sweikert,0,0,0,Bob Sweikert
521,675,114,1953,Chuck Stevenson,Manny Ayulo,0,0,0,Manny Ayulo
529,559,114,1953,Tony Bettenhausen,Pat Flaherty,0,0,0,Pat Flaherty
529,628,114,1953,Tony Bettenhausen,Bob Sweikert,0,0,0,Bob Sweikert
529,675,114,1953,Tony Bettenhausen,Manny Ayulo,0,0,0,Manny Ayulo
559,628,114,1953,Pat Flaherty,Bob Sweikert,0,0,0,Bob Sweikert
559,675,114,1953,Pat Flaherty,Manny Ayulo,0,0,0,Manny Ayulo
628,675,114,1953,Bob Sweikert,Manny Ayulo,0,0,0,Manny Ayulo
521,525,114,1954,Chuck Stevenson,Jimmy Bryan,0,6,6,Jimmy Bryan
521,654,114,1954,Chuck Stevenson,Walt Faulkner,0,0,0,Walt Faulkner
521,675,114,1954,Chuck Stevenson,Manny Ayulo,0,0,0,Manny Ayulo
525,654,114,1954,Jimmy Bryan,Walt Faulkner,6,0,6,Jimmy Bryan
525,675,114,1954,Jimmy Bryan,Manny Ayulo,6,0,6,Jimmy Bryan
654,675,114,1954,Walt Faulkner,Manny Ayulo,0,0,0,Manny Ayulo
449,512,114,1955,Rodger Ward,Johnny Thomson,0,3,3,Johnny Thomson
449,518,114,1955,Rodger Ward,Duane Carter,0,0,0,Duane Carter
449,525,114,1955,Rodger Ward,Jimmy Bryan,0,0,0,Jimmy Bryan
512,518,114,1955,Johnny Thomson,Duane Carter,3,0,3,Johnny Thomson
512,525,114,1955,Johnny Thomson,Jimmy Bryan,3,0,3,Johnny Thomson
518,525,114,1955,Duane Carter,Jimmy Bryan,0,0,0,Jimmy Bryan
512,513,114,1956,Johnny Thomson,Eddie Johnson,0,0,0,Eddie Johnson
512,520,114,1956,Johnny Thomson,Gene Hartley,0,0,0,Gene Hartley
512,525,114,1956,Johnny Thomson,Jimmy Bryan,0,0,0,Jimmy Bryan
512,595,114,1956,Johnny Thomson,Billy Garrett,0,0,0,Billy Garrett
512,628,114,1956,Johnny Thomson,Bob Sweikert,0,0,0,Bob Sweikert
513,520,114,1956,Eddie Johnson,Gene Hartley,0,0,0,Gene Hartley
513,525,114,1956,Eddie Johnson,Jimmy Bryan,0,0,0,Jimmy Bryan
513,595,114,1956,Eddie Johnson,Billy Garrett,0,0,0,Billy Garrett
513,628,114,1956,Eddie Johnson,Bob Sweikert,0,0,0,Bob Sweikert
520,525,114,1956,Gene Hartley,Jimmy Bryan,0,0,0,Jimmy Bryan
520,595,114,1956,Gene Hartley,Billy Garrett,0,0,0,Billy Garrett
520,628,114,1956,Gene Hartley,Bob Sweikert,0,0,0,Bob Sweikert
525,595,114,1956,Jimmy Bryan,Billy Garrett,0,0,0,Billy Garrett
525,628,114,1956,Jimmy Bryan,Bob Sweikert,0,0,0,Bob Sweikert
595,628,114,1956,Billy Garrett,Bob Sweikert,0,0,0,Bob Sweikert
512,525,114,1957,Johnny Thomson,Jimmy Bryan,0,4,4,Jimmy Bryan
512,527,114,1957,Johnny Thomson,Eddie Sachs,0,0,0,Eddie Sachs
512,563,114,1957,Johnny Thomson,Chuck Weyant,0,0,0,Chuck Weyant
525,527,114,1957,Jimmy Bryan,Eddie Sachs,4,0,4,Jimmy Bryan
525,563,114,1957,Jimmy Bryan,Chuck Weyant,4,0,4,Jimmy Bryan
527,563,114,1957,Eddie Sachs,Chuck Weyant,0,0,0,Chuck Weyant
527,531,114,1958,Eddie Sachs,Anthony Foyt,0,0,0,Anthony Foyt
527,539,114,1958,Eddie Sachs,Dempsey Wilson,0,0,0,Dempsey Wilson
527,594,114,1958,Eddie Sachs,Johnnie Tolan,0,0,0,Johnnie Tolan
527,599,114,1958,Eddie Sachs,Art Bisch,0,0,0,Art Bisch
531,539,114,1958,Anthony Foyt,Dempsey Wilson,0,0,0,Dempsey Wilson
531,594,114,1958,Anthony Foyt,Johnnie Tolan,0,0,0,Johnnie Tolan
531,599,114,1958,Anthony Foyt,Art Bisch,0,0,0,Art Bisch
539,594,114,1958,Dempsey Wilson,Johnnie Tolan,0,0,0,Johnnie Tolan
539,599,114,1958,Dempsey Wilson,Art Bisch,0,0,0,Art Bisch
594,599,114,1958,Johnnie Tolan,Art Bisch,0,0,0,Art Bisch
520,527,114,1959,Gene Hartley,Eddie Sachs,0,0,0,Eddie Sachs
520,531,114,1959,Gene Hartley,Anthony Foyt,0,0,0,Anthony Foyt
520,558,114,1959,Gene Hartley,Al Keller,0,0,0,Al Keller
520,560,114,1959,Gene Hartley,Bill Cheesbourg,0,0,0,Bill Cheesbourg
527,531,114,1959,Eddie Sachs,Anthony Foyt,0,0,0,Anthony Foyt
527,558,114,1959,Eddie Sachs,Al Keller,0,0,0,Al Keller
527,560,114,1959,Eddie Sachs,Bill Cheesbourg,0,0,0,Bill Cheesbourg
531,558,114,1959,Anthony Foyt,Al Keller,0,0,0,Al Keller
531,560,114,1959,Anthony Foyt,Bill Cheesbourg,0,0,0,Bill Cheesbourg
558,560,114,1959,Al Keller,Bill Cheesbourg,0,0,0,Bill Cheesbourg
518,519,114,1960,Duane Carter,Bill Homeier,0,0,0,Bill Homeier
527,538,116,1960,Eddie Sachs,Al Herman,0,0,0,Al Herman
456,566,117,1959,Roy Salvadori,Carroll Shelby,0,0,0,Carroll Shelby
427,456,117,1960,Maurice Trintignant,Roy Salvadori,0,0,0,Roy Salvadori
20,840,117,2021,Sebastian Vettel,Lance Stroll,43,34,9,Sebastian Vettel
20,807,117,2022,Sebastian Vettel,Nico HÃ¼lkenberg,37,0,37,Sebastian Vettel
20,840,117,2022,Sebastian Vettel,Lance Stroll,37,18,19,Sebastian Vettel
807,840,117,2022,Nico HÃ¼lkenberg,Lance Stroll,0,18,18,Lance Stroll
4,840,117,2023,Fernando Alonso,Lance Stroll,198,68,130,Fernando Alonso
4,840,117,2024,Fernando Alonso,Lance Stroll,45,23,22,Fernando Alonso
501,578,118,1955,Harry Schell,Mike Hawthorn,0,0,0,Mike Hawthorn
501,663,118,1955,Harry Schell,Ken Wharton,0,0,0,Ken Wharton
578,663,118,1955,Mike Hawthorn,Ken Wharton,0,0,0,Ken Wharton
427,498,118,1956,Maurice Trintignant,JosÃ© FroilÃ¡n GonzÃ¡lez,0,0,0,JosÃ© FroilÃ¡n GonzÃ¡lez
427,501,118,1956,Maurice Trintignant,Harry Schell,0,3,3,Harry Schell
427,578,118,1956,Maurice Trintignant,Mike Hawthorn,0,0,0,Mike Hawthorn
427,635,118,1956,Maurice Trintignant,Colin Chapman,0,0,0,Colin Chapman
427,641,118,1956,Maurice Trintignant,Piero Taruffi,0,0,0,Piero Taruffi
498,501,118,1956,JosÃ© FroilÃ¡n GonzÃ¡lez,Harry Schell,0,3,3,Harry Schell
498,578,118,1956,JosÃ© FroilÃ¡n GonzÃ¡lez,Mike Hawthorn,0,0,0,Mike Hawthorn
498,635,118,1956,JosÃ© FroilÃ¡n GonzÃ¡lez,Colin Chapman,0,0,0,Colin Chapman
498,641,118,1956,JosÃ© FroilÃ¡n GonzÃ¡lez,Piero Taruffi,0,0,0,Piero Taruffi
501,578,118,1956,Harry Schell,Mike Hawthorn,3,0,3,Harry Schell
501,635,118,1956,Harry Schell,Colin Chapman,3,0,3,Harry Schell
501,641,118,1956,Harry Schell,Piero Taruffi,3,0,3,Harry Schell
578,635,118,1956,Mike Hawthorn,Colin Chapman,0,0,0,Colin Chapman
578,641,118,1956,Mike Hawthorn,Piero Taruffi,0,0,0,Piero Taruffi
635,641,118,1956,Colin Chapman,Piero Taruffi,0,0,0,Piero Taruffi
456,475,118,1957,Roy Salvadori,Stirling Moss,0,24,24,Stirling Moss
456,479,118,1957,Roy Salvadori,Tony Brooks,0,11,11,Tony Brooks
456,590,118,1957,Roy Salvadori,Stuart Lewis-Evans,0,2,2,Stuart Lewis-Evans
475,479,118,1957,Stirling Moss,Tony Brooks,24,11,13,Stirling Moss
475,590,118,1957,Stirling Moss,Stuart Lewis-Evans,24,2,22,Stirling Moss
479,590,118,1957,Tony Brooks,Stuart Lewis-Evans,11,2,9,Tony Brooks
475,479,118,1958,Stirling Moss,Tony Brooks,33,24,9,Stirling Moss
475,590,118,1958,Stirling Moss,Stuart Lewis-Evans,33,11,22,Stirling Moss
479,590,118,1958,Tony Brooks,Stuart Lewis-Evans,24,11,13,Tony Brooks
16,27,12,2007,Adrian Sutil,Christijan Albers,1,0,1,Adrian Sutil
16,28,12,2007,Adrian Sutil,Markus Winkelhock,1,0,1,Adrian Sutil
16,29,12,2007,Adrian Sutil,Sakon Yamamoto,1,0,1,Adrian Sutil
27,28,12,2007,Christijan Albers,Markus Winkelhock,0,0,0,Markus Winkelhock
27,29,12,2007,Christijan Albers,Sakon Yamamoto,0,0,0,Sakon Yamamoto
28,29,12,2007,Markus Winkelhock,Sakon Yamamoto,0,0,0,Sakon Yamamoto
475,664,125,1952,Stirling Moss,Kenneth McAlpine,0,0,0,Kenneth McAlpine
475,742,125,1952,Stirling Moss,Dennis Poore,0,3,3,Dennis Poore
475,743,125,1952,Stirling Moss,Eric Thompson,0,2,2,Eric Thompson
475,744,125,1952,Stirling Moss,Ken Downing,0,0,0,Ken Downing
664,742,125,1952,Kenneth McAlpine,Dennis Poore,0,3,3,Dennis Poore
664,743,125,1952,Kenneth McAlpine,Eric Thompson,0,2,2,Eric Thompson
664,744,125,1952,Kenneth McAlpine,Ken Downing,0,0,0,Ken Downing
742,743,125,1952,Dennis Poore,Eric Thompson,3,2,1,Dennis Poore
742,744,125,1952,Dennis Poore,Ken Downing,3,0,3,Dennis Poore
743,744,125,1952,Eric Thompson,Ken Downing,2,0,2,Eric Thompson
429,456,125,1953,AndrÃ© Pilette,Roy Salvadori,0,0,0,Roy Salvadori
429,475,125,1953,AndrÃ© Pilette,Stirling Moss,0,0,0,Stirling Moss
429,486,125,1953,AndrÃ© Pilette,Jack Fairman,0,0,0,Jack Fairman
429,660,125,1953,AndrÃ© Pilette,Johnny Claes,0,0,0,Johnny Claes
429,664,125,1953,AndrÃ© Pilette,Kenneth McAlpine,0,0,0,Kenneth McAlpine
429,666,125,1953,AndrÃ© Pilette,Tony Rolt,0,0,0,Tony Rolt
429,669,125,1953,AndrÃ© Pilette,Prince Bira,0,0,0,Prince Bira
429,707,125,1953,AndrÃ© Pilette,Ian Stewart,0,0,0,Ian Stewart
456,475,125,1953,Roy Salvadori,Stirling Moss,0,0,0,Stirling Moss
456,486,125,1953,Roy Salvadori,Jack Fairman,0,0,0,Jack Fairman
456,660,125,1953,Roy Salvadori,Johnny Claes,0,0,0,Johnny Claes
456,664,125,1953,Roy Salvadori,Kenneth McAlpine,0,0,0,Kenneth McAlpine
456,666,125,1953,Roy Salvadori,Tony Rolt,0,0,0,Tony Rolt
456,669,125,1953,Roy Salvadori,Prince Bira,0,0,0,Prince Bira
456,707,125,1953,Roy Salvadori,Ian Stewart,0,0,0,Ian Stewart
475,486,125,1953,Stirling Moss,Jack Fairman,0,0,0,Jack Fairman
475,660,125,1953,Stirling Moss,Johnny Claes,0,0,0,Johnny Claes
475,664,125,1953,Stirling Moss,Kenneth McAlpine,0,0,0,Kenneth McAlpine
475,666,125,1953,Stirling Moss,Tony Rolt,0,0,0,Tony Rolt
475,669,125,1953,Stirling Moss,Prince Bira,0,0,0,Prince Bira
475,707,125,1953,Stirling Moss,Ian Stewart,0,0,0,Ian Stewart
486,660,125,1953,Jack Fairman,Johnny Claes,0,0,0,Johnny Claes
486,664,125,1953,Jack Fairman,Kenneth McAlpine,0,0,0,Kenneth McAlpine
486,666,125,1953,Jack Fairman,Tony Rolt,0,0,0,Tony Rolt
486,669,125,1953,Jack Fairman,Prince Bira,0,0,0,Prince Bira
486,707,125,1953,Jack Fairman,Ian Stewart,0,0,0,Ian Stewart
660,664,125,1953,Johnny Claes,Kenneth McAlpine,0,0,0,Kenneth McAlpine
660,666,125,1953,Johnny Claes,Tony Rolt,0,0,0,Tony Rolt
660,669,125,1953,Johnny Claes,Prince Bira,0,0,0,Prince Bira
660,707,125,1953,Johnny Claes,Ian Stewart,0,0,0,Ian Stewart
664,666,125,1953,Kenneth McAlpine,Tony Rolt,0,0,0,Tony Rolt
664,669,125,1953,Kenneth McAlpine,Prince Bira,0,0,0,Prince Bira
664,707,125,1953,Kenneth McAlpine,Ian Stewart,0,0,0,Ian Stewart
666,669,125,1953,Tony Rolt,Prince Bira,0,0,0,Prince Bira
666,707,125,1953,Tony Rolt,Ian Stewart,0,0,0,Ian Stewart
669,707,125,1953,Prince Bira,Ian Stewart,0,0,0,Ian Stewart
665,682,125,1954,Leslie Marr,Don Beauman,0,0,0,Don Beauman
665,683,125,1954,Leslie Marr,Leslie Thorne,0,0,0,Leslie Thorne
665,684,125,1954,Leslie Marr,Bill Whitehouse,0,0,0,Bill Whitehouse
665,685,125,1954,Leslie Marr,John Riseley-Prichard,0,0,0,John Riseley-Prichard
682,683,125,1954,Don Beauman,Leslie Thorne,0,0,0,Leslie Thorne
682,684,125,1954,Don Beauman,Bill Whitehouse,0,0,0,Bill Whitehouse
682,685,125,1954,Don Beauman,John Riseley-Prichard,0,0,0,John Riseley-Prichard
683,684,125,1954,Leslie Thorne,Bill Whitehouse,0,0,0,Bill Whitehouse
683,685,125,1954,Leslie Thorne,John Riseley-Prichard,0,0,0,John Riseley-Prichard
684,685,125,1954,Bill Whitehouse,John Riseley-Prichard,0,0,0,John Riseley-Prichard
486,661,125,1955,Jack Fairman,Peter Walker,0,0,0,Peter Walker
486,664,125,1955,Jack Fairman,Kenneth McAlpine,0,0,0,Kenneth McAlpine
486,665,125,1955,Jack Fairman,Leslie Marr,0,0,0,Leslie Marr
486,666,125,1955,Jack Fairman,Tony Rolt,0,0,0,Tony Rolt
661,664,125,1955,Peter Walker,Kenneth McAlpine,0,0,0,Kenneth McAlpine
661,665,125,1955,Peter Walker,Leslie Marr,0,0,0,Leslie Marr
661,666,125,1955,Peter Walker,Tony Rolt,0,0,0,Tony Rolt
664,665,125,1955,Kenneth McAlpine,Leslie Marr,0,0,0,Leslie Marr
664,666,125,1955,Kenneth McAlpine,Tony Rolt,0,0,0,Tony Rolt
665,666,125,1955,Leslie Marr,Tony Rolt,0,0,0,Tony Rolt
486,541,125,1956,Jack Fairman,Ron Flockhart,5,4,1,Jack Fairman
486,610,125,1956,Jack Fairman,Les Leston,5,0,5,Jack Fairman
486,634,125,1956,Jack Fairman,Piero Scotti,5,0,5,Jack Fairman
486,636,125,1956,Jack Fairman,Desmond Titterington,5,0,5,Jack Fairman
486,637,125,1956,Jack Fairman,Archie Scott Brown,5,0,5,Jack Fairman
541,610,125,1956,Ron Flockhart,Les Leston,4,0,4,Ron Flockhart
541,634,125,1956,Ron Flockhart,Piero Scotti,4,0,4,Ron Flockhart
541,636,125,1956,Ron Flockhart,Desmond Titterington,4,0,4,Ron Flockhart
541,637,125,1956,Ron Flockhart,Archie Scott Brown,4,0,4,Ron Flockhart
610,634,125,1956,Les Leston,Piero Scotti,0,0,0,Piero Scotti
610,636,125,1956,Les Leston,Desmond Titterington,0,0,0,Desmond Titterington
610,637,125,1956,Les Leston,Archie Scott Brown,0,0,0,Archie Scott Brown
634,636,125,1956,Piero Scotti,Desmond Titterington,0,0,0,Desmond Titterington
634,637,125,1956,Piero Scotti,Archie Scott Brown,0,0,0,Archie Scott Brown
636,637,125,1956,Desmond Titterington,Archie Scott Brown,0,0,0,Archie Scott Brown
549,590,125,1957,Ivor Bueb,Stuart Lewis-Evans,0,3,3,Stuart Lewis-Evans
486,549,125,1958,Jack Fairman,Ivor Bueb,0,0,0,Ivor Bueb
486,584,125,1958,Jack Fairman,Bruce Kessler,0,0,0,Bruce Kessler
486,585,125,1958,Jack Fairman,Paul Emery,0,0,0,Paul Emery
486,587,125,1958,Jack Fairman,Bernie Ecclestone,0,0,0,Bernie Ecclestone
549,584,125,1958,Ivor Bueb,Bruce Kessler,0,0,0,Bruce Kessler
549,585,125,1958,Ivor Bueb,Paul Emery,0,0,0,Paul Emery
549,587,125,1958,Ivor Bueb,Bernie Ecclestone,0,0,0,Bernie Ecclestone
584,585,125,1958,Bruce Kessler,Paul Emery,0,0,0,Paul Emery
584,587,125,1958,Bruce Kessler,Bernie Ecclestone,0,0,0,Bernie Ecclestone
585,587,125,1958,Paul Emery,Bernie Ecclestone,0,0,0,Bernie Ecclestone
776,785,126,1950,Joe Kelly,Geoff Crossley,0,0,0,Geoff Crossley
687,745,126,1952,Peter Whitehead,Graham Whitehead,0,0,0,Graham Whitehead
589,625,127,1953,Louis Chiron,Ã‰lie Bayol,0,0,0,Ã‰lie Bayol
543,586,127,1958,Giulio Cabianca,Luigi Piotti,0,0,0,Luigi Piotti
427,554,128,1952,Maurice Trintignant,Jean Behra,0,6,6,Jean Behra
427,626,128,1952,Maurice Trintignant,Robert Manzon,0,9,9,Robert Manzon
427,660,128,1952,Maurice Trintignant,Johnny Claes,0,0,0,Johnny Claes
427,669,128,1952,Maurice Trintignant,Prince Bira,0,0,0,Prince Bira
554,626,128,1952,Jean Behra,Robert Manzon,6,9,3,Robert Manzon
554,660,128,1952,Jean Behra,Johnny Claes,6,0,6,Jean Behra
554,669,128,1952,Jean Behra,Prince Bira,6,0,6,Jean Behra
626,660,128,1952,Robert Manzon,Johnny Claes,9,0,9,Robert Manzon
626,669,128,1952,Robert Manzon,Prince Bira,9,0,9,Robert Manzon
660,669,128,1952,Johnny Claes,Prince Bira,0,0,0,Prince Bira
427,496,128,1953,Maurice Trintignant,Carlos Menditeguy,4,0,4,Maurice Trintignant
427,501,128,1953,Maurice Trintignant,Harry Schell,4,0,4,Maurice Trintignant
427,554,128,1953,Maurice Trintignant,Jean Behra,4,0,4,Maurice Trintignant
427,626,128,1953,Maurice Trintignant,Robert Manzon,4,0,4,Maurice Trintignant
427,643,128,1953,Maurice Trintignant,Roberto Mieres,4,0,4,Maurice Trintignant
427,693,128,1953,Maurice Trintignant,Fred Wacker,4,0,4,Maurice Trintignant
496,501,128,1953,Carlos Menditeguy,Harry Schell,0,0,0,Harry Schell
496,554,128,1953,Carlos Menditeguy,Jean Behra,0,0,0,Jean Behra
496,626,128,1953,Carlos Menditeguy,Robert Manzon,0,0,0,Robert Manzon
496,643,128,1953,Carlos Menditeguy,Roberto Mieres,0,0,0,Roberto Mieres
496,693,128,1953,Carlos Menditeguy,Fred Wacker,0,0,0,Fred Wacker
501,554,128,1953,Harry Schell,Jean Behra,0,0,0,Jean Behra
501,626,128,1953,Harry Schell,Robert Manzon,0,0,0,Robert Manzon
501,643,128,1953,Harry Schell,Roberto Mieres,0,0,0,Roberto Mieres
501,693,128,1953,Harry Schell,Fred Wacker,0,0,0,Fred Wacker
554,626,128,1953,Jean Behra,Robert Manzon,0,0,0,Robert Manzon
554,643,128,1953,Jean Behra,Roberto Mieres,0,0,0,Roberto Mieres
554,693,128,1953,Jean Behra,Fred Wacker,0,0,0,Fred Wacker
626,643,128,1953,Robert Manzon,Roberto Mieres,0,0,0,Roberto Mieres
626,693,128,1953,Robert Manzon,Fred Wacker,0,0,0,Fred Wacker
643,693,128,1953,Roberto Mieres,Fred Wacker,0,0,0,Fred Wacker
429,554,128,1954,AndrÃ© Pilette,Jean Behra,2,0,2,AndrÃ© Pilette
429,625,128,1954,AndrÃ© Pilette,Ã‰lie Bayol,2,2,0,Ã‰lie Bayol
429,632,128,1954,AndrÃ© Pilette,Paul FrÃ¨re,2,0,2,AndrÃ© Pilette
429,645,128,1954,AndrÃ© Pilette,Clemar Bucci,2,0,2,AndrÃ© Pilette
429,650,128,1954,AndrÃ© Pilette,Jacques Pollet,2,0,2,AndrÃ© Pilette
429,671,128,1954,AndrÃ© Pilette,Roger Loyer,2,0,2,AndrÃ© Pilette
429,681,128,1954,AndrÃ© Pilette,Georges Berger,2,0,2,AndrÃ© Pilette
429,693,128,1954,AndrÃ© Pilette,Fred Wacker,2,0,2,AndrÃ© Pilette
554,625,128,1954,Jean Behra,Ã‰lie Bayol,0,2,2,Ã‰lie Bayol
554,632,128,1954,Jean Behra,Paul FrÃ¨re,0,0,0,Paul FrÃ¨re
554,645,128,1954,Jean Behra,Clemar Bucci,0,0,0,Clemar Bucci
554,650,128,1954,Jean Behra,Jacques Pollet,0,0,0,Jacques Pollet
554,671,128,1954,Jean Behra,Roger Loyer,0,0,0,Roger Loyer
554,681,128,1954,Jean Behra,Georges Berger,0,0,0,Georges Berger
554,693,128,1954,Jean Behra,Fred Wacker,0,0,0,Fred Wacker
625,632,128,1954,Ã‰lie Bayol,Paul FrÃ¨re,2,0,2,Ã‰lie Bayol
625,645,128,1954,Ã‰lie Bayol,Clemar Bucci,2,0,2,Ã‰lie Bayol
625,650,128,1954,Ã‰lie Bayol,Jacques Pollet,2,0,2,Ã‰lie Bayol
625,671,128,1954,Ã‰lie Bayol,Roger Loyer,2,0,2,Ã‰lie Bayol
625,681,128,1954,Ã‰lie Bayol,Georges Berger,2,0,2,Ã‰lie Bayol
625,693,128,1954,Ã‰lie Bayol,Fred Wacker,2,0,2,Ã‰lie Bayol
632,645,128,1954,Paul FrÃ¨re,Clemar Bucci,0,0,0,Clemar Bucci
632,650,128,1954,Paul FrÃ¨re,Jacques Pollet,0,0,0,Jacques Pollet
632,671,128,1954,Paul FrÃ¨re,Roger Loyer,0,0,0,Roger Loyer
632,681,128,1954,Paul FrÃ¨re,Georges Berger,0,0,0,Georges Berger
632,693,128,1954,Paul FrÃ¨re,Fred Wacker,0,0,0,Fred Wacker
645,650,128,1954,Clemar Bucci,Jacques Pollet,0,0,0,Jacques Pollet
645,671,128,1954,Clemar Bucci,Roger Loyer,0,0,0,Roger Loyer
645,681,128,1954,Clemar Bucci,Georges Berger,0,0,0,Georges Berger
645,693,128,1954,Clemar Bucci,Fred Wacker,0,0,0,Fred Wacker
650,671,128,1954,Jacques Pollet,Roger Loyer,0,0,0,Roger Loyer
650,681,128,1954,Jacques Pollet,Georges Berger,0,0,0,Georges Berger
650,693,128,1954,Jacques Pollet,Fred Wacker,0,0,0,Fred Wacker
671,681,128,1954,Roger Loyer,Georges Berger,0,0,0,Georges Berger
671,693,128,1954,Roger Loyer,Fred Wacker,0,0,0,Fred Wacker
681,693,128,1954,Georges Berger,Fred Wacker,0,0,0,Fred Wacker
624,625,128,1955,Hernando da Silva Ramos,Ã‰lie Bayol,0,0,0,Ã‰lie Bayol
624,626,128,1955,Hernando da Silva Ramos,Robert Manzon,0,0,0,Robert Manzon
624,646,128,1955,Hernando da Silva Ramos,JesÃºs Iglesias,0,0,0,JesÃºs Iglesias
624,649,128,1955,Hernando da Silva Ramos,Pablo Birger,0,0,0,Pablo Birger
624,650,128,1955,Hernando da Silva Ramos,Jacques Pollet,0,0,0,Jacques Pollet
624,662,128,1955,Hernando da Silva Ramos,Mike Sparken,0,0,0,Mike Sparken
624,668,128,1955,Hernando da Silva Ramos,Jean Lucas,0,0,0,Jean Lucas
625,626,128,1955,Ã‰lie Bayol,Robert Manzon,0,0,0,Robert Manzon
625,646,128,1955,Ã‰lie Bayol,JesÃºs Iglesias,0,0,0,JesÃºs Iglesias
625,649,128,1955,Ã‰lie Bayol,Pablo Birger,0,0,0,Pablo Birger
625,650,128,1955,Ã‰lie Bayol,Jacques Pollet,0,0,0,Jacques Pollet
625,662,128,1955,Ã‰lie Bayol,Mike Sparken,0,0,0,Mike Sparken
625,668,128,1955,Ã‰lie Bayol,Jean Lucas,0,0,0,Jean Lucas
626,646,128,1955,Robert Manzon,JesÃºs Iglesias,0,0,0,JesÃºs Iglesias
626,649,128,1955,Robert Manzon,Pablo Birger,0,0,0,Pablo Birger
626,650,128,1955,Robert Manzon,Jacques Pollet,0,0,0,Jacques Pollet
626,662,128,1955,Robert Manzon,Mike Sparken,0,0,0,Mike Sparken
626,668,128,1955,Robert Manzon,Jean Lucas,0,0,0,Jean Lucas
646,649,128,1955,JesÃºs Iglesias,Pablo Birger,0,0,0,Pablo Birger
646,650,128,1955,JesÃºs Iglesias,Jacques Pollet,0,0,0,Jacques Pollet
646,662,128,1955,JesÃºs Iglesias,Mike Sparken,0,0,0,Mike Sparken
646,668,128,1955,JesÃºs Iglesias,Jean Lucas,0,0,0,Jean Lucas
649,650,128,1955,Pablo Birger,Jacques Pollet,0,0,0,Jacques Pollet
649,662,128,1955,Pablo Birger,Mike Sparken,0,0,0,Mike Sparken
649,668,128,1955,Pablo Birger,Jean Lucas,0,0,0,Jean Lucas
650,662,128,1955,Jacques Pollet,Mike Sparken,0,0,0,Mike Sparken
650,668,128,1955,Jacques Pollet,Jean Lucas,0,0,0,Jean Lucas
662,668,128,1955,Mike Sparken,Jean Lucas,0,0,0,Jean Lucas
429,609,128,1956,AndrÃ© Pilette,AndrÃ© Simon,0,0,0,AndrÃ© Simon
429,624,128,1956,AndrÃ© Pilette,Hernando da Silva Ramos,0,2,2,Hernando da Silva Ramos
429,625,128,1956,AndrÃ© Pilette,Ã‰lie Bayol,0,0,0,Ã‰lie Bayol
429,626,128,1956,AndrÃ© Pilette,Robert Manzon,0,0,0,Robert Manzon
429,639,128,1956,AndrÃ© Pilette,AndrÃ© Milhoux,0,0,0,AndrÃ© Milhoux
609,624,128,1956,AndrÃ© Simon,Hernando da Silva Ramos,0,2,2,Hernando da Silva Ramos
609,625,128,1956,AndrÃ© Simon,Ã‰lie Bayol,0,0,0,Ã‰lie Bayol
609,626,128,1956,AndrÃ© Simon,Robert Manzon,0,0,0,Robert Manzon
609,639,128,1956,AndrÃ© Simon,AndrÃ© Milhoux,0,0,0,AndrÃ© Milhoux
624,625,128,1956,Hernando da Silva Ramos,Ã‰lie Bayol,2,0,2,Hernando da Silva Ramos
624,626,128,1956,Hernando da Silva Ramos,Robert Manzon,2,0,2,Hernando da Silva Ramos
624,639,128,1956,Hernando da Silva Ramos,AndrÃ© Milhoux,2,0,2,Hernando da Silva Ramos
625,626,128,1956,Ã‰lie Bayol,Robert Manzon,0,0,0,Robert Manzon
625,639,128,1956,Ã‰lie Bayol,AndrÃ© Milhoux,0,0,0,AndrÃ© Milhoux
626,639,128,1956,Robert Manzon,AndrÃ© Milhoux,0,0,0,AndrÃ© Milhoux
729,734,129,1952,Bill Schindler,Bobby Ball,0,0,0,Bobby Ball
612,679,129,1953,Andy Linden,Ernie McCoy,0,0,0,Ernie McCoy
596,655,129,1954,Ed Elisian,Cal Niday,0,0,0,Cal Niday
596,702,129,1954,Ed Elisian,Bob Scott,0,0,0,Bob Scott
655,702,129,1954,Cal Niday,Bob Scott,0,0,0,Bob Scott
27,33,13,2006,Christijan Albers,Tiago Monteiro,0,0,0,Tiago Monteiro
478,579,131,1954,Hans Herrmann,Juan Fangio,8,40,32,Juan Fangio
478,648,131,1954,Hans Herrmann,Karl Kling,8,12,4,Karl Kling
478,691,131,1954,Hans Herrmann,Hermann Lang,8,0,8,Hans Herrmann
579,648,131,1954,Juan Fangio,Karl Kling,40,12,28,Juan Fangio
579,691,131,1954,Juan Fangio,Hermann Lang,40,0,40,Juan Fangio
648,691,131,1954,Karl Kling,Hermann Lang,12,0,12,Karl Kling
475,478,131,1955,Stirling Moss,Hans Herrmann,23,1,22,Stirling Moss
475,579,131,1955,Stirling Moss,Juan Fangio,23,41,18,Juan Fangio
475,609,131,1955,Stirling Moss,AndrÃ© Simon,23,0,23,Stirling Moss
475,641,131,1955,Stirling Moss,Piero Taruffi,23,9,14,Stirling Moss
475,648,131,1955,Stirling Moss,Karl Kling,23,5,18,Stirling Moss
478,579,131,1955,Hans Herrmann,Juan Fangio,1,41,40,Juan Fangio
478,609,131,1955,Hans Herrmann,AndrÃ© Simon,1,0,1,Hans Herrmann
478,641,131,1955,Hans Herrmann,Piero Taruffi,1,9,8,Piero Taruffi
478,648,131,1955,Hans Herrmann,Karl Kling,1,5,4,Karl Kling
579,609,131,1955,Juan Fangio,AndrÃ© Simon,41,0,41,Juan Fangio
579,641,131,1955,Juan Fangio,Piero Taruffi,41,9,32,Juan Fangio
579,648,131,1955,Juan Fangio,Karl Kling,41,5,36,Juan Fangio
609,641,131,1955,AndrÃ© Simon,Piero Taruffi,0,9,9,Piero Taruffi
609,648,131,1955,AndrÃ© Simon,Karl Kling,0,5,5,Karl Kling
641,648,131,1955,Piero Taruffi,Karl Kling,9,5,4,Piero Taruffi
3,30,131,2010,Nico Rosberg,Michael Schumacher,142,72,70,Nico Rosberg
3,30,131,2011,Nico Rosberg,Michael Schumacher,89,76,13,Nico Rosberg
3,30,131,2012,Nico Rosberg,Michael Schumacher,93,49,44,Nico Rosberg
1,3,131,2013,Lewis Hamilton,Nico Rosberg,189,171,18,Lewis Hamilton
1,3,131,2014,Lewis Hamilton,Nico Rosberg,384,317,67,Lewis Hamilton
1,3,131,2015,Lewis Hamilton,Nico Rosberg,381,322,59,Lewis Hamilton
1,3,131,2016,Lewis Hamilton,Nico Rosberg,380,385,5,Nico Rosberg
1,822,131,2017,Lewis Hamilton,Valtteri Bottas,363,305,58,Lewis Hamilton
1,822,131,2018,Lewis Hamilton,Valtteri Bottas,408,247,161,Lewis Hamilton
1,822,131,2019,Lewis Hamilton,Valtteri Bottas,413,326,87,Lewis Hamilton
1,822,131,2020,Lewis Hamilton,Valtteri Bottas,347,223,124,Lewis Hamilton
1,847,131,2020,Lewis Hamilton,George Russell,347,3,344,Lewis Hamilton
822,847,131,2020,Valtteri Bottas,George Russell,223,3,220,Valtteri Bottas
1,822,131,2021,Lewis Hamilton,Valtteri Bottas,386,219,167,Lewis Hamilton
1,847,131,2022,Lewis Hamilton,George Russell,233,262,29,George Russell
1,847,131,2023,Lewis Hamilton,George Russell,217,157,60,Lewis Hamilton
1,847,131,2024,Lewis Hamilton,George Russell,100,105,5,George Russell
633,647,132,1954,Luigi Villoresi,Alberto Ascari,0,1,1,Alberto Ascari
589,608,132,1955,Louis Chiron,Eugenio Castellotti,0,6,6,Eugenio Castellotti
589,633,132,1955,Louis Chiron,Luigi Villoresi,0,2,2,Luigi Villoresi
589,647,132,1955,Louis Chiron,Alberto Ascari,0,0,0,Alberto Ascari
608,633,132,1955,Eugenio Castellotti,Luigi Villoresi,6,2,4,Eugenio Castellotti
608,647,132,1955,Eugenio Castellotti,Alberto Ascari,6,0,6,Eugenio Castellotti
633,647,132,1955,Luigi Villoresi,Alberto Ascari,2,0,2,Luigi Villoresi
475,725,133,1951,Stirling Moss,George Abecassis,0,0,0,George Abecassis
475,581,133,1952,Stirling Moss,Peter Collins,0,0,0,Peter Collins
475,632,133,1952,Stirling Moss,Paul FrÃ¨re,0,2,2,Paul FrÃ¨re
475,651,133,1952,Stirling Moss,Lance Macklin,0,0,0,Lance Macklin
475,660,133,1952,Stirling Moss,Johnny Claes,0,0,0,Johnny Claes
475,704,133,1952,Stirling Moss,Yves Cabantous,0,0,0,Yves Cabantous
475,708,133,1952,Stirling Moss,Duncan Hamilton,0,0,0,Duncan Hamilton
475,725,133,1952,Stirling Moss,George Abecassis,0,0,0,George Abecassis
475,736,133,1952,Stirling Moss,Roger Laurent,0,0,0,Roger Laurent
475,738,133,1952,Stirling Moss,Tony Gaze,0,0,0,Tony Gaze
475,758,133,1952,Stirling Moss,Dries van der Lof,0,0,0,Dries van der Lof
581,632,133,1952,Peter Collins,Paul FrÃ¨re,0,2,2,Paul FrÃ¨re
581,651,133,1952,Peter Collins,Lance Macklin,0,0,0,Lance Macklin
581,660,133,1952,Peter Collins,Johnny Claes,0,0,0,Johnny Claes
581,704,133,1952,Peter Collins,Yves Cabantous,0,0,0,Yves Cabantous
581,708,133,1952,Peter Collins,Duncan Hamilton,0,0,0,Duncan Hamilton
581,725,133,1952,Peter Collins,George Abecassis,0,0,0,George Abecassis
581,736,133,1952,Peter Collins,Roger Laurent,0,0,0,Roger Laurent
581,738,133,1952,Peter Collins,Tony Gaze,0,0,0,Tony Gaze
581,758,133,1952,Peter Collins,Dries van der Lof,0,0,0,Dries van der Lof
632,651,133,1952,Paul FrÃ¨re,Lance Macklin,2,0,2,Paul FrÃ¨re
632,660,133,1952,Paul FrÃ¨re,Johnny Claes,2,0,2,Paul FrÃ¨re
632,704,133,1952,Paul FrÃ¨re,Yves Cabantous,2,0,2,Paul FrÃ¨re
632,708,133,1952,Paul FrÃ¨re,Duncan Hamilton,2,0,2,Paul FrÃ¨re
632,725,133,1952,Paul FrÃ¨re,George Abecassis,2,0,2,Paul FrÃ¨re
632,736,133,1952,Paul FrÃ¨re,Roger Laurent,2,0,2,Paul FrÃ¨re
632,738,133,1952,Paul FrÃ¨re,Tony Gaze,2,0,2,Paul FrÃ¨re
632,758,133,1952,Paul FrÃ¨re,Dries van der Lof,2,0,2,Paul FrÃ¨re
651,660,133,1952,Lance Macklin,Johnny Claes,0,0,0,Johnny Claes
651,704,133,1952,Lance Macklin,Yves Cabantous,0,0,0,Yves Cabantous
651,708,133,1952,Lance Macklin,Duncan Hamilton,0,0,0,Duncan Hamilton
651,725,133,1952,Lance Macklin,George Abecassis,0,0,0,George Abecassis
651,736,133,1952,Lance Macklin,Roger Laurent,0,0,0,Roger Laurent
651,738,133,1952,Lance Macklin,Tony Gaze,0,0,0,Tony Gaze
651,758,133,1952,Lance Macklin,Dries van der Lof,0,0,0,Dries van der Lof
660,704,133,1952,Johnny Claes,Yves Cabantous,0,0,0,Yves Cabantous
660,708,133,1952,Johnny Claes,Duncan Hamilton,0,0,0,Duncan Hamilton
660,725,133,1952,Johnny Claes,George Abecassis,0,0,0,George Abecassis
660,736,133,1952,Johnny Claes,Roger Laurent,0,0,0,Roger Laurent
660,738,133,1952,Johnny Claes,Tony Gaze,0,0,0,Tony Gaze
660,758,133,1952,Johnny Claes,Dries van der Lof,0,0,0,Dries van der Lof
704,708,133,1952,Yves Cabantous,Duncan Hamilton,0,0,0,Duncan Hamilton
704,725,133,1952,Yves Cabantous,George Abecassis,0,0,0,George Abecassis
704,736,133,1952,Yves Cabantous,Roger Laurent,0,0,0,Roger Laurent
704,738,133,1952,Yves Cabantous,Tony Gaze,0,0,0,Tony Gaze
704,758,133,1952,Yves Cabantous,Dries van der Lof,0,0,0,Dries van der Lof
708,725,133,1952,Duncan Hamilton,George Abecassis,0,0,0,George Abecassis
708,736,133,1952,Duncan Hamilton,Roger Laurent,0,0,0,Roger Laurent
708,738,133,1952,Duncan Hamilton,Tony Gaze,0,0,0,Tony Gaze
708,758,133,1952,Duncan Hamilton,Dries van der Lof,0,0,0,Dries van der Lof
725,736,133,1952,George Abecassis,Roger Laurent,0,0,0,Roger Laurent
725,738,133,1952,George Abecassis,Tony Gaze,0,0,0,Tony Gaze
725,758,133,1952,George Abecassis,Dries van der Lof,0,0,0,Dries van der Lof
736,738,133,1952,Roger Laurent,Tony Gaze,0,0,0,Tony Gaze
736,758,133,1952,Roger Laurent,Dries van der Lof,0,0,0,Dries van der Lof
738,758,133,1952,Tony Gaze,Dries van der Lof,0,0,0,Dries van der Lof
486,581,133,1953,Jack Fairman,Peter Collins,0,0,0,Peter Collins
486,632,133,1953,Jack Fairman,Paul FrÃ¨re,0,0,0,Paul FrÃ¨re
486,651,133,1953,Jack Fairman,Lance Macklin,0,0,0,Lance Macklin
486,667,133,1953,Jack Fairman,John Fitch,0,0,0,John Fitch
486,704,133,1953,Jack Fairman,Yves Cabantous,0,0,0,Yves Cabantous
486,708,133,1953,Jack Fairman,Duncan Hamilton,0,0,0,Duncan Hamilton
486,719,133,1953,Jack Fairman,Albert Scherrer,0,0,0,Albert Scherrer
581,632,133,1953,Peter Collins,Paul FrÃ¨re,0,0,0,Paul FrÃ¨re
581,651,133,1953,Peter Collins,Lance Macklin,0,0,0,Lance Macklin
581,667,133,1953,Peter Collins,John Fitch,0,0,0,John Fitch
581,704,133,1953,Peter Collins,Yves Cabantous,0,0,0,Yves Cabantous
581,708,133,1953,Peter Collins,Duncan Hamilton,0,0,0,Duncan Hamilton
581,719,133,1953,Peter Collins,Albert Scherrer,0,0,0,Albert Scherrer
632,651,133,1953,Paul FrÃ¨re,Lance Macklin,0,0,0,Lance Macklin
632,667,133,1953,Paul FrÃ¨re,John Fitch,0,0,0,John Fitch
632,704,133,1953,Paul FrÃ¨re,Yves Cabantous,0,0,0,Yves Cabantous
632,708,133,1953,Paul FrÃ¨re,Duncan Hamilton,0,0,0,Duncan Hamilton
632,719,133,1953,Paul FrÃ¨re,Albert Scherrer,0,0,0,Albert Scherrer
651,667,133,1953,Lance Macklin,John Fitch,0,0,0,John Fitch
651,704,133,1953,Lance Macklin,Yves Cabantous,0,0,0,Yves Cabantous
651,708,133,1953,Lance Macklin,Duncan Hamilton,0,0,0,Duncan Hamilton
651,719,133,1953,Lance Macklin,Albert Scherrer,0,0,0,Albert Scherrer
667,704,133,1953,John Fitch,Yves Cabantous,0,0,0,Yves Cabantous
667,708,133,1953,John Fitch,Duncan Hamilton,0,0,0,Duncan Hamilton
667,719,133,1953,John Fitch,Albert Scherrer,0,0,0,Albert Scherrer
704,708,133,1953,Yves Cabantous,Duncan Hamilton,0,0,0,Duncan Hamilton
704,719,133,1953,Yves Cabantous,Albert Scherrer,0,0,0,Albert Scherrer
708,719,133,1953,Duncan Hamilton,Albert Scherrer,0,0,0,Albert Scherrer
630,734,134,1951,Duke Dinsmore,Bobby Ball,0,2,2,Bobby Ball
612,678,134,1954,Andy Linden,Len Duncan,0,0,0,Len Duncan
612,702,134,1954,Andy Linden,Bob Scott,0,0,0,Bob Scott
612,730,134,1954,Andy Linden,George Fonder,0,0,0,George Fonder
678,702,134,1954,Len Duncan,Bob Scott,0,0,0,Bob Scott
678,730,134,1954,Len Duncan,George Fonder,0,0,0,George Fonder
702,730,134,1954,Bob Scott,George Fonder,0,0,0,George Fonder
449,513,135,1954,Rodger Ward,Eddie Johnson,0,0,0,Eddie Johnson
512,556,138,1954,Johnny Thomson,Jimmy Daywalt,0,0,0,Jimmy Daywalt
512,612,138,1954,Johnny Thomson,Andy Linden,0,0,0,Andy Linden
556,612,138,1954,Jimmy Daywalt,Andy Linden,0,0,0,Andy Linden
677,805,139,1954,Travis Webb,Danny Kladis,0,0,0,Danny Kladis
27,33,14,2006,Christijan Albers,Tiago Monteiro,0,0,0,Tiago Monteiro
427,626,141,1950,Maurice Trintignant,Robert Manzon,0,3,3,Robert Manzon
427,609,141,1951,Maurice Trintignant,AndrÃ© Simon,0,0,0,AndrÃ© Simon
427,626,141,1951,Maurice Trintignant,Robert Manzon,0,0,0,Robert Manzon
427,775,141,1951,Maurice Trintignant,Aldo Gordini,0,0,0,Aldo Gordini
609,626,141,1951,AndrÃ© Simon,Robert Manzon,0,0,0,Robert Manzon
609,775,141,1951,AndrÃ© Simon,Aldo Gordini,0,0,0,Aldo Gordini
626,775,141,1951,Robert Manzon,Aldo Gordini,0,0,0,Aldo Gordini
427,632,141,1952,Maurice Trintignant,Paul FrÃ¨re,2,0,2,Maurice Trintignant
427,660,141,1952,Maurice Trintignant,Johnny Claes,2,0,2,Maurice Trintignant
427,669,141,1952,Maurice Trintignant,Prince Bira,2,0,2,Maurice Trintignant
427,720,141,1952,Maurice Trintignant,Max de Terra,2,0,2,Maurice Trintignant
427,737,141,1952,Maurice Trintignant,Robert O'Brien,2,0,2,Maurice Trintignant
632,660,141,1952,Paul FrÃ¨re,Johnny Claes,0,0,0,Johnny Claes
632,669,141,1952,Paul FrÃ¨re,Prince Bira,0,0,0,Prince Bira
632,720,141,1952,Paul FrÃ¨re,Max de Terra,0,0,0,Max de Terra
632,737,141,1952,Paul FrÃ¨re,Robert O'Brien,0,0,0,Robert O'Brien
660,669,141,1952,Johnny Claes,Prince Bira,0,0,0,Prince Bira
660,720,141,1952,Johnny Claes,Max de Terra,0,0,0,Max de Terra
660,737,141,1952,Johnny Claes,Robert O'Brien,0,0,0,Robert O'Brien
669,720,141,1952,Prince Bira,Max de Terra,0,0,0,Max de Terra
669,737,141,1952,Prince Bira,Robert O'Brien,0,0,0,Robert O'Brien
720,737,141,1952,Max de Terra,Robert O'Brien,0,0,0,Robert O'Brien
649,681,141,1953,Pablo Birger,Georges Berger,0,0,0,Georges Berger
692,703,144,1952,Theo Helfrich,Arthur Legat,0,0,0,Arthur Legat
692,724,144,1952,Theo Helfrich,Toni Ulmen,0,0,0,Toni Ulmen
692,750,144,1952,Theo Helfrich,Adolf Brudes,0,0,0,Adolf Brudes
692,751,144,1952,Theo Helfrich,Fritz Riess,0,0,0,Fritz Riess
692,753,144,1952,Theo Helfrich,Hans Klenk,0,0,0,Hans Klenk
692,756,144,1952,Theo Helfrich,Paul Pietsch,0,0,0,Paul Pietsch
692,757,144,1952,Theo Helfrich,Josef Peters,0,0,0,Josef Peters
703,724,144,1952,Arthur Legat,Toni Ulmen,0,0,0,Toni Ulmen
703,750,144,1952,Arthur Legat,Adolf Brudes,0,0,0,Adolf Brudes
703,751,144,1952,Arthur Legat,Fritz Riess,0,0,0,Fritz Riess
703,753,144,1952,Arthur Legat,Hans Klenk,0,0,0,Hans Klenk
703,756,144,1952,Arthur Legat,Paul Pietsch,0,0,0,Paul Pietsch
703,757,144,1952,Arthur Legat,Josef Peters,0,0,0,Josef Peters
724,750,144,1952,Toni Ulmen,Adolf Brudes,0,0,0,Adolf Brudes
724,751,144,1952,Toni Ulmen,Fritz Riess,0,0,0,Fritz Riess
724,753,144,1952,Toni Ulmen,Hans Klenk,0,0,0,Hans Klenk
724,756,144,1952,Toni Ulmen,Paul Pietsch,0,0,0,Paul Pietsch
724,757,144,1952,Toni Ulmen,Josef Peters,0,0,0,Josef Peters
750,751,144,1952,Adolf Brudes,Fritz Riess,0,0,0,Fritz Riess
750,753,144,1952,Adolf Brudes,Hans Klenk,0,0,0,Hans Klenk
750,756,144,1952,Adolf Brudes,Paul Pietsch,0,0,0,Paul Pietsch
750,757,144,1952,Adolf Brudes,Josef Peters,0,0,0,Josef Peters
751,753,144,1952,Fritz Riess,Hans Klenk,0,0,0,Hans Klenk
751,756,144,1952,Fritz Riess,Paul Pietsch,0,0,0,Paul Pietsch
751,757,144,1952,Fritz Riess,Josef Peters,0,0,0,Josef Peters
753,756,144,1952,Hans Klenk,Paul Pietsch,0,0,0,Paul Pietsch
753,757,144,1952,Hans Klenk,Josef Peters,0,0,0,Josef Peters
756,757,144,1952,Paul Pietsch,Josef Peters,0,0,0,Josef Peters
455,478,144,1953,Wolfgang Seidel,Hans Herrmann,0,0,0,Hans Herrmann
455,692,144,1953,Wolfgang Seidel,Theo Helfrich,0,0,0,Theo Helfrich
455,703,144,1953,Wolfgang Seidel,Arthur Legat,0,0,0,Arthur Legat
455,711,144,1953,Wolfgang Seidel,Oswald Karch,0,0,0,Oswald Karch
455,712,144,1953,Wolfgang Seidel,Willi Heeks,0,0,0,Willi Heeks
455,716,144,1953,Wolfgang Seidel,Erwin Bauer,0,0,0,Erwin Bauer
455,718,144,1953,Wolfgang Seidel,Ernst Loof,0,0,0,Ernst Loof
478,692,144,1953,Hans Herrmann,Theo Helfrich,0,0,0,Theo Helfrich
478,703,144,1953,Hans Herrmann,Arthur Legat,0,0,0,Arthur Legat
478,711,144,1953,Hans Herrmann,Oswald Karch,0,0,0,Oswald Karch
478,712,144,1953,Hans Herrmann,Willi Heeks,0,0,0,Willi Heeks
478,716,144,1953,Hans Herrmann,Erwin Bauer,0,0,0,Erwin Bauer
478,718,144,1953,Hans Herrmann,Ernst Loof,0,0,0,Ernst Loof
692,703,144,1953,Theo Helfrich,Arthur Legat,0,0,0,Arthur Legat
692,711,144,1953,Theo Helfrich,Oswald Karch,0,0,0,Oswald Karch
692,712,144,1953,Theo Helfrich,Willi Heeks,0,0,0,Willi Heeks
692,716,144,1953,Theo Helfrich,Erwin Bauer,0,0,0,Erwin Bauer
692,718,144,1953,Theo Helfrich,Ernst Loof,0,0,0,Ernst Loof
703,711,144,1953,Arthur Legat,Oswald Karch,0,0,0,Oswald Karch
703,712,144,1953,Arthur Legat,Willi Heeks,0,0,0,Willi Heeks
703,716,144,1953,Arthur Legat,Erwin Bauer,0,0,0,Erwin Bauer
703,718,144,1953,Arthur Legat,Ernst Loof,0,0,0,Ernst Loof
711,712,144,1953,Oswald Karch,Willi Heeks,0,0,0,Willi Heeks
711,716,144,1953,Oswald Karch,Erwin Bauer,0,0,0,Erwin Bauer
711,718,144,1953,Oswald Karch,Ernst Loof,0,0,0,Ernst Loof
712,716,144,1953,Willi Heeks,Erwin Bauer,0,0,0,Erwin Bauer
712,718,144,1953,Willi Heeks,Ernst Loof,0,0,0,Ernst Loof
716,718,144,1953,Erwin Bauer,Ernst Loof,0,0,0,Ernst Loof
709,710,145,1952,Ernst Klodwig,Rudolf Krause,0,0,0,Rudolf Krause
709,715,145,1952,Ernst Klodwig,GÃ¼nther Bechem,0,0,0,GÃ¼nther Bechem
709,754,145,1952,Ernst Klodwig,Marcel Balsa,0,0,0,Marcel Balsa
710,715,145,1952,Rudolf Krause,GÃ¼nther Bechem,0,0,0,GÃ¼nther Bechem
710,754,145,1952,Rudolf Krause,Marcel Balsa,0,0,0,Marcel Balsa
715,754,145,1952,GÃ¼nther Bechem,Marcel Balsa,0,0,0,Marcel Balsa
709,710,145,1953,Ernst Klodwig,Rudolf Krause,0,0,0,Rudolf Krause
712,717,147,1952,Willi Heeks,Hans von Stuck,0,0,0,Hans von Stuck
712,752,147,1952,Willi Heeks,Helmut Niedermayr,0,0,0,Helmut Niedermayr
717,752,147,1952,Hans von Stuck,Helmut Niedermayr,0,0,0,Helmut Niedermayr
713,715,147,1953,Theo Fitzau,GÃ¼nther Bechem,0,0,0,GÃ¼nther Bechem
713,717,147,1953,Theo Fitzau,Hans von Stuck,0,0,0,Hans von Stuck
715,717,147,1953,GÃ¼nther Bechem,Hans von Stuck,0,0,0,Hans von Stuck
663,705,148,1952,Ken Wharton,Tony Crook,3,0,3,Ken Wharton
109,91,15,1993,Jyrki JÃ¤rvilehto,Karl Wendlinger,5,7,2,Karl Wendlinger
109,110,15,1994,Jyrki JÃ¤rvilehto,Andrea de Cesaris,0,1,1,Andrea de Cesaris
109,49,15,1994,Jyrki JÃ¤rvilehto,Heinz-Harald Frentzen,0,7,7,Heinz-Harald Frentzen
109,91,15,1994,Jyrki JÃ¤rvilehto,Karl Wendlinger,0,4,4,Karl Wendlinger
110,49,15,1994,Andrea de Cesaris,Heinz-Harald Frentzen,1,7,6,Heinz-Harald Frentzen
110,91,15,1994,Andrea de Cesaris,Karl Wendlinger,1,4,3,Karl Wendlinger
49,91,15,1994,Heinz-Harald Frentzen,Karl Wendlinger,7,4,3,Heinz-Harald Frentzen
49,91,15,1995,Heinz-Harald Frentzen,Karl Wendlinger,15,0,15,Heinz-Harald Frentzen
49,96,15,1995,Heinz-Harald Frentzen,Jean-Christophe Boullion,15,3,12,Heinz-Harald Frentzen
91,96,15,1995,Karl Wendlinger,Jean-Christophe Boullion,0,3,3,Jean-Christophe Boullion
49,65,15,1996,Heinz-Harald Frentzen,Johnny Herbert,7,4,3,Heinz-Harald Frentzen
65,78,15,1997,Johnny Herbert,Nicola Larini,15,1,14,Johnny Herbert
65,81,15,1997,Johnny Herbert,Gianni Morbidelli,15,0,15,Johnny Herbert
65,82,15,1997,Johnny Herbert,Norberto Fontana,15,0,15,Johnny Herbert
78,81,15,1997,Nicola Larini,Gianni Morbidelli,1,0,1,Nicola Larini
78,82,15,1997,Nicola Larini,Norberto Fontana,1,0,1,Nicola Larini
81,82,15,1997,Gianni Morbidelli,Norberto Fontana,0,0,0,Norberto Fontana
55,65,15,1998,Jean Alesi,Johnny Herbert,9,1,8,Jean Alesi
55,64,15,1999,Jean Alesi,Pedro Diniz,2,3,1,Pedro Diniz
63,64,15,2000,Mika Salo,Pedro Diniz,6,0,6,Mika Salo
2,8,15,2001,Nick Heidfeld,Kimi RÃ¤ikkÃ¶nen,12,9,3,Nick Heidfeld
13,2,15,2002,Felipe Massa,Nick Heidfeld,4,7,3,Nick Heidfeld
13,49,15,2002,Felipe Massa,Heinz-Harald Frentzen,4,0,4,Felipe Massa
2,49,15,2002,Nick Heidfeld,Heinz-Harald Frentzen,7,0,7,Nick Heidfeld
2,49,15,2003,Nick Heidfeld,Heinz-Harald Frentzen,6,13,7,Heinz-Harald Frentzen
13,21,15,2004,Felipe Massa,Giancarlo Fisichella,12,22,10,Giancarlo Fisichella
13,35,15,2005,Felipe Massa,Jacques Villeneuve,11,9,2,Felipe Massa
155,2,15,2010,Kamui Kobayashi,Nick Heidfeld,32,6,26,Kamui Kobayashi
155,37,15,2010,Kamui Kobayashi,Pedro de la Rosa,32,6,26,Kamui Kobayashi
2,37,15,2010,Nick Heidfeld,Pedro de la Rosa,6,6,0,Pedro de la Rosa
155,37,15,2011,Kamui Kobayashi,Pedro de la Rosa,30,0,30,Kamui Kobayashi
155,815,15,2011,Kamui Kobayashi,Sergio PÃ©rez,30,14,16,Kamui Kobayashi
37,815,15,2011,Pedro de la Rosa,Sergio PÃ©rez,0,14,14,Sergio PÃ©rez
155,815,15,2012,Kamui Kobayashi,Sergio PÃ©rez,60,66,6,Sergio PÃ©rez
807,821,15,2013,Nico HÃ¼lkenberg,Esteban GutiÃ©rrez,51,6,45,Nico HÃ¼lkenberg
16,821,15,2014,Adrian Sutil,Esteban GutiÃ©rrez,0,0,0,Esteban GutiÃ©rrez
828,831,15,2015,Marcus Ericsson,Felipe Nasr,9,27,18,Felipe Nasr
828,831,15,2016,Marcus Ericsson,Felipe Nasr,0,2,2,Felipe Nasr
828,836,15,2017,Marcus Ericsson,Pascal Wehrlein,0,5,5,Pascal Wehrlein
828,841,15,2017,Marcus Ericsson,Antonio Giovinazzi,0,0,0,Antonio Giovinazzi
836,841,15,2017,Pascal Wehrlein,Antonio Giovinazzi,5,0,5,Pascal Wehrlein
828,844,15,2018,Marcus Ericsson,Charles Leclerc,9,39,30,Charles Leclerc
822,855,15,2024,Valtteri Bottas,Guanyu Zhou,0,0,0,Guanyu Zhou
529,701,150,1950,Tony Bettenhausen,Bill Holland,0,6,6,Bill Holland
529,768,150,1950,Tony Bettenhausen,Mauri Rose,0,4,4,Mauri Rose
701,768,150,1950,Bill Holland,Mauri Rose,6,4,2,Bill Holland
518,529,150,1951,Duane Carter,Tony Bettenhausen,0,0,0,Tony Bettenhausen
518,768,150,1951,Duane Carter,Mauri Rose,0,0,0,Mauri Rose
518,772,150,1951,Duane Carter,Mack Hellings,0,0,0,Mack Hellings
529,768,150,1951,Tony Bettenhausen,Mauri Rose,0,0,0,Mauri Rose
529,772,150,1951,Tony Bettenhausen,Mack Hellings,0,0,0,Mack Hellings
768,772,150,1951,Mauri Rose,Mack Hellings,0,0,0,Mack Hellings
619,661,151,1950,Bob Gerard,Peter Walker,0,0,0,Peter Walker
619,666,151,1950,Bob Gerard,Tony Rolt,0,0,0,Tony Rolt
619,787,151,1950,Bob Gerard,Cuth Harrison,0,0,0,Cuth Harrison
619,790,151,1950,Bob Gerard,Leslie Johnson,0,0,0,Leslie Johnson
661,666,151,1950,Peter Walker,Tony Rolt,0,0,0,Tony Rolt
661,787,151,1950,Peter Walker,Cuth Harrison,0,0,0,Cuth Harrison
661,790,151,1950,Peter Walker,Leslie Johnson,0,0,0,Leslie Johnson
666,787,151,1950,Tony Rolt,Cuth Harrison,0,0,0,Cuth Harrison
666,790,151,1950,Tony Rolt,Leslie Johnson,0,0,0,Leslie Johnson
787,790,151,1950,Cuth Harrison,Leslie Johnson,0,0,0,Leslie Johnson
619,778,151,1951,Bob Gerard,Brian Shawe Taylor,0,0,0,Brian Shawe Taylor
739,749,152,1952,Robin Montgomerie-Charrington,Bill Aston,0,0,0,Bill Aston
501,627,154,1950,Harry Schell,Louis Rosier,0,13,13,Louis Rosier
501,660,154,1950,Harry Schell,Johnny Claes,0,0,0,Johnny Claes
501,704,154,1950,Harry Schell,Yves Cabantous,0,3,3,Yves Cabantous
501,741,154,1950,Harry Schell,Philippe Ã‰tancelin,0,3,3,Philippe Ã‰tancelin
501,764,154,1950,Harry Schell,Guy Mairesse,0,0,0,Guy Mairesse
501,765,154,1950,Harry Schell,Henri Louveau,0,0,0,Henri Louveau
501,773,154,1950,Harry Schell,Pierre Levegh,0,0,0,Pierre Levegh
501,774,154,1950,Harry Schell,EugÃ¨ne Chaboud,0,1,1,EugÃ¨ne Chaboud
501,789,154,1950,Harry Schell,EugÃ¨ne Martin,0,0,0,EugÃ¨ne Martin
501,793,154,1950,Harry Schell,Raymond Sommer,0,0,0,Raymond Sommer
501,801,154,1950,Harry Schell,Charles Pozzi,0,0,0,Charles Pozzi
627,660,154,1950,Louis Rosier,Johnny Claes,13,0,13,Louis Rosier
627,704,154,1950,Louis Rosier,Yves Cabantous,13,3,10,Louis Rosier
627,741,154,1950,Louis Rosier,Philippe Ã‰tancelin,13,3,10,Louis Rosier
627,764,154,1950,Louis Rosier,Guy Mairesse,13,0,13,Louis Rosier
627,765,154,1950,Louis Rosier,Henri Louveau,13,0,13,Louis Rosier
627,773,154,1950,Louis Rosier,Pierre Levegh,13,0,13,Louis Rosier
627,774,154,1950,Louis Rosier,EugÃ¨ne Chaboud,13,1,12,Louis Rosier
627,789,154,1950,Louis Rosier,EugÃ¨ne Martin,13,0,13,Louis Rosier
627,793,154,1950,Louis Rosier,Raymond Sommer,13,0,13,Louis Rosier
627,801,154,1950,Louis Rosier,Charles Pozzi,13,0,13,Louis Rosier
660,704,154,1950,Johnny Claes,Yves Cabantous,0,3,3,Yves Cabantous
660,741,154,1950,Johnny Claes,Philippe Ã‰tancelin,0,3,3,Philippe Ã‰tancelin
660,764,154,1950,Johnny Claes,Guy Mairesse,0,0,0,Guy Mairesse
660,765,154,1950,Johnny Claes,Henri Louveau,0,0,0,Henri Louveau
660,773,154,1950,Johnny Claes,Pierre Levegh,0,0,0,Pierre Levegh
660,774,154,1950,Johnny Claes,EugÃ¨ne Chaboud,0,1,1,EugÃ¨ne Chaboud
660,789,154,1950,Johnny Claes,EugÃ¨ne Martin,0,0,0,EugÃ¨ne Martin
660,793,154,1950,Johnny Claes,Raymond Sommer,0,0,0,Raymond Sommer
660,801,154,1950,Johnny Claes,Charles Pozzi,0,0,0,Charles Pozzi
704,741,154,1950,Yves Cabantous,Philippe Ã‰tancelin,3,3,0,Philippe Ã‰tancelin
704,764,154,1950,Yves Cabantous,Guy Mairesse,3,0,3,Yves Cabantous
704,765,154,1950,Yves Cabantous,Henri Louveau,3,0,3,Yves Cabantous
704,773,154,1950,Yves Cabantous,Pierre Levegh,3,0,3,Yves Cabantous
704,774,154,1950,Yves Cabantous,EugÃ¨ne Chaboud,3,1,2,Yves Cabantous
704,789,154,1950,Yves Cabantous,EugÃ¨ne Martin,3,0,3,Yves Cabantous
704,793,154,1950,Yves Cabantous,Raymond Sommer,3,0,3,Yves Cabantous
704,801,154,1950,Yves Cabantous,Charles Pozzi,3,0,3,Yves Cabantous
741,764,154,1950,Philippe Ã‰tancelin,Guy Mairesse,3,0,3,Philippe Ã‰tancelin
741,765,154,1950,Philippe Ã‰tancelin,Henri Louveau,3,0,3,Philippe Ã‰tancelin
741,773,154,1950,Philippe Ã‰tancelin,Pierre Levegh,3,0,3,Philippe Ã‰tancelin
741,774,154,1950,Philippe Ã‰tancelin,EugÃ¨ne Chaboud,3,1,2,Philippe Ã‰tancelin
741,789,154,1950,Philippe Ã‰tancelin,EugÃ¨ne Martin,3,0,3,Philippe Ã‰tancelin
741,793,154,1950,Philippe Ã‰tancelin,Raymond Sommer,3,0,3,Philippe Ã‰tancelin
741,801,154,1950,Philippe Ã‰tancelin,Charles Pozzi,3,0,3,Philippe Ã‰tancelin
764,765,154,1950,Guy Mairesse,Henri Louveau,0,0,0,Henri Louveau
764,773,154,1950,Guy Mairesse,Pierre Levegh,0,0,0,Pierre Levegh
764,774,154,1950,Guy Mairesse,EugÃ¨ne Chaboud,0,1,1,EugÃ¨ne Chaboud
764,789,154,1950,Guy Mairesse,EugÃ¨ne Martin,0,0,0,EugÃ¨ne Martin
764,793,154,1950,Guy Mairesse,Raymond Sommer,0,0,0,Raymond Sommer
764,801,154,1950,Guy Mairesse,Charles Pozzi,0,0,0,Charles Pozzi
765,773,154,1950,Henri Louveau,Pierre Levegh,0,0,0,Pierre Levegh
765,774,154,1950,Henri Louveau,EugÃ¨ne Chaboud,0,1,1,EugÃ¨ne Chaboud
765,789,154,1950,Henri Louveau,EugÃ¨ne Martin,0,0,0,EugÃ¨ne Martin
765,793,154,1950,Henri Louveau,Raymond Sommer,0,0,0,Raymond Sommer
765,801,154,1950,Henri Louveau,Charles Pozzi,0,0,0,Charles Pozzi
773,774,154,1950,Pierre Levegh,EugÃ¨ne Chaboud,0,1,1,EugÃ¨ne Chaboud
773,789,154,1950,Pierre Levegh,EugÃ¨ne Martin,0,0,0,EugÃ¨ne Martin
773,793,154,1950,Pierre Levegh,Raymond Sommer,0,0,0,Raymond Sommer
773,801,154,1950,Pierre Levegh,Charles Pozzi,0,0,0,Charles Pozzi
774,789,154,1950,EugÃ¨ne Chaboud,EugÃ¨ne Martin,1,0,1,EugÃ¨ne Chaboud
774,793,154,1950,EugÃ¨ne Chaboud,Raymond Sommer,1,0,1,EugÃ¨ne Chaboud
774,801,154,1950,EugÃ¨ne Chaboud,Charles Pozzi,1,0,1,EugÃ¨ne Chaboud
789,793,154,1950,EugÃ¨ne Martin,Raymond Sommer,0,0,0,Raymond Sommer
789,801,154,1950,EugÃ¨ne Martin,Charles Pozzi,0,0,0,Charles Pozzi
793,801,154,1950,Raymond Sommer,Charles Pozzi,0,0,0,Charles Pozzi
429,498,154,1951,AndrÃ© Pilette,JosÃ© FroilÃ¡n GonzÃ¡lez,0,0,0,JosÃ© FroilÃ¡n GonzÃ¡lez
429,589,154,1951,AndrÃ© Pilette,Louis Chiron,0,0,0,Louis Chiron
429,627,154,1951,AndrÃ© Pilette,Louis Rosier,0,3,3,Louis Rosier
429,660,154,1951,AndrÃ© Pilette,Johnny Claes,0,0,0,Johnny Claes
429,680,154,1951,AndrÃ© Pilette,Jacques Swaters,0,0,0,Jacques Swaters
429,704,154,1951,AndrÃ© Pilette,Yves Cabantous,0,2,2,Yves Cabantous
429,708,154,1951,AndrÃ© Pilette,Duncan Hamilton,0,0,0,Duncan Hamilton
429,741,154,1951,AndrÃ© Pilette,Philippe Ã‰tancelin,0,0,0,Philippe Ã‰tancelin
429,764,154,1951,AndrÃ© Pilette,Guy Mairesse,0,0,0,Guy Mairesse
429,765,154,1951,AndrÃ© Pilette,Henri Louveau,0,0,0,Henri Louveau
429,773,154,1951,AndrÃ© Pilette,Pierre Levegh,0,0,0,Pierre Levegh
429,774,154,1951,AndrÃ© Pilette,EugÃ¨ne Chaboud,0,0,0,EugÃ¨ne Chaboud
429,783,154,1951,AndrÃ© Pilette,Georges Grignard,0,0,0,Georges Grignard
498,589,154,1951,JosÃ© FroilÃ¡n GonzÃ¡lez,Louis Chiron,0,0,0,Louis Chiron
498,627,154,1951,JosÃ© FroilÃ¡n GonzÃ¡lez,Louis Rosier,0,3,3,Louis Rosier
498,660,154,1951,JosÃ© FroilÃ¡n GonzÃ¡lez,Johnny Claes,0,0,0,Johnny Claes
498,680,154,1951,JosÃ© FroilÃ¡n GonzÃ¡lez,Jacques Swaters,0,0,0,Jacques Swaters
498,704,154,1951,JosÃ© FroilÃ¡n GonzÃ¡lez,Yves Cabantous,0,2,2,Yves Cabantous
498,708,154,1951,JosÃ© FroilÃ¡n GonzÃ¡lez,Duncan Hamilton,0,0,0,Duncan Hamilton
498,741,154,1951,JosÃ© FroilÃ¡n GonzÃ¡lez,Philippe Ã‰tancelin,0,0,0,Philippe Ã‰tancelin
498,764,154,1951,JosÃ© FroilÃ¡n GonzÃ¡lez,Guy Mairesse,0,0,0,Guy Mairesse
498,765,154,1951,JosÃ© FroilÃ¡n GonzÃ¡lez,Henri Louveau,0,0,0,Henri Louveau
498,773,154,1951,JosÃ© FroilÃ¡n GonzÃ¡lez,Pierre Levegh,0,0,0,Pierre Levegh
498,774,154,1951,JosÃ© FroilÃ¡n GonzÃ¡lez,EugÃ¨ne Chaboud,0,0,0,EugÃ¨ne Chaboud
498,783,154,1951,JosÃ© FroilÃ¡n GonzÃ¡lez,Georges Grignard,0,0,0,Georges Grignard
589,627,154,1951,Louis Chiron,Louis Rosier,0,3,3,Louis Rosier
589,660,154,1951,Louis Chiron,Johnny Claes,0,0,0,Johnny Claes
589,680,154,1951,Louis Chiron,Jacques Swaters,0,0,0,Jacques Swaters
589,704,154,1951,Louis Chiron,Yves Cabantous,0,2,2,Yves Cabantous
589,708,154,1951,Louis Chiron,Duncan Hamilton,0,0,0,Duncan Hamilton
589,741,154,1951,Louis Chiron,Philippe Ã‰tancelin,0,0,0,Philippe Ã‰tancelin
589,764,154,1951,Louis Chiron,Guy Mairesse,0,0,0,Guy Mairesse
589,765,154,1951,Louis Chiron,Henri Louveau,0,0,0,Henri Louveau
589,773,154,1951,Louis Chiron,Pierre Levegh,0,0,0,Pierre Levegh
589,774,154,1951,Louis Chiron,EugÃ¨ne Chaboud,0,0,0,EugÃ¨ne Chaboud
589,783,154,1951,Louis Chiron,Georges Grignard,0,0,0,Georges Grignard
627,660,154,1951,Louis Rosier,Johnny Claes,3,0,3,Louis Rosier
627,680,154,1951,Louis Rosier,Jacques Swaters,3,0,3,Louis Rosier
627,704,154,1951,Louis Rosier,Yves Cabantous,3,2,1,Louis Rosier
627,708,154,1951,Louis Rosier,Duncan Hamilton,3,0,3,Louis Rosier
627,741,154,1951,Louis Rosier,Philippe Ã‰tancelin,3,0,3,Louis Rosier
627,764,154,1951,Louis Rosier,Guy Mairesse,3,0,3,Louis Rosier
627,765,154,1951,Louis Rosier,Henri Louveau,3,0,3,Louis Rosier
627,773,154,1951,Louis Rosier,Pierre Levegh,3,0,3,Louis Rosier
627,774,154,1951,Louis Rosier,EugÃ¨ne Chaboud,3,0,3,Louis Rosier
627,783,154,1951,Louis Rosier,Georges Grignard,3,0,3,Louis Rosier
660,680,154,1951,Johnny Claes,Jacques Swaters,0,0,0,Jacques Swaters
660,704,154,1951,Johnny Claes,Yves Cabantous,0,2,2,Yves Cabantous
660,708,154,1951,Johnny Claes,Duncan Hamilton,0,0,0,Duncan Hamilton
660,741,154,1951,Johnny Claes,Philippe Ã‰tancelin,0,0,0,Philippe Ã‰tancelin
660,764,154,1951,Johnny Claes,Guy Mairesse,0,0,0,Guy Mairesse
660,765,154,1951,Johnny Claes,Henri Louveau,0,0,0,Henri Louveau
660,773,154,1951,Johnny Claes,Pierre Levegh,0,0,0,Pierre Levegh
660,774,154,1951,Johnny Claes,EugÃ¨ne Chaboud,0,0,0,EugÃ¨ne Chaboud
660,783,154,1951,Johnny Claes,Georges Grignard,0,0,0,Georges Grignard
680,704,154,1951,Jacques Swaters,Yves Cabantous,0,2,2,Yves Cabantous
680,708,154,1951,Jacques Swaters,Duncan Hamilton,0,0,0,Duncan Hamilton
680,741,154,1951,Jacques Swaters,Philippe Ã‰tancelin,0,0,0,Philippe Ã‰tancelin
680,764,154,1951,Jacques Swaters,Guy Mairesse,0,0,0,Guy Mairesse
680,765,154,1951,Jacques Swaters,Henri Louveau,0,0,0,Henri Louveau
680,773,154,1951,Jacques Swaters,Pierre Levegh,0,0,0,Pierre Levegh
680,774,154,1951,Jacques Swaters,EugÃ¨ne Chaboud,0,0,0,EugÃ¨ne Chaboud
680,783,154,1951,Jacques Swaters,Georges Grignard,0,0,0,Georges Grignard
704,708,154,1951,Yves Cabantous,Duncan Hamilton,2,0,2,Yves Cabantous
704,741,154,1951,Yves Cabantous,Philippe Ã‰tancelin,2,0,2,Yves Cabantous
704,764,154,1951,Yves Cabantous,Guy Mairesse,2,0,2,Yves Cabantous
704,765,154,1951,Yves Cabantous,Henri Louveau,2,0,2,Yves Cabantous
704,773,154,1951,Yves Cabantous,Pierre Levegh,2,0,2,Yves Cabantous
704,774,154,1951,Yves Cabantous,EugÃ¨ne Chaboud,2,0,2,Yves Cabantous
704,783,154,1951,Yves Cabantous,Georges Grignard,2,0,2,Yves Cabantous
708,741,154,1951,Duncan Hamilton,Philippe Ã‰tancelin,0,0,0,Philippe Ã‰tancelin
708,764,154,1951,Duncan Hamilton,Guy Mairesse,0,0,0,Guy Mairesse
708,765,154,1951,Duncan Hamilton,Henri Louveau,0,0,0,Henri Louveau
708,773,154,1951,Duncan Hamilton,Pierre Levegh,0,0,0,Pierre Levegh
708,774,154,1951,Duncan Hamilton,EugÃ¨ne Chaboud,0,0,0,EugÃ¨ne Chaboud
708,783,154,1951,Duncan Hamilton,Georges Grignard,0,0,0,Georges Grignard
741,764,154,1951,Philippe Ã‰tancelin,Guy Mairesse,0,0,0,Guy Mairesse
741,765,154,1951,Philippe Ã‰tancelin,Henri Louveau,0,0,0,Henri Louveau
741,773,154,1951,Philippe Ã‰tancelin,Pierre Levegh,0,0,0,Pierre Levegh
741,774,154,1951,Philippe Ã‰tancelin,EugÃ¨ne Chaboud,0,0,0,EugÃ¨ne Chaboud
741,783,154,1951,Philippe Ã‰tancelin,Georges Grignard,0,0,0,Georges Grignard
764,765,154,1951,Guy Mairesse,Henri Louveau,0,0,0,Henri Louveau
764,773,154,1951,Guy Mairesse,Pierre Levegh,0,0,0,Pierre Levegh
764,774,154,1951,Guy Mairesse,EugÃ¨ne Chaboud,0,0,0,EugÃ¨ne Chaboud
764,783,154,1951,Guy Mairesse,Georges Grignard,0,0,0,Georges Grignard
765,773,154,1951,Henri Louveau,Pierre Levegh,0,0,0,Pierre Levegh
765,774,154,1951,Henri Louveau,EugÃ¨ne Chaboud,0,0,0,EugÃ¨ne Chaboud
765,783,154,1951,Henri Louveau,Georges Grignard,0,0,0,Georges Grignard
773,774,154,1951,Pierre Levegh,EugÃ¨ne Chaboud,0,0,0,EugÃ¨ne Chaboud
773,783,154,1951,Pierre Levegh,Georges Grignard,0,0,0,Georges Grignard
774,783,154,1951,EugÃ¨ne Chaboud,Georges Grignard,0,0,0,Georges Grignard
35,41,16,1999,Jacques Villeneuve,Ricardo Zonta,0,0,0,Ricardo Zonta
35,63,16,1999,Jacques Villeneuve,Mika Salo,0,0,0,Mika Salo
41,63,16,1999,Ricardo Zonta,Mika Salo,0,0,0,Mika Salo
35,41,16,2000,Jacques Villeneuve,Ricardo Zonta,17,3,14,Jacques Villeneuve
35,44,16,2001,Jacques Villeneuve,Olivier Panis,12,5,7,Jacques Villeneuve
35,44,16,2002,Jacques Villeneuve,Olivier Panis,4,3,1,Jacques Villeneuve
11,18,16,2003,Takuma Sato,Jenson Button,3,17,14,Jenson Button
11,35,16,2003,Takuma Sato,Jacques Villeneuve,3,6,3,Jacques Villeneuve
18,35,16,2003,Jenson Button,Jacques Villeneuve,17,6,11,Jenson Button
11,18,16,2004,Takuma Sato,Jenson Button,34,85,51,Jenson Button
11,18,16,2005,Takuma Sato,Jenson Button,1,37,36,Jenson Button
11,19,16,2005,Takuma Sato,Anthony Davidson,1,0,1,Takuma Sato
18,19,16,2005,Jenson Button,Anthony Davidson,37,0,37,Jenson Button
798,803,161,1950,Bayliss Levrett,Bill Cantrell,0,0,0,Bill Cantrell
29,32,164,2010,Sakon Yamamoto,Christian Klien,0,0,0,Christian Klien
29,811,164,2010,Sakon Yamamoto,Bruno Senna,0,0,0,Bruno Senna
29,812,164,2010,Sakon Yamamoto,Karun Chandhok,0,0,0,Karun Chandhok
32,811,164,2010,Christian Klien,Bruno Senna,0,0,0,Bruno Senna
32,812,164,2010,Christian Klien,Karun Chandhok,0,0,0,Karun Chandhok
811,812,164,2010,Bruno Senna,Karun Chandhok,0,0,0,Karun Chandhok
24,39,164,2011,Vitantonio Liuzzi,Narain Karthikeyan,0,0,0,Narain Karthikeyan
24,817,164,2011,Vitantonio Liuzzi,Daniel Ricciardo,0,0,0,Daniel Ricciardo
39,817,164,2011,Narain Karthikeyan,Daniel Ricciardo,0,0,0,Daniel Ricciardo
37,39,164,2012,Pedro de la Rosa,Narain Karthikeyan,0,0,0,Narain Karthikeyan
10,810,166,2010,Timo Glock,Lucas di Grassi,0,0,0,Lucas di Grassi
10,816,166,2011,Timo Glock,JÃ©rÃ´me d'Ambrosio,0,0,0,JÃ©rÃ´me d'Ambrosio
432,437,167,1959,MÃ¡rio de AraÃºjo Cabral,Ian Burgess,0,0,0,Ian Burgess
432,456,167,1959,MÃ¡rio de AraÃºjo Cabral,Roy Salvadori,0,0,0,Roy Salvadori
432,462,167,1959,MÃ¡rio de AraÃºjo Cabral,Colin Davis,0,0,0,Colin Davis
432,478,167,1959,MÃ¡rio de AraÃºjo Cabral,Hans Herrmann,0,0,0,Hans Herrmann
432,486,167,1959,MÃ¡rio de AraÃºjo Cabral,Jack Fairman,0,0,0,Jack Fairman
437,456,167,1959,Ian Burgess,Roy Salvadori,0,0,0,Roy Salvadori
437,462,167,1959,Ian Burgess,Colin Davis,0,0,0,Colin Davis
437,478,167,1959,Ian Burgess,Hans Herrmann,0,0,0,Hans Herrmann
437,486,167,1959,Ian Burgess,Jack Fairman,0,0,0,Jack Fairman
456,462,167,1959,Roy Salvadori,Colin Davis,0,0,0,Colin Davis
456,478,167,1959,Roy Salvadori,Hans Herrmann,0,0,0,Hans Herrmann
456,486,167,1959,Roy Salvadori,Jack Fairman,0,0,0,Jack Fairman
462,478,167,1959,Colin Davis,Hans Herrmann,0,0,0,Hans Herrmann
462,486,167,1959,Colin Davis,Jack Fairman,0,0,0,Jack Fairman
478,486,167,1959,Hans Herrmann,Jack Fairman,0,0,0,Jack Fairman
418,427,167,1960,Masten Gregory,Maurice Trintignant,0,0,0,Maurice Trintignant
418,432,167,1960,Masten Gregory,MÃ¡rio de AraÃºjo Cabral,0,0,0,MÃ¡rio de AraÃºjo Cabral
418,437,167,1960,Masten Gregory,Ian Burgess,0,0,0,Ian Burgess
418,465,167,1960,Masten Gregory,Keith Greene,0,0,0,Keith Greene
418,476,167,1960,Masten Gregory,Wolfgang von Trips,0,0,0,Wolfgang von Trips
418,483,167,1960,Masten Gregory,Giorgio Scarlatti,0,0,0,Giorgio Scarlatti
418,484,167,1960,Masten Gregory,Brian Naylor,0,0,0,Brian Naylor
418,491,167,1960,Masten Gregory,Alfonso Thiele,0,0,0,Alfonso Thiele
418,496,167,1960,Masten Gregory,Carlos Menditeguy,0,3,3,Carlos Menditeguy
418,499,167,1960,Masten Gregory,Roberto Bonomi,0,0,0,Roberto Bonomi
427,432,167,1960,Maurice Trintignant,MÃ¡rio de AraÃºjo Cabral,0,0,0,MÃ¡rio de AraÃºjo Cabral
427,437,167,1960,Maurice Trintignant,Ian Burgess,0,0,0,Ian Burgess
427,465,167,1960,Maurice Trintignant,Keith Greene,0,0,0,Keith Greene
427,476,167,1960,Maurice Trintignant,Wolfgang von Trips,0,0,0,Wolfgang von Trips
427,483,167,1960,Maurice Trintignant,Giorgio Scarlatti,0,0,0,Giorgio Scarlatti
427,484,167,1960,Maurice Trintignant,Brian Naylor,0,0,0,Brian Naylor
427,491,167,1960,Maurice Trintignant,Alfonso Thiele,0,0,0,Alfonso Thiele
427,496,167,1960,Maurice Trintignant,Carlos Menditeguy,0,3,3,Carlos Menditeguy
427,499,167,1960,Maurice Trintignant,Roberto Bonomi,0,0,0,Roberto Bonomi
432,437,167,1960,MÃ¡rio de AraÃºjo Cabral,Ian Burgess,0,0,0,Ian Burgess
432,465,167,1960,MÃ¡rio de AraÃºjo Cabral,Keith Greene,0,0,0,Keith Greene
432,476,167,1960,MÃ¡rio de AraÃºjo Cabral,Wolfgang von Trips,0,0,0,Wolfgang von Trips
432,483,167,1960,MÃ¡rio de AraÃºjo Cabral,Giorgio Scarlatti,0,0,0,Giorgio Scarlatti
432,484,167,1960,MÃ¡rio de AraÃºjo Cabral,Brian Naylor,0,0,0,Brian Naylor
432,491,167,1960,MÃ¡rio de AraÃºjo Cabral,Alfonso Thiele,0,0,0,Alfonso Thiele
432,496,167,1960,MÃ¡rio de AraÃºjo Cabral,Carlos Menditeguy,0,3,3,Carlos Menditeguy
432,499,167,1960,MÃ¡rio de AraÃºjo Cabral,Roberto Bonomi,0,0,0,Roberto Bonomi
437,465,167,1960,Ian Burgess,Keith Greene,0,0,0,Keith Greene
437,476,167,1960,Ian Burgess,Wolfgang von Trips,0,0,0,Wolfgang von Trips
437,483,167,1960,Ian Burgess,Giorgio Scarlatti,0,0,0,Giorgio Scarlatti
437,484,167,1960,Ian Burgess,Brian Naylor,0,0,0,Brian Naylor
437,491,167,1960,Ian Burgess,Alfonso Thiele,0,0,0,Alfonso Thiele
437,496,167,1960,Ian Burgess,Carlos Menditeguy,0,3,3,Carlos Menditeguy
437,499,167,1960,Ian Burgess,Roberto Bonomi,0,0,0,Roberto Bonomi
465,476,167,1960,Keith Greene,Wolfgang von Trips,0,0,0,Wolfgang von Trips
465,483,167,1960,Keith Greene,Giorgio Scarlatti,0,0,0,Giorgio Scarlatti
465,484,167,1960,Keith Greene,Brian Naylor,0,0,0,Brian Naylor
465,491,167,1960,Keith Greene,Alfonso Thiele,0,0,0,Alfonso Thiele
465,496,167,1960,Keith Greene,Carlos Menditeguy,0,3,3,Carlos Menditeguy
465,499,167,1960,Keith Greene,Roberto Bonomi,0,0,0,Roberto Bonomi
476,483,167,1960,Wolfgang von Trips,Giorgio Scarlatti,0,0,0,Giorgio Scarlatti
476,484,167,1960,Wolfgang von Trips,Brian Naylor,0,0,0,Brian Naylor
476,491,167,1960,Wolfgang von Trips,Alfonso Thiele,0,0,0,Alfonso Thiele
476,496,167,1960,Wolfgang von Trips,Carlos Menditeguy,0,3,3,Carlos Menditeguy
476,499,167,1960,Wolfgang von Trips,Roberto Bonomi,0,0,0,Roberto Bonomi
483,484,167,1960,Giorgio Scarlatti,Brian Naylor,0,0,0,Brian Naylor
483,491,167,1960,Giorgio Scarlatti,Alfonso Thiele,0,0,0,Alfonso Thiele
483,496,167,1960,Giorgio Scarlatti,Carlos Menditeguy,0,3,3,Carlos Menditeguy
483,499,167,1960,Giorgio Scarlatti,Roberto Bonomi,0,0,0,Roberto Bonomi
484,491,167,1960,Brian Naylor,Alfonso Thiele,0,0,0,Alfonso Thiele
484,496,167,1960,Brian Naylor,Carlos Menditeguy,0,3,3,Carlos Menditeguy
484,499,167,1960,Brian Naylor,Roberto Bonomi,0,0,0,Roberto Bonomi
491,496,167,1960,Alfonso Thiele,Carlos Menditeguy,0,3,3,Carlos Menditeguy
491,499,167,1960,Alfonso Thiele,Roberto Bonomi,0,0,0,Roberto Bonomi
496,499,167,1960,Carlos Menditeguy,Roberto Bonomi,3,0,3,Carlos Menditeguy
385,427,167,1961,Lorenzo Bandini,Maurice Trintignant,0,0,0,Maurice Trintignant
385,487,167,1961,Lorenzo Bandini,Massimo Natili,0,0,0,Massimo Natili
385,489,167,1961,Lorenzo Bandini,Renato Pirocchi,0,0,0,Renato Pirocchi
427,487,167,1961,Maurice Trintignant,Massimo Natili,0,0,0,Massimo Natili
427,489,167,1961,Maurice Trintignant,Renato Pirocchi,0,0,0,Renato Pirocchi
487,489,167,1961,Massimo Natili,Renato Pirocchi,0,0,0,Renato Pirocchi
409,443,167,1963,Trevor Blokdyk,Ernesto Brambilla,0,0,0,Ernesto Brambilla
278,341,167,1966,Chris Amon,John Surtees,0,19,19,John Surtees
278,346,167,1966,Chris Amon,Jo Siffert,0,3,3,Jo Siffert
278,347,167,1966,Chris Amon,Jo Bonnier,0,1,1,Jo Bonnier
278,358,167,1966,Chris Amon,Jochen Rindt,0,24,24,Jochen Rindt
278,382,167,1966,Chris Amon,MoisÃ©s Solana,0,0,0,MoisÃ©s Solana
278,386,167,1966,Chris Amon,Richie Ginther,0,2,2,Richie Ginther
278,389,167,1966,Chris Amon,Guy Ligier,0,0,0,Guy Ligier
341,346,167,1966,John Surtees,Jo Siffert,19,3,16,John Surtees
341,347,167,1966,John Surtees,Jo Bonnier,19,1,18,John Surtees
341,358,167,1966,John Surtees,Jochen Rindt,19,24,5,Jochen Rindt
341,382,167,1966,John Surtees,MoisÃ©s Solana,19,0,19,John Surtees
341,386,167,1966,John Surtees,Richie Ginther,19,2,17,John Surtees
341,389,167,1966,John Surtees,Guy Ligier,19,0,19,John Surtees
346,347,167,1966,Jo Siffert,Jo Bonnier,3,1,2,Jo Siffert
346,358,167,1966,Jo Siffert,Jochen Rindt,3,24,21,Jochen Rindt
346,382,167,1966,Jo Siffert,MoisÃ©s Solana,3,0,3,Jo Siffert
346,386,167,1966,Jo Siffert,Richie Ginther,3,2,1,Jo Siffert
346,389,167,1966,Jo Siffert,Guy Ligier,3,0,3,Jo Siffert
347,358,167,1966,Jo Bonnier,Jochen Rindt,1,24,23,Jochen Rindt
347,382,167,1966,Jo Bonnier,MoisÃ©s Solana,1,0,1,Jo Bonnier
347,386,167,1966,Jo Bonnier,Richie Ginther,1,2,1,Richie Ginther
347,389,167,1966,Jo Bonnier,Guy Ligier,1,0,1,Jo Bonnier
358,382,167,1966,Jochen Rindt,MoisÃ©s Solana,24,0,24,Jochen Rindt
358,386,167,1966,Jochen Rindt,Richie Ginther,24,2,22,Jochen Rindt
358,389,167,1966,Jochen Rindt,Guy Ligier,24,0,24,Jochen Rindt
382,386,167,1966,MoisÃ©s Solana,Richie Ginther,0,2,2,Richie Ginther
382,389,167,1966,MoisÃ©s Solana,Guy Ligier,0,0,0,Guy Ligier
386,389,167,1966,Richie Ginther,Guy Ligier,2,0,2,Richie Ginther
235,345,167,1967,Jacky Ickx,Pedro RodrÃ­guez,1,15,14,Pedro RodrÃ­guez
235,346,167,1967,Jacky Ickx,Jo Siffert,1,6,5,Jo Siffert
235,347,167,1967,Jacky Ickx,Jo Bonnier,1,3,2,Jo Bonnier
235,358,167,1967,Jacky Ickx,Jochen Rindt,1,6,5,Jochen Rindt
235,370,167,1967,Jacky Ickx,Richard Attwood,1,0,1,Jacky Ickx
235,389,167,1967,Jacky Ickx,Guy Ligier,1,0,1,Jacky Ickx
235,390,167,1967,Jacky Ickx,Alan Rees,1,0,1,Jacky Ickx
345,346,167,1967,Pedro RodrÃ­guez,Jo Siffert,15,6,9,Pedro RodrÃ­guez
345,347,167,1967,Pedro RodrÃ­guez,Jo Bonnier,15,3,12,Pedro RodrÃ­guez
345,358,167,1967,Pedro RodrÃ­guez,Jochen Rindt,15,6,9,Pedro RodrÃ­guez
345,370,167,1967,Pedro RodrÃ­guez,Richard Attwood,15,0,15,Pedro RodrÃ­guez
345,389,167,1967,Pedro RodrÃ­guez,Guy Ligier,15,0,15,Pedro RodrÃ­guez
345,390,167,1967,Pedro RodrÃ­guez,Alan Rees,15,0,15,Pedro RodrÃ­guez
346,347,167,1967,Jo Siffert,Jo Bonnier,6,3,3,Jo Siffert
346,358,167,1967,Jo Siffert,Jochen Rindt,6,6,0,Jochen Rindt
346,370,167,1967,Jo Siffert,Richard Attwood,6,0,6,Jo Siffert
346,389,167,1967,Jo Siffert,Guy Ligier,6,0,6,Jo Siffert
346,390,167,1967,Jo Siffert,Alan Rees,6,0,6,Jo Siffert
347,358,167,1967,Jo Bonnier,Jochen Rindt,3,6,3,Jochen Rindt
347,370,167,1967,Jo Bonnier,Richard Attwood,3,0,3,Jo Bonnier
347,389,167,1967,Jo Bonnier,Guy Ligier,3,0,3,Jo Bonnier
347,390,167,1967,Jo Bonnier,Alan Rees,3,0,3,Jo Bonnier
358,370,167,1967,Jochen Rindt,Richard Attwood,6,0,6,Jochen Rindt
358,389,167,1967,Jochen Rindt,Guy Ligier,6,0,6,Jochen Rindt
358,390,167,1967,Jochen Rindt,Alan Rees,6,0,6,Jochen Rindt
370,389,167,1967,Richard Attwood,Guy Ligier,0,0,0,Guy Ligier
370,390,167,1967,Richard Attwood,Alan Rees,0,0,0,Alan Rees
389,390,167,1967,Guy Ligier,Alan Rees,0,0,0,Alan Rees
312,346,167,1968,Brian Redman,Jo Siffert,0,0,0,Jo Siffert
312,347,167,1968,Brian Redman,Jo Bonnier,0,0,0,Jo Bonnier
346,347,167,1968,Jo Siffert,Jo Bonnier,0,0,0,Jo Bonnier
505,549,169,1959,Chris Bristow,Ivor Bueb,0,0,0,Ivor Bueb
505,574,169,1959,Chris Bristow,George Constantine,0,0,0,George Constantine
549,574,169,1959,Ivor Bueb,George Constantine,0,0,0,George Constantine
110,30,17,1991,Andrea de Cesaris,Michael Schumacher,9,0,9,Andrea de Cesaris
110,70,17,1991,Andrea de Cesaris,Alessandro Zanardi,9,0,9,Andrea de Cesaris
110,90,17,1991,Andrea de Cesaris,Roberto Moreno,9,0,9,Andrea de Cesaris
110,92,17,1991,Andrea de Cesaris,Bertrand Gachot,9,4,5,Andrea de Cesaris
30,70,17,1991,Michael Schumacher,Alessandro Zanardi,0,0,0,Alessandro Zanardi
30,90,17,1991,Michael Schumacher,Roberto Moreno,0,0,0,Roberto Moreno
30,92,17,1991,Michael Schumacher,Bertrand Gachot,0,4,4,Bertrand Gachot
70,90,17,1991,Alessandro Zanardi,Roberto Moreno,0,0,0,Roberto Moreno
70,92,17,1991,Alessandro Zanardi,Bertrand Gachot,0,4,4,Bertrand Gachot
90,92,17,1991,Roberto Moreno,Bertrand Gachot,0,4,4,Bertrand Gachot
127,131,17,1992,MaurÃ­cio Gugelmin,Stefano Modena,0,1,1,Stefano Modena
122,123,17,1993,Ivan Capelli,Thierry Boutsen,0,0,0,Thierry Boutsen
122,124,17,1993,Ivan Capelli,Marco Apicella,0,0,0,Marco Apicella
122,125,17,1993,Ivan Capelli,Emanuele Naspetti,0,0,0,Emanuele Naspetti
122,22,17,1993,Ivan Capelli,Rubens Barrichello,0,2,2,Rubens Barrichello
122,56,17,1993,Ivan Capelli,Eddie Irvine,0,1,1,Eddie Irvine
123,124,17,1993,Thierry Boutsen,Marco Apicella,0,0,0,Marco Apicella
123,125,17,1993,Thierry Boutsen,Emanuele Naspetti,0,0,0,Emanuele Naspetti
123,22,17,1993,Thierry Boutsen,Rubens Barrichello,0,2,2,Rubens Barrichello
123,56,17,1993,Thierry Boutsen,Eddie Irvine,0,1,1,Eddie Irvine
124,125,17,1993,Marco Apicella,Emanuele Naspetti,0,0,0,Emanuele Naspetti
124,22,17,1993,Marco Apicella,Rubens Barrichello,0,2,2,Rubens Barrichello
124,56,17,1993,Marco Apicella,Eddie Irvine,0,1,1,Eddie Irvine
125,22,17,1993,Emanuele Naspetti,Rubens Barrichello,0,2,2,Rubens Barrichello
125,56,17,1993,Emanuele Naspetti,Eddie Irvine,0,1,1,Eddie Irvine
22,56,17,1993,Rubens Barrichello,Eddie Irvine,2,1,1,Rubens Barrichello
110,22,17,1994,Andrea de Cesaris,Rubens Barrichello,3,19,16,Rubens Barrichello
110,56,17,1994,Andrea de Cesaris,Eddie Irvine,3,6,3,Eddie Irvine
110,88,17,1994,Andrea de Cesaris,Aguri Suzuki,3,0,3,Andrea de Cesaris
22,56,17,1994,Rubens Barrichello,Eddie Irvine,19,6,13,Rubens Barrichello
22,88,17,1994,Rubens Barrichello,Aguri Suzuki,19,0,19,Rubens Barrichello
56,88,17,1994,Eddie Irvine,Aguri Suzuki,6,0,6,Eddie Irvine
22,56,17,1995,Rubens Barrichello,Eddie Irvine,11,10,1,Rubens Barrichello
22,84,17,1996,Rubens Barrichello,Martin Brundle,14,8,6,Rubens Barrichello
21,23,17,1997,Giancarlo Fisichella,Ralf Schumacher,20,13,7,Giancarlo Fisichella
23,71,17,1998,Ralf Schumacher,Damon Hill,14,20,6,Damon Hill
49,71,17,1999,Heinz-Harald Frentzen,Damon Hill,54,7,47,Heinz-Harald Frentzen
15,49,17,2000,Jarno Trulli,Heinz-Harald Frentzen,6,11,5,Heinz-Harald Frentzen
15,41,17,2001,Jarno Trulli,Ricardo Zonta,12,0,12,Jarno Trulli
15,49,17,2001,Jarno Trulli,Heinz-Harald Frentzen,12,6,6,Jarno Trulli
15,55,17,2001,Jarno Trulli,Jean Alesi,12,1,11,Jarno Trulli
41,49,17,2001,Ricardo Zonta,Heinz-Harald Frentzen,0,6,6,Heinz-Harald Frentzen
41,55,17,2001,Ricardo Zonta,Jean Alesi,0,1,1,Jean Alesi
49,55,17,2001,Heinz-Harald Frentzen,Jean Alesi,6,1,5,Heinz-Harald Frentzen
11,21,17,2002,Takuma Sato,Giancarlo Fisichella,2,7,5,Giancarlo Fisichella
21,47,17,2003,Giancarlo Fisichella,Zsolt Baumgartner,12,0,12,Giancarlo Fisichella
21,52,17,2003,Giancarlo Fisichella,Ralph Firman,12,1,11,Giancarlo Fisichella
47,52,17,2003,Zsolt Baumgartner,Ralph Firman,0,1,1,Ralph Firman
10,2,17,2004,Timo Glock,Nick Heidfeld,2,3,1,Nick Heidfeld
10,45,17,2004,Timo Glock,Giorgio Pantano,2,0,2,Timo Glock
2,45,17,2004,Nick Heidfeld,Giorgio Pantano,3,0,3,Nick Heidfeld
33,39,17,2005,Tiago Monteiro,Narain Karthikeyan,7,5,2,Tiago Monteiro
356,360,170,1959,Jack Brabham,Bruce McLaren,34,16,18,Jack Brabham
356,376,170,1959,Jack Brabham,Lucien Bianchi,34,0,34,Jack Brabham
356,401,170,1959,Jack Brabham,Trevor Taylor,34,0,34,Jack Brabham
356,418,170,1959,Jack Brabham,Masten Gregory,34,10,24,Jack Brabham
356,427,170,1959,Jack Brabham,Maurice Trintignant,34,19,15,Jack Brabham
356,441,170,1959,Jack Brabham,Tim Parnell,34,0,34,Jack Brabham
356,465,170,1959,Jack Brabham,Keith Greene,34,0,34,Jack Brabham
356,475,170,1959,Jack Brabham,Stirling Moss,34,18,16,Jack Brabham
356,481,170,1959,Jack Brabham,Henry Taylor,34,0,34,Jack Brabham
356,483,170,1959,Jack Brabham,Giorgio Scarlatti,34,0,34,Jack Brabham
356,486,170,1959,Jack Brabham,Jack Fairman,34,0,34,Jack Brabham
356,501,170,1959,Jack Brabham,Harry Schell,34,0,34,Jack Brabham
356,540,170,1959,Jack Brabham,Mike Taylor,34,0,34,Jack Brabham
356,549,170,1959,Jack Brabham,Ivor Bueb,34,0,34,Jack Brabham
356,550,170,1959,Jack Brabham,Alain de Changy,34,0,34,Jack Brabham
356,552,170,1959,Jack Brabham,Jean Lucienbonnet,34,0,34,Jack Brabham
356,569,170,1959,Jack Brabham,Peter Ashdown,34,0,34,Jack Brabham
356,570,170,1959,Jack Brabham,Bill Moss,34,0,34,Jack Brabham
360,376,170,1959,Bruce McLaren,Lucien Bianchi,16,0,16,Bruce McLaren
360,401,170,1959,Bruce McLaren,Trevor Taylor,16,0,16,Bruce McLaren
360,418,170,1959,Bruce McLaren,Masten Gregory,16,10,6,Bruce McLaren
360,427,170,1959,Bruce McLaren,Maurice Trintignant,16,19,3,Maurice Trintignant
360,441,170,1959,Bruce McLaren,Tim Parnell,16,0,16,Bruce McLaren
360,465,170,1959,Bruce McLaren,Keith Greene,16,0,16,Bruce McLaren
360,475,170,1959,Bruce McLaren,Stirling Moss,16,18,2,Stirling Moss
360,481,170,1959,Bruce McLaren,Henry Taylor,16,0,16,Bruce McLaren
360,483,170,1959,Bruce McLaren,Giorgio Scarlatti,16,0,16,Bruce McLaren
360,486,170,1959,Bruce McLaren,Jack Fairman,16,0,16,Bruce McLaren
360,501,170,1959,Bruce McLaren,Harry Schell,16,0,16,Bruce McLaren
360,540,170,1959,Bruce McLaren,Mike Taylor,16,0,16,Bruce McLaren
360,549,170,1959,Bruce McLaren,Ivor Bueb,16,0,16,Bruce McLaren
360,550,170,1959,Bruce McLaren,Alain de Changy,16,0,16,Bruce McLaren
360,552,170,1959,Bruce McLaren,Jean Lucienbonnet,16,0,16,Bruce McLaren
360,569,170,1959,Bruce McLaren,Peter Ashdown,16,0,16,Bruce McLaren
360,570,170,1959,Bruce McLaren,Bill Moss,16,0,16,Bruce McLaren
376,401,170,1959,Lucien Bianchi,Trevor Taylor,0,0,0,Trevor Taylor
376,418,170,1959,Lucien Bianchi,Masten Gregory,0,10,10,Masten Gregory
376,427,170,1959,Lucien Bianchi,Maurice Trintignant,0,19,19,Maurice Trintignant
376,441,170,1959,Lucien Bianchi,Tim Parnell,0,0,0,Tim Parnell
376,465,170,1959,Lucien Bianchi,Keith Greene,0,0,0,Keith Greene
376,475,170,1959,Lucien Bianchi,Stirling Moss,0,18,18,Stirling Moss
376,481,170,1959,Lucien Bianchi,Henry Taylor,0,0,0,Henry Taylor
376,483,170,1959,Lucien Bianchi,Giorgio Scarlatti,0,0,0,Giorgio Scarlatti
376,486,170,1959,Lucien Bianchi,Jack Fairman,0,0,0,Jack Fairman
376,501,170,1959,Lucien Bianchi,Harry Schell,0,0,0,Harry Schell
376,540,170,1959,Lucien Bianchi,Mike Taylor,0,0,0,Mike Taylor
376,549,170,1959,Lucien Bianchi,Ivor Bueb,0,0,0,Ivor Bueb
376,550,170,1959,Lucien Bianchi,Alain de Changy,0,0,0,Alain de Changy
376,552,170,1959,Lucien Bianchi,Jean Lucienbonnet,0,0,0,Jean Lucienbonnet
376,569,170,1959,Lucien Bianchi,Peter Ashdown,0,0,0,Peter Ashdown
376,570,170,1959,Lucien Bianchi,Bill Moss,0,0,0,Bill Moss
401,418,170,1959,Trevor Taylor,Masten Gregory,0,10,10,Masten Gregory
401,427,170,1959,Trevor Taylor,Maurice Trintignant,0,19,19,Maurice Trintignant
401,441,170,1959,Trevor Taylor,Tim Parnell,0,0,0,Tim Parnell
401,465,170,1959,Trevor Taylor,Keith Greene,0,0,0,Keith Greene
401,475,170,1959,Trevor Taylor,Stirling Moss,0,18,18,Stirling Moss
401,481,170,1959,Trevor Taylor,Henry Taylor,0,0,0,Henry Taylor
401,483,170,1959,Trevor Taylor,Giorgio Scarlatti,0,0,0,Giorgio Scarlatti
401,486,170,1959,Trevor Taylor,Jack Fairman,0,0,0,Jack Fairman
401,501,170,1959,Trevor Taylor,Harry Schell,0,0,0,Harry Schell
401,540,170,1959,Trevor Taylor,Mike Taylor,0,0,0,Mike Taylor
401,549,170,1959,Trevor Taylor,Ivor Bueb,0,0,0,Ivor Bueb
401,550,170,1959,Trevor Taylor,Alain de Changy,0,0,0,Alain de Changy
401,552,170,1959,Trevor Taylor,Jean Lucienbonnet,0,0,0,Jean Lucienbonnet
401,569,170,1959,Trevor Taylor,Peter Ashdown,0,0,0,Peter Ashdown
401,570,170,1959,Trevor Taylor,Bill Moss,0,0,0,Bill Moss
418,427,170,1959,Masten Gregory,Maurice Trintignant,10,19,9,Maurice Trintignant
418,441,170,1959,Masten Gregory,Tim Parnell,10,0,10,Masten Gregory
418,465,170,1959,Masten Gregory,Keith Greene,10,0,10,Masten Gregory
418,475,170,1959,Masten Gregory,Stirling Moss,10,18,8,Stirling Moss
418,481,170,1959,Masten Gregory,Henry Taylor,10,0,10,Masten Gregory
418,483,170,1959,Masten Gregory,Giorgio Scarlatti,10,0,10,Masten Gregory
418,486,170,1959,Masten Gregory,Jack Fairman,10,0,10,Masten Gregory
418,501,170,1959,Masten Gregory,Harry Schell,10,0,10,Masten Gregory
418,540,170,1959,Masten Gregory,Mike Taylor,10,0,10,Masten Gregory
418,549,170,1959,Masten Gregory,Ivor Bueb,10,0,10,Masten Gregory
418,550,170,1959,Masten Gregory,Alain de Changy,10,0,10,Masten Gregory
418,552,170,1959,Masten Gregory,Jean Lucienbonnet,10,0,10,Masten Gregory
418,569,170,1959,Masten Gregory,Peter Ashdown,10,0,10,Masten Gregory
418,570,170,1959,Masten Gregory,Bill Moss,10,0,10,Masten Gregory
427,441,170,1959,Maurice Trintignant,Tim Parnell,19,0,19,Maurice Trintignant
427,465,170,1959,Maurice Trintignant,Keith Greene,19,0,19,Maurice Trintignant
427,475,170,1959,Maurice Trintignant,Stirling Moss,19,18,1,Maurice Trintignant
427,481,170,1959,Maurice Trintignant,Henry Taylor,19,0,19,Maurice Trintignant
427,483,170,1959,Maurice Trintignant,Giorgio Scarlatti,19,0,19,Maurice Trintignant
427,486,170,1959,Maurice Trintignant,Jack Fairman,19,0,19,Maurice Trintignant
427,501,170,1959,Maurice Trintignant,Harry Schell,19,0,19,Maurice Trintignant
427,540,170,1959,Maurice Trintignant,Mike Taylor,19,0,19,Maurice Trintignant
427,549,170,1959,Maurice Trintignant,Ivor Bueb,19,0,19,Maurice Trintignant
427,550,170,1959,Maurice Trintignant,Alain de Changy,19,0,19,Maurice Trintignant
427,552,170,1959,Maurice Trintignant,Jean Lucienbonnet,19,0,19,Maurice Trintignant
427,569,170,1959,Maurice Trintignant,Peter Ashdown,19,0,19,Maurice Trintignant
427,570,170,1959,Maurice Trintignant,Bill Moss,19,0,19,Maurice Trintignant
441,465,170,1959,Tim Parnell,Keith Greene,0,0,0,Keith Greene
441,475,170,1959,Tim Parnell,Stirling Moss,0,18,18,Stirling Moss
441,481,170,1959,Tim Parnell,Henry Taylor,0,0,0,Henry Taylor
441,483,170,1959,Tim Parnell,Giorgio Scarlatti,0,0,0,Giorgio Scarlatti
441,486,170,1959,Tim Parnell,Jack Fairman,0,0,0,Jack Fairman
441,501,170,1959,Tim Parnell,Harry Schell,0,0,0,Harry Schell
441,540,170,1959,Tim Parnell,Mike Taylor,0,0,0,Mike Taylor
441,549,170,1959,Tim Parnell,Ivor Bueb,0,0,0,Ivor Bueb
441,550,170,1959,Tim Parnell,Alain de Changy,0,0,0,Alain de Changy
441,552,170,1959,Tim Parnell,Jean Lucienbonnet,0,0,0,Jean Lucienbonnet
441,569,170,1959,Tim Parnell,Peter Ashdown,0,0,0,Peter Ashdown
441,570,170,1959,Tim Parnell,Bill Moss,0,0,0,Bill Moss
465,475,170,1959,Keith Greene,Stirling Moss,0,18,18,Stirling Moss
465,481,170,1959,Keith Greene,Henry Taylor,0,0,0,Henry Taylor
465,483,170,1959,Keith Greene,Giorgio Scarlatti,0,0,0,Giorgio Scarlatti
465,486,170,1959,Keith Greene,Jack Fairman,0,0,0,Jack Fairman
465,501,170,1959,Keith Greene,Harry Schell,0,0,0,Harry Schell
465,540,170,1959,Keith Greene,Mike Taylor,0,0,0,Mike Taylor
465,549,170,1959,Keith Greene,Ivor Bueb,0,0,0,Ivor Bueb
465,550,170,1959,Keith Greene,Alain de Changy,0,0,0,Alain de Changy
465,552,170,1959,Keith Greene,Jean Lucienbonnet,0,0,0,Jean Lucienbonnet
465,569,170,1959,Keith Greene,Peter Ashdown,0,0,0,Peter Ashdown
465,570,170,1959,Keith Greene,Bill Moss,0,0,0,Bill Moss
475,481,170,1959,Stirling Moss,Henry Taylor,18,0,18,Stirling Moss
475,483,170,1959,Stirling Moss,Giorgio Scarlatti,18,0,18,Stirling Moss
475,486,170,1959,Stirling Moss,Jack Fairman,18,0,18,Stirling Moss
475,501,170,1959,Stirling Moss,Harry Schell,18,0,18,Stirling Moss
475,540,170,1959,Stirling Moss,Mike Taylor,18,0,18,Stirling Moss
475,549,170,1959,Stirling Moss,Ivor Bueb,18,0,18,Stirling Moss
475,550,170,1959,Stirling Moss,Alain de Changy,18,0,18,Stirling Moss
475,552,170,1959,Stirling Moss,Jean Lucienbonnet,18,0,18,Stirling Moss
475,569,170,1959,Stirling Moss,Peter Ashdown,18,0,18,Stirling Moss
475,570,170,1959,Stirling Moss,Bill Moss,18,0,18,Stirling Moss
481,483,170,1959,Henry Taylor,Giorgio Scarlatti,0,0,0,Giorgio Scarlatti
481,486,170,1959,Henry Taylor,Jack Fairman,0,0,0,Jack Fairman
481,501,170,1959,Henry Taylor,Harry Schell,0,0,0,Harry Schell
481,540,170,1959,Henry Taylor,Mike Taylor,0,0,0,Mike Taylor
481,549,170,1959,Henry Taylor,Ivor Bueb,0,0,0,Ivor Bueb
481,550,170,1959,Henry Taylor,Alain de Changy,0,0,0,Alain de Changy
481,552,170,1959,Henry Taylor,Jean Lucienbonnet,0,0,0,Jean Lucienbonnet
481,569,170,1959,Henry Taylor,Peter Ashdown,0,0,0,Peter Ashdown
481,570,170,1959,Henry Taylor,Bill Moss,0,0,0,Bill Moss
483,486,170,1959,Giorgio Scarlatti,Jack Fairman,0,0,0,Jack Fairman
483,501,170,1959,Giorgio Scarlatti,Harry Schell,0,0,0,Harry Schell
483,540,170,1959,Giorgio Scarlatti,Mike Taylor,0,0,0,Mike Taylor
483,549,170,1959,Giorgio Scarlatti,Ivor Bueb,0,0,0,Ivor Bueb
483,550,170,1959,Giorgio Scarlatti,Alain de Changy,0,0,0,Alain de Changy
483,552,170,1959,Giorgio Scarlatti,Jean Lucienbonnet,0,0,0,Jean Lucienbonnet
483,569,170,1959,Giorgio Scarlatti,Peter Ashdown,0,0,0,Peter Ashdown
483,570,170,1959,Giorgio Scarlatti,Bill Moss,0,0,0,Bill Moss
486,501,170,1959,Jack Fairman,Harry Schell,0,0,0,Harry Schell
486,540,170,1959,Jack Fairman,Mike Taylor,0,0,0,Mike Taylor
486,549,170,1959,Jack Fairman,Ivor Bueb,0,0,0,Ivor Bueb
486,550,170,1959,Jack Fairman,Alain de Changy,0,0,0,Alain de Changy
486,552,170,1959,Jack Fairman,Jean Lucienbonnet,0,0,0,Jean Lucienbonnet
486,569,170,1959,Jack Fairman,Peter Ashdown,0,0,0,Peter Ashdown
486,570,170,1959,Jack Fairman,Bill Moss,0,0,0,Bill Moss
501,540,170,1959,Harry Schell,Mike Taylor,0,0,0,Mike Taylor
501,549,170,1959,Harry Schell,Ivor Bueb,0,0,0,Ivor Bueb
501,550,170,1959,Harry Schell,Alain de Changy,0,0,0,Alain de Changy
501,552,170,1959,Harry Schell,Jean Lucienbonnet,0,0,0,Jean Lucienbonnet
501,569,170,1959,Harry Schell,Peter Ashdown,0,0,0,Peter Ashdown
501,570,170,1959,Harry Schell,Bill Moss,0,0,0,Bill Moss
540,549,170,1959,Mike Taylor,Ivor Bueb,0,0,0,Ivor Bueb
540,550,170,1959,Mike Taylor,Alain de Changy,0,0,0,Alain de Changy
540,552,170,1959,Mike Taylor,Jean Lucienbonnet,0,0,0,Jean Lucienbonnet
540,569,170,1959,Mike Taylor,Peter Ashdown,0,0,0,Peter Ashdown
540,570,170,1959,Mike Taylor,Bill Moss,0,0,0,Bill Moss
549,550,170,1959,Ivor Bueb,Alain de Changy,0,0,0,Alain de Changy
549,552,170,1959,Ivor Bueb,Jean Lucienbonnet,0,0,0,Jean Lucienbonnet
549,569,170,1959,Ivor Bueb,Peter Ashdown,0,0,0,Peter Ashdown
549,570,170,1959,Ivor Bueb,Bill Moss,0,0,0,Bill Moss
550,552,170,1959,Alain de Changy,Jean Lucienbonnet,0,0,0,Jean Lucienbonnet
550,569,170,1959,Alain de Changy,Peter Ashdown,0,0,0,Peter Ashdown
550,570,170,1959,Alain de Changy,Bill Moss,0,0,0,Bill Moss
552,569,170,1959,Jean Lucienbonnet,Peter Ashdown,0,0,0,Peter Ashdown
552,570,170,1959,Jean Lucienbonnet,Bill Moss,0,0,0,Bill Moss
569,570,170,1959,Peter Ashdown,Bill Moss,0,0,0,Bill Moss
356,360,170,1960,Jack Brabham,Bruce McLaren,43,37,6,Jack Brabham
356,376,170,1960,Jack Brabham,Lucien Bianchi,43,1,42,Jack Brabham
356,398,170,1960,Jack Brabham,Vic Wilson,43,0,43,Jack Brabham
356,403,170,1960,Jack Brabham,Phil Hill,43,1,42,Jack Brabham
356,427,170,1960,Jack Brabham,Maurice Trintignant,43,0,43,Jack Brabham
356,430,170,1960,Jack Brabham,Carel Godin de Beaufort,43,0,43,Jack Brabham
356,455,170,1960,Jack Brabham,Wolfgang Seidel,43,0,43,Jack Brabham
356,456,170,1960,Jack Brabham,Roy Salvadori,43,0,43,Jack Brabham
356,475,170,1960,Jack Brabham,Stirling Moss,43,0,43,Jack Brabham
356,479,170,1960,Jack Brabham,Tony Brooks,43,7,36,Jack Brabham
356,481,170,1960,Jack Brabham,Henry Taylor,43,3,40,Jack Brabham
356,482,170,1960,Jack Brabham,Olivier Gendebien,43,10,33,Jack Brabham
356,486,170,1960,Jack Brabham,Jack Fairman,43,0,43,Jack Brabham
356,501,170,1960,Jack Brabham,Harry Schell,43,0,43,Jack Brabham
356,505,170,1960,Jack Brabham,Chris Bristow,43,0,43,Jack Brabham
356,506,170,1960,Jack Brabham,Bruce Halford,43,0,43,Jack Brabham
356,507,170,1960,Jack Brabham,Chuck Daigh,43,0,43,Jack Brabham
356,508,170,1960,Jack Brabham,Lance Reventlow,43,0,43,Jack Brabham
356,541,170,1960,Jack Brabham,Ron Flockhart,43,0,43,Jack Brabham
356,544,170,1960,Jack Brabham,Piero Drogo,43,0,43,Jack Brabham
356,546,170,1960,Jack Brabham,Arthur Owen,43,0,43,Jack Brabham
360,376,170,1960,Bruce McLaren,Lucien Bianchi,37,1,36,Bruce McLaren
360,398,170,1960,Bruce McLaren,Vic Wilson,37,0,37,Bruce McLaren
360,403,170,1960,Bruce McLaren,Phil Hill,37,1,36,Bruce McLaren
360,427,170,1960,Bruce McLaren,Maurice Trintignant,37,0,37,Bruce McLaren
360,430,170,1960,Bruce McLaren,Carel Godin de Beaufort,37,0,37,Bruce McLaren
360,455,170,1960,Bruce McLaren,Wolfgang Seidel,37,0,37,Bruce McLaren
360,456,170,1960,Bruce McLaren,Roy Salvadori,37,0,37,Bruce McLaren
360,475,170,1960,Bruce McLaren,Stirling Moss,37,0,37,Bruce McLaren
360,479,170,1960,Bruce McLaren,Tony Brooks,37,7,30,Bruce McLaren
360,481,170,1960,Bruce McLaren,Henry Taylor,37,3,34,Bruce McLaren
360,482,170,1960,Bruce McLaren,Olivier Gendebien,37,10,27,Bruce McLaren
360,486,170,1960,Bruce McLaren,Jack Fairman,37,0,37,Bruce McLaren
360,501,170,1960,Bruce McLaren,Harry Schell,37,0,37,Bruce McLaren
360,505,170,1960,Bruce McLaren,Chris Bristow,37,0,37,Bruce McLaren
360,506,170,1960,Bruce McLaren,Bruce Halford,37,0,37,Bruce McLaren
360,507,170,1960,Bruce McLaren,Chuck Daigh,37,0,37,Bruce McLaren
360,508,170,1960,Bruce McLaren,Lance Reventlow,37,0,37,Bruce McLaren
360,541,170,1960,Bruce McLaren,Ron Flockhart,37,0,37,Bruce McLaren
360,544,170,1960,Bruce McLaren,Piero Drogo,37,0,37,Bruce McLaren
360,546,170,1960,Bruce McLaren,Arthur Owen,37,0,37,Bruce McLaren
376,398,170,1960,Lucien Bianchi,Vic Wilson,1,0,1,Lucien Bianchi
376,403,170,1960,Lucien Bianchi,Phil Hill,1,1,0,Phil Hill
376,427,170,1960,Lucien Bianchi,Maurice Trintignant,1,0,1,Lucien Bianchi
376,430,170,1960,Lucien Bianchi,Carel Godin de Beaufort,1,0,1,Lucien Bianchi
376,455,170,1960,Lucien Bianchi,Wolfgang Seidel,1,0,1,Lucien Bianchi
376,456,170,1960,Lucien Bianchi,Roy Salvadori,1,0,1,Lucien Bianchi
376,475,170,1960,Lucien Bianchi,Stirling Moss,1,0,1,Lucien Bianchi
376,479,170,1960,Lucien Bianchi,Tony Brooks,1,7,6,Tony Brooks
376,481,170,1960,Lucien Bianchi,Henry Taylor,1,3,2,Henry Taylor
376,482,170,1960,Lucien Bianchi,Olivier Gendebien,1,10,9,Olivier Gendebien
376,486,170,1960,Lucien Bianchi,Jack Fairman,1,0,1,Lucien Bianchi
376,501,170,1960,Lucien Bianchi,Harry Schell,1,0,1,Lucien Bianchi
376,505,170,1960,Lucien Bianchi,Chris Bristow,1,0,1,Lucien Bianchi
376,506,170,1960,Lucien Bianchi,Bruce Halford,1,0,1,Lucien Bianchi
376,507,170,1960,Lucien Bianchi,Chuck Daigh,1,0,1,Lucien Bianchi
376,508,170,1960,Lucien Bianchi,Lance Reventlow,1,0,1,Lucien Bianchi
376,541,170,1960,Lucien Bianchi,Ron Flockhart,1,0,1,Lucien Bianchi
376,544,170,1960,Lucien Bianchi,Piero Drogo,1,0,1,Lucien Bianchi
376,546,170,1960,Lucien Bianchi,Arthur Owen,1,0,1,Lucien Bianchi
398,403,170,1960,Vic Wilson,Phil Hill,0,1,1,Phil Hill
398,427,170,1960,Vic Wilson,Maurice Trintignant,0,0,0,Maurice Trintignant
398,430,170,1960,Vic Wilson,Carel Godin de Beaufort,0,0,0,Carel Godin de Beaufort
398,455,170,1960,Vic Wilson,Wolfgang Seidel,0,0,0,Wolfgang Seidel
398,456,170,1960,Vic Wilson,Roy Salvadori,0,0,0,Roy Salvadori
398,475,170,1960,Vic Wilson,Stirling Moss,0,0,0,Stirling Moss
398,479,170,1960,Vic Wilson,Tony Brooks,0,7,7,Tony Brooks
398,481,170,1960,Vic Wilson,Henry Taylor,0,3,3,Henry Taylor
398,482,170,1960,Vic Wilson,Olivier Gendebien,0,10,10,Olivier Gendebien
398,486,170,1960,Vic Wilson,Jack Fairman,0,0,0,Jack Fairman
398,501,170,1960,Vic Wilson,Harry Schell,0,0,0,Harry Schell
398,505,170,1960,Vic Wilson,Chris Bristow,0,0,0,Chris Bristow
398,506,170,1960,Vic Wilson,Bruce Halford,0,0,0,Bruce Halford
398,507,170,1960,Vic Wilson,Chuck Daigh,0,0,0,Chuck Daigh
398,508,170,1960,Vic Wilson,Lance Reventlow,0,0,0,Lance Reventlow
398,541,170,1960,Vic Wilson,Ron Flockhart,0,0,0,Ron Flockhart
398,544,170,1960,Vic Wilson,Piero Drogo,0,0,0,Piero Drogo
398,546,170,1960,Vic Wilson,Arthur Owen,0,0,0,Arthur Owen
403,427,170,1960,Phil Hill,Maurice Trintignant,1,0,1,Phil Hill
403,430,170,1960,Phil Hill,Carel Godin de Beaufort,1,0,1,Phil Hill
403,455,170,1960,Phil Hill,Wolfgang Seidel,1,0,1,Phil Hill
403,456,170,1960,Phil Hill,Roy Salvadori,1,0,1,Phil Hill
403,475,170,1960,Phil Hill,Stirling Moss,1,0,1,Phil Hill
403,479,170,1960,Phil Hill,Tony Brooks,1,7,6,Tony Brooks
403,481,170,1960,Phil Hill,Henry Taylor,1,3,2,Henry Taylor
403,482,170,1960,Phil Hill,Olivier Gendebien,1,10,9,Olivier Gendebien
403,486,170,1960,Phil Hill,Jack Fairman,1,0,1,Phil Hill
403,501,170,1960,Phil Hill,Harry Schell,1,0,1,Phil Hill
403,505,170,1960,Phil Hill,Chris Bristow,1,0,1,Phil Hill
403,506,170,1960,Phil Hill,Bruce Halford,1,0,1,Phil Hill
403,507,170,1960,Phil Hill,Chuck Daigh,1,0,1,Phil Hill
403,508,170,1960,Phil Hill,Lance Reventlow,1,0,1,Phil Hill
403,541,170,1960,Phil Hill,Ron Flockhart,1,0,1,Phil Hill
403,544,170,1960,Phil Hill,Piero Drogo,1,0,1,Phil Hill
403,546,170,1960,Phil Hill,Arthur Owen,1,0,1,Phil Hill
427,430,170,1960,Maurice Trintignant,Carel Godin de Beaufort,0,0,0,Carel Godin de Beaufort
427,455,170,1960,Maurice Trintignant,Wolfgang Seidel,0,0,0,Wolfgang Seidel
427,456,170,1960,Maurice Trintignant,Roy Salvadori,0,0,0,Roy Salvadori
427,475,170,1960,Maurice Trintignant,Stirling Moss,0,0,0,Stirling Moss
427,479,170,1960,Maurice Trintignant,Tony Brooks,0,7,7,Tony Brooks
427,481,170,1960,Maurice Trintignant,Henry Taylor,0,3,3,Henry Taylor
427,482,170,1960,Maurice Trintignant,Olivier Gendebien,0,10,10,Olivier Gendebien
427,486,170,1960,Maurice Trintignant,Jack Fairman,0,0,0,Jack Fairman
427,501,170,1960,Maurice Trintignant,Harry Schell,0,0,0,Harry Schell
427,505,170,1960,Maurice Trintignant,Chris Bristow,0,0,0,Chris Bristow
427,506,170,1960,Maurice Trintignant,Bruce Halford,0,0,0,Bruce Halford
427,507,170,1960,Maurice Trintignant,Chuck Daigh,0,0,0,Chuck Daigh
427,508,170,1960,Maurice Trintignant,Lance Reventlow,0,0,0,Lance Reventlow
427,541,170,1960,Maurice Trintignant,Ron Flockhart,0,0,0,Ron Flockhart
427,544,170,1960,Maurice Trintignant,Piero Drogo,0,0,0,Piero Drogo
427,546,170,1960,Maurice Trintignant,Arthur Owen,0,0,0,Arthur Owen
430,455,170,1960,Carel Godin de Beaufort,Wolfgang Seidel,0,0,0,Wolfgang Seidel
430,456,170,1960,Carel Godin de Beaufort,Roy Salvadori,0,0,0,Roy Salvadori
430,475,170,1960,Carel Godin de Beaufort,Stirling Moss,0,0,0,Stirling Moss
430,479,170,1960,Carel Godin de Beaufort,Tony Brooks,0,7,7,Tony Brooks
430,481,170,1960,Carel Godin de Beaufort,Henry Taylor,0,3,3,Henry Taylor
430,482,170,1960,Carel Godin de Beaufort,Olivier Gendebien,0,10,10,Olivier Gendebien
430,486,170,1960,Carel Godin de Beaufort,Jack Fairman,0,0,0,Jack Fairman
430,501,170,1960,Carel Godin de Beaufort,Harry Schell,0,0,0,Harry Schell
430,505,170,1960,Carel Godin de Beaufort,Chris Bristow,0,0,0,Chris Bristow
430,506,170,1960,Carel Godin de Beaufort,Bruce Halford,0,0,0,Bruce Halford
430,507,170,1960,Carel Godin de Beaufort,Chuck Daigh,0,0,0,Chuck Daigh
430,508,170,1960,Carel Godin de Beaufort,Lance Reventlow,0,0,0,Lance Reventlow
430,541,170,1960,Carel Godin de Beaufort,Ron Flockhart,0,0,0,Ron Flockhart
430,544,170,1960,Carel Godin de Beaufort,Piero Drogo,0,0,0,Piero Drogo
430,546,170,1960,Carel Godin de Beaufort,Arthur Owen,0,0,0,Arthur Owen
455,456,170,1960,Wolfgang Seidel,Roy Salvadori,0,0,0,Roy Salvadori
455,475,170,1960,Wolfgang Seidel,Stirling Moss,0,0,0,Stirling Moss
455,479,170,1960,Wolfgang Seidel,Tony Brooks,0,7,7,Tony Brooks
455,481,170,1960,Wolfgang Seidel,Henry Taylor,0,3,3,Henry Taylor
455,482,170,1960,Wolfgang Seidel,Olivier Gendebien,0,10,10,Olivier Gendebien
455,486,170,1960,Wolfgang Seidel,Jack Fairman,0,0,0,Jack Fairman
455,501,170,1960,Wolfgang Seidel,Harry Schell,0,0,0,Harry Schell
455,505,170,1960,Wolfgang Seidel,Chris Bristow,0,0,0,Chris Bristow
455,506,170,1960,Wolfgang Seidel,Bruce Halford,0,0,0,Bruce Halford
455,507,170,1960,Wolfgang Seidel,Chuck Daigh,0,0,0,Chuck Daigh
455,508,170,1960,Wolfgang Seidel,Lance Reventlow,0,0,0,Lance Reventlow
455,541,170,1960,Wolfgang Seidel,Ron Flockhart,0,0,0,Ron Flockhart
455,544,170,1960,Wolfgang Seidel,Piero Drogo,0,0,0,Piero Drogo
455,546,170,1960,Wolfgang Seidel,Arthur Owen,0,0,0,Arthur Owen
456,475,170,1960,Roy Salvadori,Stirling Moss,0,0,0,Stirling Moss
456,479,170,1960,Roy Salvadori,Tony Brooks,0,7,7,Tony Brooks
456,481,170,1960,Roy Salvadori,Henry Taylor,0,3,3,Henry Taylor
456,482,170,1960,Roy Salvadori,Olivier Gendebien,0,10,10,Olivier Gendebien
456,486,170,1960,Roy Salvadori,Jack Fairman,0,0,0,Jack Fairman
456,501,170,1960,Roy Salvadori,Harry Schell,0,0,0,Harry Schell
456,505,170,1960,Roy Salvadori,Chris Bristow,0,0,0,Chris Bristow
456,506,170,1960,Roy Salvadori,Bruce Halford,0,0,0,Bruce Halford
456,507,170,1960,Roy Salvadori,Chuck Daigh,0,0,0,Chuck Daigh
456,508,170,1960,Roy Salvadori,Lance Reventlow,0,0,0,Lance Reventlow
456,541,170,1960,Roy Salvadori,Ron Flockhart,0,0,0,Ron Flockhart
456,544,170,1960,Roy Salvadori,Piero Drogo,0,0,0,Piero Drogo
456,546,170,1960,Roy Salvadori,Arthur Owen,0,0,0,Arthur Owen
475,479,170,1960,Stirling Moss,Tony Brooks,0,7,7,Tony Brooks
475,481,170,1960,Stirling Moss,Henry Taylor,0,3,3,Henry Taylor
475,482,170,1960,Stirling Moss,Olivier Gendebien,0,10,10,Olivier Gendebien
475,486,170,1960,Stirling Moss,Jack Fairman,0,0,0,Jack Fairman
475,501,170,1960,Stirling Moss,Harry Schell,0,0,0,Harry Schell
475,505,170,1960,Stirling Moss,Chris Bristow,0,0,0,Chris Bristow
475,506,170,1960,Stirling Moss,Bruce Halford,0,0,0,Bruce Halford
475,507,170,1960,Stirling Moss,Chuck Daigh,0,0,0,Chuck Daigh
475,508,170,1960,Stirling Moss,Lance Reventlow,0,0,0,Lance Reventlow
475,541,170,1960,Stirling Moss,Ron Flockhart,0,0,0,Ron Flockhart
475,544,170,1960,Stirling Moss,Piero Drogo,0,0,0,Piero Drogo
475,546,170,1960,Stirling Moss,Arthur Owen,0,0,0,Arthur Owen
479,481,170,1960,Tony Brooks,Henry Taylor,7,3,4,Tony Brooks
479,482,170,1960,Tony Brooks,Olivier Gendebien,7,10,3,Olivier Gendebien
479,486,170,1960,Tony Brooks,Jack Fairman,7,0,7,Tony Brooks
479,501,170,1960,Tony Brooks,Harry Schell,7,0,7,Tony Brooks
479,505,170,1960,Tony Brooks,Chris Bristow,7,0,7,Tony Brooks
479,506,170,1960,Tony Brooks,Bruce Halford,7,0,7,Tony Brooks
479,507,170,1960,Tony Brooks,Chuck Daigh,7,0,7,Tony Brooks
479,508,170,1960,Tony Brooks,Lance Reventlow,7,0,7,Tony Brooks
479,541,170,1960,Tony Brooks,Ron Flockhart,7,0,7,Tony Brooks
479,544,170,1960,Tony Brooks,Piero Drogo,7,0,7,Tony Brooks
479,546,170,1960,Tony Brooks,Arthur Owen,7,0,7,Tony Brooks
481,482,170,1960,Henry Taylor,Olivier Gendebien,3,10,7,Olivier Gendebien
481,486,170,1960,Henry Taylor,Jack Fairman,3,0,3,Henry Taylor
481,501,170,1960,Henry Taylor,Harry Schell,3,0,3,Henry Taylor
481,505,170,1960,Henry Taylor,Chris Bristow,3,0,3,Henry Taylor
481,506,170,1960,Henry Taylor,Bruce Halford,3,0,3,Henry Taylor
481,507,170,1960,Henry Taylor,Chuck Daigh,3,0,3,Henry Taylor
481,508,170,1960,Henry Taylor,Lance Reventlow,3,0,3,Henry Taylor
481,541,170,1960,Henry Taylor,Ron Flockhart,3,0,3,Henry Taylor
481,544,170,1960,Henry Taylor,Piero Drogo,3,0,3,Henry Taylor
481,546,170,1960,Henry Taylor,Arthur Owen,3,0,3,Henry Taylor
482,486,170,1960,Olivier Gendebien,Jack Fairman,10,0,10,Olivier Gendebien
482,501,170,1960,Olivier Gendebien,Harry Schell,10,0,10,Olivier Gendebien
482,505,170,1960,Olivier Gendebien,Chris Bristow,10,0,10,Olivier Gendebien
482,506,170,1960,Olivier Gendebien,Bruce Halford,10,0,10,Olivier Gendebien
482,507,170,1960,Olivier Gendebien,Chuck Daigh,10,0,10,Olivier Gendebien
482,508,170,1960,Olivier Gendebien,Lance Reventlow,10,0,10,Olivier Gendebien
482,541,170,1960,Olivier Gendebien,Ron Flockhart,10,0,10,Olivier Gendebien
482,544,170,1960,Olivier Gendebien,Piero Drogo,10,0,10,Olivier Gendebien
482,546,170,1960,Olivier Gendebien,Arthur Owen,10,0,10,Olivier Gendebien
486,501,170,1960,Jack Fairman,Harry Schell,0,0,0,Harry Schell
486,505,170,1960,Jack Fairman,Chris Bristow,0,0,0,Chris Bristow
486,506,170,1960,Jack Fairman,Bruce Halford,0,0,0,Bruce Halford
486,507,170,1960,Jack Fairman,Chuck Daigh,0,0,0,Chuck Daigh
486,508,170,1960,Jack Fairman,Lance Reventlow,0,0,0,Lance Reventlow
486,541,170,1960,Jack Fairman,Ron Flockhart,0,0,0,Ron Flockhart
486,544,170,1960,Jack Fairman,Piero Drogo,0,0,0,Piero Drogo
486,546,170,1960,Jack Fairman,Arthur Owen,0,0,0,Arthur Owen
501,505,170,1960,Harry Schell,Chris Bristow,0,0,0,Chris Bristow
501,506,170,1960,Harry Schell,Bruce Halford,0,0,0,Bruce Halford
501,507,170,1960,Harry Schell,Chuck Daigh,0,0,0,Chuck Daigh
501,508,170,1960,Harry Schell,Lance Reventlow,0,0,0,Lance Reventlow
501,541,170,1960,Harry Schell,Ron Flockhart,0,0,0,Ron Flockhart
501,544,170,1960,Harry Schell,Piero Drogo,0,0,0,Piero Drogo
501,546,170,1960,Harry Schell,Arthur Owen,0,0,0,Arthur Owen
505,506,170,1960,Chris Bristow,Bruce Halford,0,0,0,Bruce Halford
505,507,170,1960,Chris Bristow,Chuck Daigh,0,0,0,Chuck Daigh
505,508,170,1960,Chris Bristow,Lance Reventlow,0,0,0,Lance Reventlow
505,541,170,1960,Chris Bristow,Ron Flockhart,0,0,0,Ron Flockhart
505,544,170,1960,Chris Bristow,Piero Drogo,0,0,0,Piero Drogo
505,546,170,1960,Chris Bristow,Arthur Owen,0,0,0,Arthur Owen
506,507,170,1960,Bruce Halford,Chuck Daigh,0,0,0,Chuck Daigh
506,508,170,1960,Bruce Halford,Lance Reventlow,0,0,0,Lance Reventlow
506,541,170,1960,Bruce Halford,Ron Flockhart,0,0,0,Ron Flockhart
506,544,170,1960,Bruce Halford,Piero Drogo,0,0,0,Piero Drogo
506,546,170,1960,Bruce Halford,Arthur Owen,0,0,0,Arthur Owen
507,508,170,1960,Chuck Daigh,Lance Reventlow,0,0,0,Lance Reventlow
507,541,170,1960,Chuck Daigh,Ron Flockhart,0,0,0,Ron Flockhart
507,544,170,1960,Chuck Daigh,Piero Drogo,0,0,0,Piero Drogo
507,546,170,1960,Chuck Daigh,Arthur Owen,0,0,0,Arthur Owen
508,541,170,1960,Lance Reventlow,Ron Flockhart,0,0,0,Ron Flockhart
508,544,170,1960,Lance Reventlow,Piero Drogo,0,0,0,Piero Drogo
508,546,170,1960,Lance Reventlow,Arthur Owen,0,0,0,Arthur Owen
541,544,170,1960,Ron Flockhart,Piero Drogo,0,0,0,Piero Drogo
541,546,170,1960,Ron Flockhart,Arthur Owen,0,0,0,Arthur Owen
544,546,170,1960,Piero Drogo,Arthur Owen,0,0,0,Arthur Owen
341,356,170,1961,John Surtees,Jack Brabham,4,4,0,Jack Brabham
341,360,170,1961,John Surtees,Bruce McLaren,4,11,7,Bruce McLaren
341,418,170,1961,John Surtees,Masten Gregory,4,0,4,John Surtees
341,428,170,1961,John Surtees,Bernard Collomb,4,0,4,John Surtees
341,433,170,1961,John Surtees,Walt Hansgen,4,0,4,John Surtees
341,434,170,1961,John Surtees,Hap Sharp,4,0,4,John Surtees
341,436,170,1961,John Surtees,John Campbell-Jones,4,0,4,John Surtees
341,437,170,1961,John Surtees,Ian Burgess,4,0,4,John Surtees
341,453,170,1961,John Surtees,Jackie Lewis,4,3,1,John Surtees
341,456,170,1961,John Surtees,Roy Salvadori,4,2,2,John Surtees
341,468,170,1961,John Surtees,Roger Penske,4,0,4,John Surtees
341,486,170,1961,John Surtees,Jack Fairman,4,0,4,John Surtees
341,489,170,1961,John Surtees,Renato Pirocchi,4,0,4,John Surtees
341,490,170,1961,John Surtees,Geoff Duke,4,0,4,John Surtees
341,491,170,1961,John Surtees,Alfonso Thiele,4,0,4,John Surtees
341,492,170,1961,John Surtees,Menato Boffa,4,0,4,John Surtees
356,360,170,1961,Jack Brabham,Bruce McLaren,4,11,7,Bruce McLaren
356,418,170,1961,Jack Brabham,Masten Gregory,4,0,4,Jack Brabham
356,428,170,1961,Jack Brabham,Bernard Collomb,4,0,4,Jack Brabham
356,433,170,1961,Jack Brabham,Walt Hansgen,4,0,4,Jack Brabham
356,434,170,1961,Jack Brabham,Hap Sharp,4,0,4,Jack Brabham
356,436,170,1961,Jack Brabham,John Campbell-Jones,4,0,4,Jack Brabham
356,437,170,1961,Jack Brabham,Ian Burgess,4,0,4,Jack Brabham
356,453,170,1961,Jack Brabham,Jackie Lewis,4,3,1,Jack Brabham
356,456,170,1961,Jack Brabham,Roy Salvadori,4,2,2,Jack Brabham
356,468,170,1961,Jack Brabham,Roger Penske,4,0,4,Jack Brabham
356,486,170,1961,Jack Brabham,Jack Fairman,4,0,4,Jack Brabham
356,489,170,1961,Jack Brabham,Renato Pirocchi,4,0,4,Jack Brabham
356,490,170,1961,Jack Brabham,Geoff Duke,4,0,4,Jack Brabham
356,491,170,1961,Jack Brabham,Alfonso Thiele,4,0,4,Jack Brabham
356,492,170,1961,Jack Brabham,Menato Boffa,4,0,4,Jack Brabham
360,418,170,1961,Bruce McLaren,Masten Gregory,11,0,11,Bruce McLaren
360,428,170,1961,Bruce McLaren,Bernard Collomb,11,0,11,Bruce McLaren
360,433,170,1961,Bruce McLaren,Walt Hansgen,11,0,11,Bruce McLaren
360,434,170,1961,Bruce McLaren,Hap Sharp,11,0,11,Bruce McLaren
360,436,170,1961,Bruce McLaren,John Campbell-Jones,11,0,11,Bruce McLaren
360,437,170,1961,Bruce McLaren,Ian Burgess,11,0,11,Bruce McLaren
360,453,170,1961,Bruce McLaren,Jackie Lewis,11,3,8,Bruce McLaren
360,456,170,1961,Bruce McLaren,Roy Salvadori,11,2,9,Bruce McLaren
360,468,170,1961,Bruce McLaren,Roger Penske,11,0,11,Bruce McLaren
360,486,170,1961,Bruce McLaren,Jack Fairman,11,0,11,Bruce McLaren
360,489,170,1961,Bruce McLaren,Renato Pirocchi,11,0,11,Bruce McLaren
360,490,170,1961,Bruce McLaren,Geoff Duke,11,0,11,Bruce McLaren
360,491,170,1961,Bruce McLaren,Alfonso Thiele,11,0,11,Bruce McLaren
360,492,170,1961,Bruce McLaren,Menato Boffa,11,0,11,Bruce McLaren
418,428,170,1961,Masten Gregory,Bernard Collomb,0,0,0,Bernard Collomb
418,433,170,1961,Masten Gregory,Walt Hansgen,0,0,0,Walt Hansgen
418,434,170,1961,Masten Gregory,Hap Sharp,0,0,0,Hap Sharp
418,436,170,1961,Masten Gregory,John Campbell-Jones,0,0,0,John Campbell-Jones
418,437,170,1961,Masten Gregory,Ian Burgess,0,0,0,Ian Burgess
418,453,170,1961,Masten Gregory,Jackie Lewis,0,3,3,Jackie Lewis
418,456,170,1961,Masten Gregory,Roy Salvadori,0,2,2,Roy Salvadori
418,468,170,1961,Masten Gregory,Roger Penske,0,0,0,Roger Penske
418,486,170,1961,Masten Gregory,Jack Fairman,0,0,0,Jack Fairman
418,489,170,1961,Masten Gregory,Renato Pirocchi,0,0,0,Renato Pirocchi
418,490,170,1961,Masten Gregory,Geoff Duke,0,0,0,Geoff Duke
418,491,170,1961,Masten Gregory,Alfonso Thiele,0,0,0,Alfonso Thiele
418,492,170,1961,Masten Gregory,Menato Boffa,0,0,0,Menato Boffa
428,433,170,1961,Bernard Collomb,Walt Hansgen,0,0,0,Walt Hansgen
428,434,170,1961,Bernard Collomb,Hap Sharp,0,0,0,Hap Sharp
428,436,170,1961,Bernard Collomb,John Campbell-Jones,0,0,0,John Campbell-Jones
428,437,170,1961,Bernard Collomb,Ian Burgess,0,0,0,Ian Burgess
428,453,170,1961,Bernard Collomb,Jackie Lewis,0,3,3,Jackie Lewis
428,456,170,1961,Bernard Collomb,Roy Salvadori,0,2,2,Roy Salvadori
428,468,170,1961,Bernard Collomb,Roger Penske,0,0,0,Roger Penske
428,486,170,1961,Bernard Collomb,Jack Fairman,0,0,0,Jack Fairman
428,489,170,1961,Bernard Collomb,Renato Pirocchi,0,0,0,Renato Pirocchi
428,490,170,1961,Bernard Collomb,Geoff Duke,0,0,0,Geoff Duke
428,491,170,1961,Bernard Collomb,Alfonso Thiele,0,0,0,Alfonso Thiele
428,492,170,1961,Bernard Collomb,Menato Boffa,0,0,0,Menato Boffa
433,434,170,1961,Walt Hansgen,Hap Sharp,0,0,0,Hap Sharp
433,436,170,1961,Walt Hansgen,John Campbell-Jones,0,0,0,John Campbell-Jones
433,437,170,1961,Walt Hansgen,Ian Burgess,0,0,0,Ian Burgess
433,453,170,1961,Walt Hansgen,Jackie Lewis,0,3,3,Jackie Lewis
433,456,170,1961,Walt Hansgen,Roy Salvadori,0,2,2,Roy Salvadori
433,468,170,1961,Walt Hansgen,Roger Penske,0,0,0,Roger Penske
433,486,170,1961,Walt Hansgen,Jack Fairman,0,0,0,Jack Fairman
433,489,170,1961,Walt Hansgen,Renato Pirocchi,0,0,0,Renato Pirocchi
433,490,170,1961,Walt Hansgen,Geoff Duke,0,0,0,Geoff Duke
433,491,170,1961,Walt Hansgen,Alfonso Thiele,0,0,0,Alfonso Thiele
433,492,170,1961,Walt Hansgen,Menato Boffa,0,0,0,Menato Boffa
434,436,170,1961,Hap Sharp,John Campbell-Jones,0,0,0,John Campbell-Jones
434,437,170,1961,Hap Sharp,Ian Burgess,0,0,0,Ian Burgess
434,453,170,1961,Hap Sharp,Jackie Lewis,0,3,3,Jackie Lewis
434,456,170,1961,Hap Sharp,Roy Salvadori,0,2,2,Roy Salvadori
434,468,170,1961,Hap Sharp,Roger Penske,0,0,0,Roger Penske
434,486,170,1961,Hap Sharp,Jack Fairman,0,0,0,Jack Fairman
434,489,170,1961,Hap Sharp,Renato Pirocchi,0,0,0,Renato Pirocchi
434,490,170,1961,Hap Sharp,Geoff Duke,0,0,0,Geoff Duke
434,491,170,1961,Hap Sharp,Alfonso Thiele,0,0,0,Alfonso Thiele
434,492,170,1961,Hap Sharp,Menato Boffa,0,0,0,Menato Boffa
436,437,170,1961,John Campbell-Jones,Ian Burgess,0,0,0,Ian Burgess
436,453,170,1961,John Campbell-Jones,Jackie Lewis,0,3,3,Jackie Lewis
436,456,170,1961,John Campbell-Jones,Roy Salvadori,0,2,2,Roy Salvadori
436,468,170,1961,John Campbell-Jones,Roger Penske,0,0,0,Roger Penske
436,486,170,1961,John Campbell-Jones,Jack Fairman,0,0,0,Jack Fairman
436,489,170,1961,John Campbell-Jones,Renato Pirocchi,0,0,0,Renato Pirocchi
436,490,170,1961,John Campbell-Jones,Geoff Duke,0,0,0,Geoff Duke
436,491,170,1961,John Campbell-Jones,Alfonso Thiele,0,0,0,Alfonso Thiele
436,492,170,1961,John Campbell-Jones,Menato Boffa,0,0,0,Menato Boffa
437,453,170,1961,Ian Burgess,Jackie Lewis,0,3,3,Jackie Lewis
437,456,170,1961,Ian Burgess,Roy Salvadori,0,2,2,Roy Salvadori
437,468,170,1961,Ian Burgess,Roger Penske,0,0,0,Roger Penske
437,486,170,1961,Ian Burgess,Jack Fairman,0,0,0,Jack Fairman
437,489,170,1961,Ian Burgess,Renato Pirocchi,0,0,0,Renato Pirocchi
437,490,170,1961,Ian Burgess,Geoff Duke,0,0,0,Geoff Duke
437,491,170,1961,Ian Burgess,Alfonso Thiele,0,0,0,Alfonso Thiele
437,492,170,1961,Ian Burgess,Menato Boffa,0,0,0,Menato Boffa
453,456,170,1961,Jackie Lewis,Roy Salvadori,3,2,1,Jackie Lewis
453,468,170,1961,Jackie Lewis,Roger Penske,3,0,3,Jackie Lewis
453,486,170,1961,Jackie Lewis,Jack Fairman,3,0,3,Jackie Lewis
453,489,170,1961,Jackie Lewis,Renato Pirocchi,3,0,3,Jackie Lewis
453,490,170,1961,Jackie Lewis,Geoff Duke,3,0,3,Jackie Lewis
453,491,170,1961,Jackie Lewis,Alfonso Thiele,3,0,3,Jackie Lewis
453,492,170,1961,Jackie Lewis,Menato Boffa,3,0,3,Jackie Lewis
456,468,170,1961,Roy Salvadori,Roger Penske,2,0,2,Roy Salvadori
456,486,170,1961,Roy Salvadori,Jack Fairman,2,0,2,Roy Salvadori
456,489,170,1961,Roy Salvadori,Renato Pirocchi,2,0,2,Roy Salvadori
456,490,170,1961,Roy Salvadori,Geoff Duke,2,0,2,Roy Salvadori
456,491,170,1961,Roy Salvadori,Alfonso Thiele,2,0,2,Roy Salvadori
456,492,170,1961,Roy Salvadori,Menato Boffa,2,0,2,Roy Salvadori
468,486,170,1961,Roger Penske,Jack Fairman,0,0,0,Jack Fairman
468,489,170,1961,Roger Penske,Renato Pirocchi,0,0,0,Renato Pirocchi
468,490,170,1961,Roger Penske,Geoff Duke,0,0,0,Geoff Duke
468,491,170,1961,Roger Penske,Alfonso Thiele,0,0,0,Alfonso Thiele
468,492,170,1961,Roger Penske,Menato Boffa,0,0,0,Menato Boffa
486,489,170,1961,Jack Fairman,Renato Pirocchi,0,0,0,Renato Pirocchi
486,490,170,1961,Jack Fairman,Geoff Duke,0,0,0,Geoff Duke
486,491,170,1961,Jack Fairman,Alfonso Thiele,0,0,0,Alfonso Thiele
486,492,170,1961,Jack Fairman,Menato Boffa,0,0,0,Menato Boffa
489,490,170,1961,Renato Pirocchi,Geoff Duke,0,0,0,Geoff Duke
489,491,170,1961,Renato Pirocchi,Alfonso Thiele,0,0,0,Alfonso Thiele
489,492,170,1961,Renato Pirocchi,Menato Boffa,0,0,0,Menato Boffa
490,491,170,1961,Geoff Duke,Alfonso Thiele,0,0,0,Alfonso Thiele
490,492,170,1961,Geoff Duke,Menato Boffa,0,0,0,Menato Boffa
491,492,170,1961,Alfonso Thiele,Menato Boffa,0,0,0,Menato Boffa
340,360,170,1962,John Love,Bruce McLaren,0,32,32,Bruce McLaren
340,408,170,1962,John Love,Tony Maggs,0,13,13,Tony Maggs
340,428,170,1962,John Love,Bernard Collomb,0,0,0,Bernard Collomb
340,434,170,1962,John Love,Hap Sharp,0,0,0,Hap Sharp
340,437,170,1962,John Love,Ian Burgess,0,0,0,Ian Burgess
340,453,170,1962,John Love,Jackie Lewis,0,0,0,Jackie Lewis
340,470,170,1962,John Love,Timmy Mayer,0,0,0,Timmy Mayer
360,408,170,1962,Bruce McLaren,Tony Maggs,32,13,19,Bruce McLaren
360,428,170,1962,Bruce McLaren,Bernard Collomb,32,0,32,Bruce McLaren
360,434,170,1962,Bruce McLaren,Hap Sharp,32,0,32,Bruce McLaren
360,437,170,1962,Bruce McLaren,Ian Burgess,32,0,32,Bruce McLaren
360,453,170,1962,Bruce McLaren,Jackie Lewis,32,0,32,Bruce McLaren
360,470,170,1962,Bruce McLaren,Timmy Mayer,32,0,32,Bruce McLaren
408,428,170,1962,Tony Maggs,Bernard Collomb,13,0,13,Tony Maggs
408,434,170,1962,Tony Maggs,Hap Sharp,13,0,13,Tony Maggs
408,437,170,1962,Tony Maggs,Ian Burgess,13,0,13,Tony Maggs
408,453,170,1962,Tony Maggs,Jackie Lewis,13,0,13,Tony Maggs
408,470,170,1962,Tony Maggs,Timmy Mayer,13,0,13,Tony Maggs
428,434,170,1962,Bernard Collomb,Hap Sharp,0,0,0,Hap Sharp
428,437,170,1962,Bernard Collomb,Ian Burgess,0,0,0,Ian Burgess
428,453,170,1962,Bernard Collomb,Jackie Lewis,0,0,0,Jackie Lewis
428,470,170,1962,Bernard Collomb,Timmy Mayer,0,0,0,Timmy Mayer
434,437,170,1962,Hap Sharp,Ian Burgess,0,0,0,Ian Burgess
434,453,170,1962,Hap Sharp,Jackie Lewis,0,0,0,Jackie Lewis
434,470,170,1962,Hap Sharp,Timmy Mayer,0,0,0,Timmy Mayer
437,453,170,1962,Ian Burgess,Jackie Lewis,0,0,0,Jackie Lewis
437,470,170,1962,Ian Burgess,Timmy Mayer,0,0,0,Timmy Mayer
453,470,170,1962,Jackie Lewis,Timmy Mayer,0,0,0,Timmy Mayer
340,347,170,1963,John Love,Jo Bonnier,0,6,6,Jo Bonnier
340,360,170,1963,John Love,Bruce McLaren,0,17,17,Bruce McLaren
340,408,170,1963,John Love,Tony Maggs,0,9,9,Tony Maggs
340,432,170,1963,John Love,MÃ¡rio de AraÃºjo Cabral,0,0,0,MÃ¡rio de AraÃºjo Cabral
340,451,170,1963,John Love,Frank Dochnal,0,0,0,Frank Dochnal
347,360,170,1963,Jo Bonnier,Bruce McLaren,6,17,11,Bruce McLaren
347,408,170,1963,Jo Bonnier,Tony Maggs,6,9,3,Tony Maggs
347,432,170,1963,Jo Bonnier,MÃ¡rio de AraÃºjo Cabral,6,0,6,Jo Bonnier
347,451,170,1963,Jo Bonnier,Frank Dochnal,6,0,6,Jo Bonnier
360,408,170,1963,Bruce McLaren,Tony Maggs,17,9,8,Bruce McLaren
360,432,170,1963,Bruce McLaren,MÃ¡rio de AraÃºjo Cabral,17,0,17,Bruce McLaren
360,451,170,1963,Bruce McLaren,Frank Dochnal,17,0,17,Bruce McLaren
408,432,170,1963,Tony Maggs,MÃ¡rio de AraÃºjo Cabral,9,0,9,Tony Maggs
408,451,170,1963,Tony Maggs,Frank Dochnal,9,0,9,Tony Maggs
432,451,170,1963,MÃ¡rio de AraÃºjo Cabral,Frank Dochnal,0,0,0,Frank Dochnal
340,347,170,1964,John Love,Jo Bonnier,0,2,2,Jo Bonnier
340,360,170,1964,John Love,Bruce McLaren,0,13,13,Bruce McLaren
340,399,170,1964,John Love,John Taylor,0,0,0,John Taylor
340,403,170,1964,John Love,Phil Hill,0,1,1,Phil Hill
340,431,170,1964,John Love,Edgar Barth,0,0,0,Edgar Barth
347,360,170,1964,Jo Bonnier,Bruce McLaren,2,13,11,Bruce McLaren
347,399,170,1964,Jo Bonnier,John Taylor,2,0,2,Jo Bonnier
347,403,170,1964,Jo Bonnier,Phil Hill,2,1,1,Jo Bonnier
347,431,170,1964,Jo Bonnier,Edgar Barth,2,0,2,Jo Bonnier
360,399,170,1964,Bruce McLaren,John Taylor,13,0,13,Bruce McLaren
360,403,170,1964,Bruce McLaren,Phil Hill,13,1,12,Bruce McLaren
360,431,170,1964,Bruce McLaren,Edgar Barth,13,0,13,Bruce McLaren
399,403,170,1964,John Taylor,Phil Hill,0,1,1,Phil Hill
399,431,170,1964,John Taylor,Edgar Barth,0,0,0,Edgar Barth
403,431,170,1964,Phil Hill,Edgar Barth,1,0,1,Phil Hill
340,358,170,1965,John Love,Jochen Rindt,0,4,4,Jochen Rindt
340,360,170,1965,John Love,Bruce McLaren,0,10,10,Bruce McLaren
340,417,170,1965,John Love,Alex Blignaut,0,0,0,Alex Blignaut
340,419,170,1965,John Love,John Rhodes,0,0,0,John Rhodes
358,360,170,1965,Jochen Rindt,Bruce McLaren,4,10,6,Bruce McLaren
358,417,170,1965,Jochen Rindt,Alex Blignaut,4,0,4,Jochen Rindt
358,419,170,1965,Jochen Rindt,John Rhodes,4,0,4,Jochen Rindt
360,417,170,1965,Bruce McLaren,Alex Blignaut,10,0,10,Bruce McLaren
360,419,170,1965,Bruce McLaren,John Rhodes,10,0,10,Bruce McLaren
417,419,170,1965,Alex Blignaut,John Rhodes,0,0,0,John Rhodes
340,393,170,1967,John Love,Tom Jones,6,0,6,John Love
353,483,171,1960,Pete Lovely,Giorgio Scarlatti,0,0,0,Giorgio Scarlatti
353,500,171,1960,Pete Lovely,Gino Munaron,0,0,0,Gino Munaron
353,543,171,1960,Pete Lovely,Giulio Cabianca,0,3,3,Giulio Cabianca
483,500,171,1960,Giorgio Scarlatti,Gino Munaron,0,0,0,Gino Munaron
483,543,171,1960,Giorgio Scarlatti,Giulio Cabianca,0,3,3,Giulio Cabianca
500,543,171,1960,Gino Munaron,Giulio Cabianca,0,3,3,Giulio Cabianca
373,376,172,1961,Jim Clark,Lucien Bianchi,11,0,11,Jim Clark
373,401,172,1961,Jim Clark,Trevor Taylor,11,0,11,Jim Clark
373,404,172,1961,Jim Clark,Innes Ireland,11,12,1,Innes Ireland
373,408,172,1961,Jim Clark,Tony Maggs,11,0,11,Jim Clark
373,418,172,1961,Jim Clark,Masten Gregory,11,0,11,Jim Clark
373,435,172,1961,Jim Clark,Willy Mairesse,11,0,11,Jim Clark
373,437,172,1961,Jim Clark,Ian Burgess,11,0,11,Jim Clark
373,440,172,1961,Jim Clark,Jim Hall,11,0,11,Jim Clark
373,441,172,1961,Jim Clark,Tim Parnell,11,0,11,Jim Clark
373,455,172,1961,Jim Clark,Wolfgang Seidel,11,0,11,Jim Clark
373,459,172,1961,Jim Clark,Tony Marsh,11,0,11,Jim Clark
373,460,172,1961,Jim Clark,Gerry Ashmore,11,0,11,Jim Clark
373,467,172,1961,Jim Clark,Ernesto Prinoth,11,0,11,Jim Clark
373,475,172,1961,Jim Clark,Stirling Moss,11,21,10,Stirling Moss
373,477,172,1961,Jim Clark,Cliff Allison,11,0,11,Jim Clark
373,480,172,1961,Jim Clark,Michael May,11,0,11,Jim Clark
373,481,172,1961,Jim Clark,Henry Taylor,11,0,11,Jim Clark
373,482,172,1961,Jim Clark,Olivier Gendebien,11,0,11,Jim Clark
373,485,172,1961,Jim Clark,Juan Manuel Bordeu,11,0,11,Jim Clark
373,493,172,1961,Jim Clark,Peter Ryan,11,0,11,Jim Clark
373,494,172,1961,Jim Clark,Lloyd Ruby,11,0,11,Jim Clark
373,495,172,1961,Jim Clark,Ken Miles,11,0,11,Jim Clark
376,401,172,1961,Lucien Bianchi,Trevor Taylor,0,0,0,Trevor Taylor
376,404,172,1961,Lucien Bianchi,Innes Ireland,0,12,12,Innes Ireland
376,408,172,1961,Lucien Bianchi,Tony Maggs,0,0,0,Tony Maggs
376,418,172,1961,Lucien Bianchi,Masten Gregory,0,0,0,Masten Gregory
376,435,172,1961,Lucien Bianchi,Willy Mairesse,0,0,0,Willy Mairesse
376,437,172,1961,Lucien Bianchi,Ian Burgess,0,0,0,Ian Burgess
376,440,172,1961,Lucien Bianchi,Jim Hall,0,0,0,Jim Hall
376,441,172,1961,Lucien Bianchi,Tim Parnell,0,0,0,Tim Parnell
376,455,172,1961,Lucien Bianchi,Wolfgang Seidel,0,0,0,Wolfgang Seidel
376,459,172,1961,Lucien Bianchi,Tony Marsh,0,0,0,Tony Marsh
376,460,172,1961,Lucien Bianchi,Gerry Ashmore,0,0,0,Gerry Ashmore
376,467,172,1961,Lucien Bianchi,Ernesto Prinoth,0,0,0,Ernesto Prinoth
376,475,172,1961,Lucien Bianchi,Stirling Moss,0,21,21,Stirling Moss
376,477,172,1961,Lucien Bianchi,Cliff Allison,0,0,0,Cliff Allison
376,480,172,1961,Lucien Bianchi,Michael May,0,0,0,Michael May
376,481,172,1961,Lucien Bianchi,Henry Taylor,0,0,0,Henry Taylor
376,482,172,1961,Lucien Bianchi,Olivier Gendebien,0,0,0,Olivier Gendebien
376,485,172,1961,Lucien Bianchi,Juan Manuel Bordeu,0,0,0,Juan Manuel Bordeu
376,493,172,1961,Lucien Bianchi,Peter Ryan,0,0,0,Peter Ryan
376,494,172,1961,Lucien Bianchi,Lloyd Ruby,0,0,0,Lloyd Ruby
376,495,172,1961,Lucien Bianchi,Ken Miles,0,0,0,Ken Miles
401,404,172,1961,Trevor Taylor,Innes Ireland,0,12,12,Innes Ireland
401,408,172,1961,Trevor Taylor,Tony Maggs,0,0,0,Tony Maggs
401,418,172,1961,Trevor Taylor,Masten Gregory,0,0,0,Masten Gregory
401,435,172,1961,Trevor Taylor,Willy Mairesse,0,0,0,Willy Mairesse
401,437,172,1961,Trevor Taylor,Ian Burgess,0,0,0,Ian Burgess
401,440,172,1961,Trevor Taylor,Jim Hall,0,0,0,Jim Hall
401,441,172,1961,Trevor Taylor,Tim Parnell,0,0,0,Tim Parnell
401,455,172,1961,Trevor Taylor,Wolfgang Seidel,0,0,0,Wolfgang Seidel
401,459,172,1961,Trevor Taylor,Tony Marsh,0,0,0,Tony Marsh
401,460,172,1961,Trevor Taylor,Gerry Ashmore,0,0,0,Gerry Ashmore
401,467,172,1961,Trevor Taylor,Ernesto Prinoth,0,0,0,Ernesto Prinoth
401,475,172,1961,Trevor Taylor,Stirling Moss,0,21,21,Stirling Moss
401,477,172,1961,Trevor Taylor,Cliff Allison,0,0,0,Cliff Allison
401,480,172,1961,Trevor Taylor,Michael May,0,0,0,Michael May
401,481,172,1961,Trevor Taylor,Henry Taylor,0,0,0,Henry Taylor
401,482,172,1961,Trevor Taylor,Olivier Gendebien,0,0,0,Olivier Gendebien
401,485,172,1961,Trevor Taylor,Juan Manuel Bordeu,0,0,0,Juan Manuel Bordeu
401,493,172,1961,Trevor Taylor,Peter Ryan,0,0,0,Peter Ryan
401,494,172,1961,Trevor Taylor,Lloyd Ruby,0,0,0,Lloyd Ruby
401,495,172,1961,Trevor Taylor,Ken Miles,0,0,0,Ken Miles
404,408,172,1961,Innes Ireland,Tony Maggs,12,0,12,Innes Ireland
404,418,172,1961,Innes Ireland,Masten Gregory,12,0,12,Innes Ireland
404,435,172,1961,Innes Ireland,Willy Mairesse,12,0,12,Innes Ireland
404,437,172,1961,Innes Ireland,Ian Burgess,12,0,12,Innes Ireland
404,440,172,1961,Innes Ireland,Jim Hall,12,0,12,Innes Ireland
404,441,172,1961,Innes Ireland,Tim Parnell,12,0,12,Innes Ireland
404,455,172,1961,Innes Ireland,Wolfgang Seidel,12,0,12,Innes Ireland
404,459,172,1961,Innes Ireland,Tony Marsh,12,0,12,Innes Ireland
404,460,172,1961,Innes Ireland,Gerry Ashmore,12,0,12,Innes Ireland
404,467,172,1961,Innes Ireland,Ernesto Prinoth,12,0,12,Innes Ireland
404,475,172,1961,Innes Ireland,Stirling Moss,12,21,9,Stirling Moss
404,477,172,1961,Innes Ireland,Cliff Allison,12,0,12,Innes Ireland
404,480,172,1961,Innes Ireland,Michael May,12,0,12,Innes Ireland
404,481,172,1961,Innes Ireland,Henry Taylor,12,0,12,Innes Ireland
404,482,172,1961,Innes Ireland,Olivier Gendebien,12,0,12,Innes Ireland
404,485,172,1961,Innes Ireland,Juan Manuel Bordeu,12,0,12,Innes Ireland
404,493,172,1961,Innes Ireland,Peter Ryan,12,0,12,Innes Ireland
404,494,172,1961,Innes Ireland,Lloyd Ruby,12,0,12,Innes Ireland
404,495,172,1961,Innes Ireland,Ken Miles,12,0,12,Innes Ireland
408,418,172,1961,Tony Maggs,Masten Gregory,0,0,0,Masten Gregory
408,435,172,1961,Tony Maggs,Willy Mairesse,0,0,0,Willy Mairesse
408,437,172,1961,Tony Maggs,Ian Burgess,0,0,0,Ian Burgess
408,440,172,1961,Tony Maggs,Jim Hall,0,0,0,Jim Hall
408,441,172,1961,Tony Maggs,Tim Parnell,0,0,0,Tim Parnell
408,455,172,1961,Tony Maggs,Wolfgang Seidel,0,0,0,Wolfgang Seidel
408,459,172,1961,Tony Maggs,Tony Marsh,0,0,0,Tony Marsh
408,460,172,1961,Tony Maggs,Gerry Ashmore,0,0,0,Gerry Ashmore
408,467,172,1961,Tony Maggs,Ernesto Prinoth,0,0,0,Ernesto Prinoth
408,475,172,1961,Tony Maggs,Stirling Moss,0,21,21,Stirling Moss
408,477,172,1961,Tony Maggs,Cliff Allison,0,0,0,Cliff Allison
408,480,172,1961,Tony Maggs,Michael May,0,0,0,Michael May
408,481,172,1961,Tony Maggs,Henry Taylor,0,0,0,Henry Taylor
408,482,172,1961,Tony Maggs,Olivier Gendebien,0,0,0,Olivier Gendebien
408,485,172,1961,Tony Maggs,Juan Manuel Bordeu,0,0,0,Juan Manuel Bordeu
408,493,172,1961,Tony Maggs,Peter Ryan,0,0,0,Peter Ryan
408,494,172,1961,Tony Maggs,Lloyd Ruby,0,0,0,Lloyd Ruby
408,495,172,1961,Tony Maggs,Ken Miles,0,0,0,Ken Miles
418,435,172,1961,Masten Gregory,Willy Mairesse,0,0,0,Willy Mairesse
418,437,172,1961,Masten Gregory,Ian Burgess,0,0,0,Ian Burgess
418,440,172,1961,Masten Gregory,Jim Hall,0,0,0,Jim Hall
418,441,172,1961,Masten Gregory,Tim Parnell,0,0,0,Tim Parnell
418,455,172,1961,Masten Gregory,Wolfgang Seidel,0,0,0,Wolfgang Seidel
418,459,172,1961,Masten Gregory,Tony Marsh,0,0,0,Tony Marsh
418,460,172,1961,Masten Gregory,Gerry Ashmore,0,0,0,Gerry Ashmore
418,467,172,1961,Masten Gregory,Ernesto Prinoth,0,0,0,Ernesto Prinoth
418,475,172,1961,Masten Gregory,Stirling Moss,0,21,21,Stirling Moss
418,477,172,1961,Masten Gregory,Cliff Allison,0,0,0,Cliff Allison
418,480,172,1961,Masten Gregory,Michael May,0,0,0,Michael May
418,481,172,1961,Masten Gregory,Henry Taylor,0,0,0,Henry Taylor
418,482,172,1961,Masten Gregory,Olivier Gendebien,0,0,0,Olivier Gendebien
418,485,172,1961,Masten Gregory,Juan Manuel Bordeu,0,0,0,Juan Manuel Bordeu
418,493,172,1961,Masten Gregory,Peter Ryan,0,0,0,Peter Ryan
418,494,172,1961,Masten Gregory,Lloyd Ruby,0,0,0,Lloyd Ruby
418,495,172,1961,Masten Gregory,Ken Miles,0,0,0,Ken Miles
435,437,172,1961,Willy Mairesse,Ian Burgess,0,0,0,Ian Burgess
435,440,172,1961,Willy Mairesse,Jim Hall,0,0,0,Jim Hall
435,441,172,1961,Willy Mairesse,Tim Parnell,0,0,0,Tim Parnell
435,455,172,1961,Willy Mairesse,Wolfgang Seidel,0,0,0,Wolfgang Seidel
435,459,172,1961,Willy Mairesse,Tony Marsh,0,0,0,Tony Marsh
435,460,172,1961,Willy Mairesse,Gerry Ashmore,0,0,0,Gerry Ashmore
435,467,172,1961,Willy Mairesse,Ernesto Prinoth,0,0,0,Ernesto Prinoth
435,475,172,1961,Willy Mairesse,Stirling Moss,0,21,21,Stirling Moss
435,477,172,1961,Willy Mairesse,Cliff Allison,0,0,0,Cliff Allison
435,480,172,1961,Willy Mairesse,Michael May,0,0,0,Michael May
435,481,172,1961,Willy Mairesse,Henry Taylor,0,0,0,Henry Taylor
435,482,172,1961,Willy Mairesse,Olivier Gendebien,0,0,0,Olivier Gendebien
435,485,172,1961,Willy Mairesse,Juan Manuel Bordeu,0,0,0,Juan Manuel Bordeu
435,493,172,1961,Willy Mairesse,Peter Ryan,0,0,0,Peter Ryan
435,494,172,1961,Willy Mairesse,Lloyd Ruby,0,0,0,Lloyd Ruby
435,495,172,1961,Willy Mairesse,Ken Miles,0,0,0,Ken Miles
437,440,172,1961,Ian Burgess,Jim Hall,0,0,0,Jim Hall
437,441,172,1961,Ian Burgess,Tim Parnell,0,0,0,Tim Parnell
437,455,172,1961,Ian Burgess,Wolfgang Seidel,0,0,0,Wolfgang Seidel
437,459,172,1961,Ian Burgess,Tony Marsh,0,0,0,Tony Marsh
437,460,172,1961,Ian Burgess,Gerry Ashmore,0,0,0,Gerry Ashmore
437,467,172,1961,Ian Burgess,Ernesto Prinoth,0,0,0,Ernesto Prinoth
437,475,172,1961,Ian Burgess,Stirling Moss,0,21,21,Stirling Moss
437,477,172,1961,Ian Burgess,Cliff Allison,0,0,0,Cliff Allison
437,480,172,1961,Ian Burgess,Michael May,0,0,0,Michael May
437,481,172,1961,Ian Burgess,Henry Taylor,0,0,0,Henry Taylor
437,482,172,1961,Ian Burgess,Olivier Gendebien,0,0,0,Olivier Gendebien
437,485,172,1961,Ian Burgess,Juan Manuel Bordeu,0,0,0,Juan Manuel Bordeu
437,493,172,1961,Ian Burgess,Peter Ryan,0,0,0,Peter Ryan
437,494,172,1961,Ian Burgess,Lloyd Ruby,0,0,0,Lloyd Ruby
437,495,172,1961,Ian Burgess,Ken Miles,0,0,0,Ken Miles
440,441,172,1961,Jim Hall,Tim Parnell,0,0,0,Tim Parnell
440,455,172,1961,Jim Hall,Wolfgang Seidel,0,0,0,Wolfgang Seidel
440,459,172,1961,Jim Hall,Tony Marsh,0,0,0,Tony Marsh
440,460,172,1961,Jim Hall,Gerry Ashmore,0,0,0,Gerry Ashmore
440,467,172,1961,Jim Hall,Ernesto Prinoth,0,0,0,Ernesto Prinoth
440,475,172,1961,Jim Hall,Stirling Moss,0,21,21,Stirling Moss
440,477,172,1961,Jim Hall,Cliff Allison,0,0,0,Cliff Allison
440,480,172,1961,Jim Hall,Michael May,0,0,0,Michael May
440,481,172,1961,Jim Hall,Henry Taylor,0,0,0,Henry Taylor
440,482,172,1961,Jim Hall,Olivier Gendebien,0,0,0,Olivier Gendebien
440,485,172,1961,Jim Hall,Juan Manuel Bordeu,0,0,0,Juan Manuel Bordeu
440,493,172,1961,Jim Hall,Peter Ryan,0,0,0,Peter Ryan
440,494,172,1961,Jim Hall,Lloyd Ruby,0,0,0,Lloyd Ruby
440,495,172,1961,Jim Hall,Ken Miles,0,0,0,Ken Miles
441,455,172,1961,Tim Parnell,Wolfgang Seidel,0,0,0,Wolfgang Seidel
441,459,172,1961,Tim Parnell,Tony Marsh,0,0,0,Tony Marsh
441,460,172,1961,Tim Parnell,Gerry Ashmore,0,0,0,Gerry Ashmore
441,467,172,1961,Tim Parnell,Ernesto Prinoth,0,0,0,Ernesto Prinoth
441,475,172,1961,Tim Parnell,Stirling Moss,0,21,21,Stirling Moss
441,477,172,1961,Tim Parnell,Cliff Allison,0,0,0,Cliff Allison
441,480,172,1961,Tim Parnell,Michael May,0,0,0,Michael May
441,481,172,1961,Tim Parnell,Henry Taylor,0,0,0,Henry Taylor
441,482,172,1961,Tim Parnell,Olivier Gendebien,0,0,0,Olivier Gendebien
441,485,172,1961,Tim Parnell,Juan Manuel Bordeu,0,0,0,Juan Manuel Bordeu
441,493,172,1961,Tim Parnell,Peter Ryan,0,0,0,Peter Ryan
441,494,172,1961,Tim Parnell,Lloyd Ruby,0,0,0,Lloyd Ruby
441,495,172,1961,Tim Parnell,Ken Miles,0,0,0,Ken Miles
455,459,172,1961,Wolfgang Seidel,Tony Marsh,0,0,0,Tony Marsh
455,460,172,1961,Wolfgang Seidel,Gerry Ashmore,0,0,0,Gerry Ashmore
455,467,172,1961,Wolfgang Seidel,Ernesto Prinoth,0,0,0,Ernesto Prinoth
455,475,172,1961,Wolfgang Seidel,Stirling Moss,0,21,21,Stirling Moss
455,477,172,1961,Wolfgang Seidel,Cliff Allison,0,0,0,Cliff Allison
455,480,172,1961,Wolfgang Seidel,Michael May,0,0,0,Michael May
455,481,172,1961,Wolfgang Seidel,Henry Taylor,0,0,0,Henry Taylor
455,482,172,1961,Wolfgang Seidel,Olivier Gendebien,0,0,0,Olivier Gendebien
455,485,172,1961,Wolfgang Seidel,Juan Manuel Bordeu,0,0,0,Juan Manuel Bordeu
455,493,172,1961,Wolfgang Seidel,Peter Ryan,0,0,0,Peter Ryan
455,494,172,1961,Wolfgang Seidel,Lloyd Ruby,0,0,0,Lloyd Ruby
455,495,172,1961,Wolfgang Seidel,Ken Miles,0,0,0,Ken Miles
459,460,172,1961,Tony Marsh,Gerry Ashmore,0,0,0,Gerry Ashmore
459,467,172,1961,Tony Marsh,Ernesto Prinoth,0,0,0,Ernesto Prinoth
459,475,172,1961,Tony Marsh,Stirling Moss,0,21,21,Stirling Moss
459,477,172,1961,Tony Marsh,Cliff Allison,0,0,0,Cliff Allison
459,480,172,1961,Tony Marsh,Michael May,0,0,0,Michael May
459,481,172,1961,Tony Marsh,Henry Taylor,0,0,0,Henry Taylor
459,482,172,1961,Tony Marsh,Olivier Gendebien,0,0,0,Olivier Gendebien
459,485,172,1961,Tony Marsh,Juan Manuel Bordeu,0,0,0,Juan Manuel Bordeu
459,493,172,1961,Tony Marsh,Peter Ryan,0,0,0,Peter Ryan
459,494,172,1961,Tony Marsh,Lloyd Ruby,0,0,0,Lloyd Ruby
459,495,172,1961,Tony Marsh,Ken Miles,0,0,0,Ken Miles
460,467,172,1961,Gerry Ashmore,Ernesto Prinoth,0,0,0,Ernesto Prinoth
460,475,172,1961,Gerry Ashmore,Stirling Moss,0,21,21,Stirling Moss
460,477,172,1961,Gerry Ashmore,Cliff Allison,0,0,0,Cliff Allison
460,480,172,1961,Gerry Ashmore,Michael May,0,0,0,Michael May
460,481,172,1961,Gerry Ashmore,Henry Taylor,0,0,0,Henry Taylor
460,482,172,1961,Gerry Ashmore,Olivier Gendebien,0,0,0,Olivier Gendebien
460,485,172,1961,Gerry Ashmore,Juan Manuel Bordeu,0,0,0,Juan Manuel Bordeu
460,493,172,1961,Gerry Ashmore,Peter Ryan,0,0,0,Peter Ryan
460,494,172,1961,Gerry Ashmore,Lloyd Ruby,0,0,0,Lloyd Ruby
460,495,172,1961,Gerry Ashmore,Ken Miles,0,0,0,Ken Miles
467,475,172,1961,Ernesto Prinoth,Stirling Moss,0,21,21,Stirling Moss
467,477,172,1961,Ernesto Prinoth,Cliff Allison,0,0,0,Cliff Allison
467,480,172,1961,Ernesto Prinoth,Michael May,0,0,0,Michael May
467,481,172,1961,Ernesto Prinoth,Henry Taylor,0,0,0,Henry Taylor
467,482,172,1961,Ernesto Prinoth,Olivier Gendebien,0,0,0,Olivier Gendebien
467,485,172,1961,Ernesto Prinoth,Juan Manuel Bordeu,0,0,0,Juan Manuel Bordeu
467,493,172,1961,Ernesto Prinoth,Peter Ryan,0,0,0,Peter Ryan
467,494,172,1961,Ernesto Prinoth,Lloyd Ruby,0,0,0,Lloyd Ruby
467,495,172,1961,Ernesto Prinoth,Ken Miles,0,0,0,Ken Miles
475,477,172,1961,Stirling Moss,Cliff Allison,21,0,21,Stirling Moss
475,480,172,1961,Stirling Moss,Michael May,21,0,21,Stirling Moss
475,481,172,1961,Stirling Moss,Henry Taylor,21,0,21,Stirling Moss
475,482,172,1961,Stirling Moss,Olivier Gendebien,21,0,21,Stirling Moss
475,485,172,1961,Stirling Moss,Juan Manuel Bordeu,21,0,21,Stirling Moss
475,493,172,1961,Stirling Moss,Peter Ryan,21,0,21,Stirling Moss
475,494,172,1961,Stirling Moss,Lloyd Ruby,21,0,21,Stirling Moss
475,495,172,1961,Stirling Moss,Ken Miles,21,0,21,Stirling Moss
477,480,172,1961,Cliff Allison,Michael May,0,0,0,Michael May
477,481,172,1961,Cliff Allison,Henry Taylor,0,0,0,Henry Taylor
477,482,172,1961,Cliff Allison,Olivier Gendebien,0,0,0,Olivier Gendebien
477,485,172,1961,Cliff Allison,Juan Manuel Bordeu,0,0,0,Juan Manuel Bordeu
477,493,172,1961,Cliff Allison,Peter Ryan,0,0,0,Peter Ryan
477,494,172,1961,Cliff Allison,Lloyd Ruby,0,0,0,Lloyd Ruby
477,495,172,1961,Cliff Allison,Ken Miles,0,0,0,Ken Miles
480,481,172,1961,Michael May,Henry Taylor,0,0,0,Henry Taylor
480,482,172,1961,Michael May,Olivier Gendebien,0,0,0,Olivier Gendebien
480,485,172,1961,Michael May,Juan Manuel Bordeu,0,0,0,Juan Manuel Bordeu
480,493,172,1961,Michael May,Peter Ryan,0,0,0,Peter Ryan
480,494,172,1961,Michael May,Lloyd Ruby,0,0,0,Lloyd Ruby
480,495,172,1961,Michael May,Ken Miles,0,0,0,Ken Miles
481,482,172,1961,Henry Taylor,Olivier Gendebien,0,0,0,Olivier Gendebien
481,485,172,1961,Henry Taylor,Juan Manuel Bordeu,0,0,0,Juan Manuel Bordeu
481,493,172,1961,Henry Taylor,Peter Ryan,0,0,0,Peter Ryan
481,494,172,1961,Henry Taylor,Lloyd Ruby,0,0,0,Lloyd Ruby
481,495,172,1961,Henry Taylor,Ken Miles,0,0,0,Ken Miles
482,485,172,1961,Olivier Gendebien,Juan Manuel Bordeu,0,0,0,Juan Manuel Bordeu
482,493,172,1961,Olivier Gendebien,Peter Ryan,0,0,0,Peter Ryan
482,494,172,1961,Olivier Gendebien,Lloyd Ruby,0,0,0,Lloyd Ruby
482,495,172,1961,Olivier Gendebien,Ken Miles,0,0,0,Ken Miles
485,493,172,1961,Juan Manuel Bordeu,Peter Ryan,0,0,0,Peter Ryan
485,494,172,1961,Juan Manuel Bordeu,Lloyd Ruby,0,0,0,Lloyd Ruby
485,495,172,1961,Juan Manuel Bordeu,Ken Miles,0,0,0,Ken Miles
493,494,172,1961,Peter Ryan,Lloyd Ruby,0,0,0,Lloyd Ruby
493,495,172,1961,Peter Ryan,Ken Miles,0,0,0,Ken Miles
494,495,172,1961,Lloyd Ruby,Ken Miles,0,0,0,Ken Miles
346,356,172,1962,Jo Siffert,Jack Brabham,0,3,3,Jack Brabham
346,368,172,1962,Jo Siffert,Sam Tingle,0,0,0,Sam Tingle
346,373,172,1962,Jo Siffert,Jim Clark,0,30,30,Jim Clark
346,376,172,1962,Jo Siffert,Lucien Bianchi,0,0,0,Lucien Bianchi
346,401,172,1962,Jo Siffert,Trevor Taylor,0,6,6,Trevor Taylor
346,404,172,1962,Jo Siffert,Innes Ireland,0,2,2,Innes Ireland
346,410,172,1962,Jo Siffert,Neville Lederle,0,1,1,Neville Lederle
346,413,172,1962,Jo Siffert,Ernie Pieterse,0,0,0,Ernie Pieterse
346,418,172,1962,Jo Siffert,Masten Gregory,0,0,0,Masten Gregory
346,425,172,1962,Jo Siffert,Nino Vaccarella,0,0,0,Nino Vaccarella
346,427,172,1962,Jo Siffert,Maurice Trintignant,0,0,0,Maurice Trintignant
346,436,172,1962,Jo Siffert,John Campbell-Jones,0,0,0,John Campbell-Jones
346,440,172,1962,Jo Siffert,Jim Hall,0,0,0,Jim Hall
346,446,172,1962,Jo Siffert,Carlo Abate,0,0,0,Carlo Abate
346,460,172,1962,Jo Siffert,Gerry Ashmore,0,0,0,Gerry Ashmore
346,463,172,1962,Jo Siffert,Jay Chamberlain,0,0,0,Jay Chamberlain
346,464,172,1962,Jo Siffert,Tony Shelly,0,0,0,Tony Shelly
346,465,172,1962,Jo Siffert,Keith Greene,0,0,0,Keith Greene
346,467,172,1962,Jo Siffert,Ernesto Prinoth,0,0,0,Ernesto Prinoth
346,468,172,1962,Jo Siffert,Roger Penske,0,0,0,Roger Penske
346,469,172,1962,Jo Siffert,Rob Schroeder,0,0,0,Rob Schroeder
346,473,172,1962,Jo Siffert,Gary Hocking,0,0,0,Gary Hocking
346,474,172,1962,Jo Siffert,Syd van der Vyver,0,0,0,Syd van der Vyver
356,368,172,1962,Jack Brabham,Sam Tingle,3,0,3,Jack Brabham
356,373,172,1962,Jack Brabham,Jim Clark,3,30,27,Jim Clark
356,376,172,1962,Jack Brabham,Lucien Bianchi,3,0,3,Jack Brabham
356,401,172,1962,Jack Brabham,Trevor Taylor,3,6,3,Trevor Taylor
356,404,172,1962,Jack Brabham,Innes Ireland,3,2,1,Jack Brabham
356,410,172,1962,Jack Brabham,Neville Lederle,3,1,2,Jack Brabham
356,413,172,1962,Jack Brabham,Ernie Pieterse,3,0,3,Jack Brabham
356,418,172,1962,Jack Brabham,Masten Gregory,3,0,3,Jack Brabham
356,425,172,1962,Jack Brabham,Nino Vaccarella,3,0,3,Jack Brabham
356,427,172,1962,Jack Brabham,Maurice Trintignant,3,0,3,Jack Brabham
356,436,172,1962,Jack Brabham,John Campbell-Jones,3,0,3,Jack Brabham
356,440,172,1962,Jack Brabham,Jim Hall,3,0,3,Jack Brabham
356,446,172,1962,Jack Brabham,Carlo Abate,3,0,3,Jack Brabham
356,460,172,1962,Jack Brabham,Gerry Ashmore,3,0,3,Jack Brabham
356,463,172,1962,Jack Brabham,Jay Chamberlain,3,0,3,Jack Brabham
356,464,172,1962,Jack Brabham,Tony Shelly,3,0,3,Jack Brabham
356,465,172,1962,Jack Brabham,Keith Greene,3,0,3,Jack Brabham
356,467,172,1962,Jack Brabham,Ernesto Prinoth,3,0,3,Jack Brabham
356,468,172,1962,Jack Brabham,Roger Penske,3,0,3,Jack Brabham
356,469,172,1962,Jack Brabham,Rob Schroeder,3,0,3,Jack Brabham
356,473,172,1962,Jack Brabham,Gary Hocking,3,0,3,Jack Brabham
356,474,172,1962,Jack Brabham,Syd van der Vyver,3,0,3,Jack Brabham
368,373,172,1962,Sam Tingle,Jim Clark,0,30,30,Jim Clark
368,376,172,1962,Sam Tingle,Lucien Bianchi,0,0,0,Lucien Bianchi
368,401,172,1962,Sam Tingle,Trevor Taylor,0,6,6,Trevor Taylor
368,404,172,1962,Sam Tingle,Innes Ireland,0,2,2,Innes Ireland
368,410,172,1962,Sam Tingle,Neville Lederle,0,1,1,Neville Lederle
368,413,172,1962,Sam Tingle,Ernie Pieterse,0,0,0,Ernie Pieterse
368,418,172,1962,Sam Tingle,Masten Gregory,0,0,0,Masten Gregory
368,425,172,1962,Sam Tingle,Nino Vaccarella,0,0,0,Nino Vaccarella
368,427,172,1962,Sam Tingle,Maurice Trintignant,0,0,0,Maurice Trintignant
368,436,172,1962,Sam Tingle,John Campbell-Jones,0,0,0,John Campbell-Jones
368,440,172,1962,Sam Tingle,Jim Hall,0,0,0,Jim Hall
368,446,172,1962,Sam Tingle,Carlo Abate,0,0,0,Carlo Abate
368,460,172,1962,Sam Tingle,Gerry Ashmore,0,0,0,Gerry Ashmore
368,463,172,1962,Sam Tingle,Jay Chamberlain,0,0,0,Jay Chamberlain
368,464,172,1962,Sam Tingle,Tony Shelly,0,0,0,Tony Shelly
368,465,172,1962,Sam Tingle,Keith Greene,0,0,0,Keith Greene
368,467,172,1962,Sam Tingle,Ernesto Prinoth,0,0,0,Ernesto Prinoth
368,468,172,1962,Sam Tingle,Roger Penske,0,0,0,Roger Penske
368,469,172,1962,Sam Tingle,Rob Schroeder,0,0,0,Rob Schroeder
368,473,172,1962,Sam Tingle,Gary Hocking,0,0,0,Gary Hocking
368,474,172,1962,Sam Tingle,Syd van der Vyver,0,0,0,Syd van der Vyver
373,376,172,1962,Jim Clark,Lucien Bianchi,30,0,30,Jim Clark
373,401,172,1962,Jim Clark,Trevor Taylor,30,6,24,Jim Clark
373,404,172,1962,Jim Clark,Innes Ireland,30,2,28,Jim Clark
373,410,172,1962,Jim Clark,Neville Lederle,30,1,29,Jim Clark
373,413,172,1962,Jim Clark,Ernie Pieterse,30,0,30,Jim Clark
373,418,172,1962,Jim Clark,Masten Gregory,30,0,30,Jim Clark
373,425,172,1962,Jim Clark,Nino Vaccarella,30,0,30,Jim Clark
373,427,172,1962,Jim Clark,Maurice Trintignant,30,0,30,Jim Clark
373,436,172,1962,Jim Clark,John Campbell-Jones,30,0,30,Jim Clark
373,440,172,1962,Jim Clark,Jim Hall,30,0,30,Jim Clark
373,446,172,1962,Jim Clark,Carlo Abate,30,0,30,Jim Clark
373,460,172,1962,Jim Clark,Gerry Ashmore,30,0,30,Jim Clark
373,463,172,1962,Jim Clark,Jay Chamberlain,30,0,30,Jim Clark
373,464,172,1962,Jim Clark,Tony Shelly,30,0,30,Jim Clark
373,465,172,1962,Jim Clark,Keith Greene,30,0,30,Jim Clark
373,467,172,1962,Jim Clark,Ernesto Prinoth,30,0,30,Jim Clark
373,468,172,1962,Jim Clark,Roger Penske,30,0,30,Jim Clark
373,469,172,1962,Jim Clark,Rob Schroeder,30,0,30,Jim Clark
373,473,172,1962,Jim Clark,Gary Hocking,30,0,30,Jim Clark
373,474,172,1962,Jim Clark,Syd van der Vyver,30,0,30,Jim Clark
376,401,172,1962,Lucien Bianchi,Trevor Taylor,0,6,6,Trevor Taylor
376,404,172,1962,Lucien Bianchi,Innes Ireland,0,2,2,Innes Ireland
376,410,172,1962,Lucien Bianchi,Neville Lederle,0,1,1,Neville Lederle
376,413,172,1962,Lucien Bianchi,Ernie Pieterse,0,0,0,Ernie Pieterse
376,418,172,1962,Lucien Bianchi,Masten Gregory,0,0,0,Masten Gregory
376,425,172,1962,Lucien Bianchi,Nino Vaccarella,0,0,0,Nino Vaccarella
376,427,172,1962,Lucien Bianchi,Maurice Trintignant,0,0,0,Maurice Trintignant
376,436,172,1962,Lucien Bianchi,John Campbell-Jones,0,0,0,John Campbell-Jones
376,440,172,1962,Lucien Bianchi,Jim Hall,0,0,0,Jim Hall
376,446,172,1962,Lucien Bianchi,Carlo Abate,0,0,0,Carlo Abate
376,460,172,1962,Lucien Bianchi,Gerry Ashmore,0,0,0,Gerry Ashmore
376,463,172,1962,Lucien Bianchi,Jay Chamberlain,0,0,0,Jay Chamberlain
376,464,172,1962,Lucien Bianchi,Tony Shelly,0,0,0,Tony Shelly
376,465,172,1962,Lucien Bianchi,Keith Greene,0,0,0,Keith Greene
376,467,172,1962,Lucien Bianchi,Ernesto Prinoth,0,0,0,Ernesto Prinoth
376,468,172,1962,Lucien Bianchi,Roger Penske,0,0,0,Roger Penske
376,469,172,1962,Lucien Bianchi,Rob Schroeder,0,0,0,Rob Schroeder
376,473,172,1962,Lucien Bianchi,Gary Hocking,0,0,0,Gary Hocking
376,474,172,1962,Lucien Bianchi,Syd van der Vyver,0,0,0,Syd van der Vyver
401,404,172,1962,Trevor Taylor,Innes Ireland,6,2,4,Trevor Taylor
401,410,172,1962,Trevor Taylor,Neville Lederle,6,1,5,Trevor Taylor
401,413,172,1962,Trevor Taylor,Ernie Pieterse,6,0,6,Trevor Taylor
401,418,172,1962,Trevor Taylor,Masten Gregory,6,0,6,Trevor Taylor
401,425,172,1962,Trevor Taylor,Nino Vaccarella,6,0,6,Trevor Taylor
401,427,172,1962,Trevor Taylor,Maurice Trintignant,6,0,6,Trevor Taylor
401,436,172,1962,Trevor Taylor,John Campbell-Jones,6,0,6,Trevor Taylor
401,440,172,1962,Trevor Taylor,Jim Hall,6,0,6,Trevor Taylor
401,446,172,1962,Trevor Taylor,Carlo Abate,6,0,6,Trevor Taylor
401,460,172,1962,Trevor Taylor,Gerry Ashmore,6,0,6,Trevor Taylor
401,463,172,1962,Trevor Taylor,Jay Chamberlain,6,0,6,Trevor Taylor
401,464,172,1962,Trevor Taylor,Tony Shelly,6,0,6,Trevor Taylor
401,465,172,1962,Trevor Taylor,Keith Greene,6,0,6,Trevor Taylor
401,467,172,1962,Trevor Taylor,Ernesto Prinoth,6,0,6,Trevor Taylor
401,468,172,1962,Trevor Taylor,Roger Penske,6,0,6,Trevor Taylor
401,469,172,1962,Trevor Taylor,Rob Schroeder,6,0,6,Trevor Taylor
401,473,172,1962,Trevor Taylor,Gary Hocking,6,0,6,Trevor Taylor
401,474,172,1962,Trevor Taylor,Syd van der Vyver,6,0,6,Trevor Taylor
404,410,172,1962,Innes Ireland,Neville Lederle,2,1,1,Innes Ireland
404,413,172,1962,Innes Ireland,Ernie Pieterse,2,0,2,Innes Ireland
404,418,172,1962,Innes Ireland,Masten Gregory,2,0,2,Innes Ireland
404,425,172,1962,Innes Ireland,Nino Vaccarella,2,0,2,Innes Ireland
404,427,172,1962,Innes Ireland,Maurice Trintignant,2,0,2,Innes Ireland
404,436,172,1962,Innes Ireland,John Campbell-Jones,2,0,2,Innes Ireland
404,440,172,1962,Innes Ireland,Jim Hall,2,0,2,Innes Ireland
404,446,172,1962,Innes Ireland,Carlo Abate,2,0,2,Innes Ireland
404,460,172,1962,Innes Ireland,Gerry Ashmore,2,0,2,Innes Ireland
404,463,172,1962,Innes Ireland,Jay Chamberlain,2,0,2,Innes Ireland
404,464,172,1962,Innes Ireland,Tony Shelly,2,0,2,Innes Ireland
404,465,172,1962,Innes Ireland,Keith Greene,2,0,2,Innes Ireland
404,467,172,1962,Innes Ireland,Ernesto Prinoth,2,0,2,Innes Ireland
404,468,172,1962,Innes Ireland,Roger Penske,2,0,2,Innes Ireland
404,469,172,1962,Innes Ireland,Rob Schroeder,2,0,2,Innes Ireland
404,473,172,1962,Innes Ireland,Gary Hocking,2,0,2,Innes Ireland
404,474,172,1962,Innes Ireland,Syd van der Vyver,2,0,2,Innes Ireland
410,413,172,1962,Neville Lederle,Ernie Pieterse,1,0,1,Neville Lederle
410,418,172,1962,Neville Lederle,Masten Gregory,1,0,1,Neville Lederle
410,425,172,1962,Neville Lederle,Nino Vaccarella,1,0,1,Neville Lederle
410,427,172,1962,Neville Lederle,Maurice Trintignant,1,0,1,Neville Lederle
410,436,172,1962,Neville Lederle,John Campbell-Jones,1,0,1,Neville Lederle
410,440,172,1962,Neville Lederle,Jim Hall,1,0,1,Neville Lederle
410,446,172,1962,Neville Lederle,Carlo Abate,1,0,1,Neville Lederle
410,460,172,1962,Neville Lederle,Gerry Ashmore,1,0,1,Neville Lederle
410,463,172,1962,Neville Lederle,Jay Chamberlain,1,0,1,Neville Lederle
410,464,172,1962,Neville Lederle,Tony Shelly,1,0,1,Neville Lederle
410,465,172,1962,Neville Lederle,Keith Greene,1,0,1,Neville Lederle
410,467,172,1962,Neville Lederle,Ernesto Prinoth,1,0,1,Neville Lederle
410,468,172,1962,Neville Lederle,Roger Penske,1,0,1,Neville Lederle
410,469,172,1962,Neville Lederle,Rob Schroeder,1,0,1,Neville Lederle
410,473,172,1962,Neville Lederle,Gary Hocking,1,0,1,Neville Lederle
410,474,172,1962,Neville Lederle,Syd van der Vyver,1,0,1,Neville Lederle
413,418,172,1962,Ernie Pieterse,Masten Gregory,0,0,0,Masten Gregory
413,425,172,1962,Ernie Pieterse,Nino Vaccarella,0,0,0,Nino Vaccarella
413,427,172,1962,Ernie Pieterse,Maurice Trintignant,0,0,0,Maurice Trintignant
413,436,172,1962,Ernie Pieterse,John Campbell-Jones,0,0,0,John Campbell-Jones
413,440,172,1962,Ernie Pieterse,Jim Hall,0,0,0,Jim Hall
413,446,172,1962,Ernie Pieterse,Carlo Abate,0,0,0,Carlo Abate
413,460,172,1962,Ernie Pieterse,Gerry Ashmore,0,0,0,Gerry Ashmore
413,463,172,1962,Ernie Pieterse,Jay Chamberlain,0,0,0,Jay Chamberlain
413,464,172,1962,Ernie Pieterse,Tony Shelly,0,0,0,Tony Shelly
413,465,172,1962,Ernie Pieterse,Keith Greene,0,0,0,Keith Greene
413,467,172,1962,Ernie Pieterse,Ernesto Prinoth,0,0,0,Ernesto Prinoth
413,468,172,1962,Ernie Pieterse,Roger Penske,0,0,0,Roger Penske
413,469,172,1962,Ernie Pieterse,Rob Schroeder,0,0,0,Rob Schroeder
413,473,172,1962,Ernie Pieterse,Gary Hocking,0,0,0,Gary Hocking
413,474,172,1962,Ernie Pieterse,Syd van der Vyver,0,0,0,Syd van der Vyver
418,425,172,1962,Masten Gregory,Nino Vaccarella,0,0,0,Nino Vaccarella
418,427,172,1962,Masten Gregory,Maurice Trintignant,0,0,0,Maurice Trintignant
418,436,172,1962,Masten Gregory,John Campbell-Jones,0,0,0,John Campbell-Jones
418,440,172,1962,Masten Gregory,Jim Hall,0,0,0,Jim Hall
418,446,172,1962,Masten Gregory,Carlo Abate,0,0,0,Carlo Abate
418,460,172,1962,Masten Gregory,Gerry Ashmore,0,0,0,Gerry Ashmore
418,463,172,1962,Masten Gregory,Jay Chamberlain,0,0,0,Jay Chamberlain
418,464,172,1962,Masten Gregory,Tony Shelly,0,0,0,Tony Shelly
418,465,172,1962,Masten Gregory,Keith Greene,0,0,0,Keith Greene
418,467,172,1962,Masten Gregory,Ernesto Prinoth,0,0,0,Ernesto Prinoth
418,468,172,1962,Masten Gregory,Roger Penske,0,0,0,Roger Penske
418,469,172,1962,Masten Gregory,Rob Schroeder,0,0,0,Rob Schroeder
418,473,172,1962,Masten Gregory,Gary Hocking,0,0,0,Gary Hocking
418,474,172,1962,Masten Gregory,Syd van der Vyver,0,0,0,Syd van der Vyver
425,427,172,1962,Nino Vaccarella,Maurice Trintignant,0,0,0,Maurice Trintignant
425,436,172,1962,Nino Vaccarella,John Campbell-Jones,0,0,0,John Campbell-Jones
425,440,172,1962,Nino Vaccarella,Jim Hall,0,0,0,Jim Hall
425,446,172,1962,Nino Vaccarella,Carlo Abate,0,0,0,Carlo Abate
425,460,172,1962,Nino Vaccarella,Gerry Ashmore,0,0,0,Gerry Ashmore
425,463,172,1962,Nino Vaccarella,Jay Chamberlain,0,0,0,Jay Chamberlain
425,464,172,1962,Nino Vaccarella,Tony Shelly,0,0,0,Tony Shelly
425,465,172,1962,Nino Vaccarella,Keith Greene,0,0,0,Keith Greene
425,467,172,1962,Nino Vaccarella,Ernesto Prinoth,0,0,0,Ernesto Prinoth
425,468,172,1962,Nino Vaccarella,Roger Penske,0,0,0,Roger Penske
425,469,172,1962,Nino Vaccarella,Rob Schroeder,0,0,0,Rob Schroeder
425,473,172,1962,Nino Vaccarella,Gary Hocking,0,0,0,Gary Hocking
425,474,172,1962,Nino Vaccarella,Syd van der Vyver,0,0,0,Syd van der Vyver
427,436,172,1962,Maurice Trintignant,John Campbell-Jones,0,0,0,John Campbell-Jones
427,440,172,1962,Maurice Trintignant,Jim Hall,0,0,0,Jim Hall
427,446,172,1962,Maurice Trintignant,Carlo Abate,0,0,0,Carlo Abate
427,460,172,1962,Maurice Trintignant,Gerry Ashmore,0,0,0,Gerry Ashmore
427,463,172,1962,Maurice Trintignant,Jay Chamberlain,0,0,0,Jay Chamberlain
427,464,172,1962,Maurice Trintignant,Tony Shelly,0,0,0,Tony Shelly
427,465,172,1962,Maurice Trintignant,Keith Greene,0,0,0,Keith Greene
427,467,172,1962,Maurice Trintignant,Ernesto Prinoth,0,0,0,Ernesto Prinoth
427,468,172,1962,Maurice Trintignant,Roger Penske,0,0,0,Roger Penske
427,469,172,1962,Maurice Trintignant,Rob Schroeder,0,0,0,Rob Schroeder
427,473,172,1962,Maurice Trintignant,Gary Hocking,0,0,0,Gary Hocking
427,474,172,1962,Maurice Trintignant,Syd van der Vyver,0,0,0,Syd van der Vyver
436,440,172,1962,John Campbell-Jones,Jim Hall,0,0,0,Jim Hall
436,446,172,1962,John Campbell-Jones,Carlo Abate,0,0,0,Carlo Abate
436,460,172,1962,John Campbell-Jones,Gerry Ashmore,0,0,0,Gerry Ashmore
436,463,172,1962,John Campbell-Jones,Jay Chamberlain,0,0,0,Jay Chamberlain
436,464,172,1962,John Campbell-Jones,Tony Shelly,0,0,0,Tony Shelly
436,465,172,1962,John Campbell-Jones,Keith Greene,0,0,0,Keith Greene
436,467,172,1962,John Campbell-Jones,Ernesto Prinoth,0,0,0,Ernesto Prinoth
436,468,172,1962,John Campbell-Jones,Roger Penske,0,0,0,Roger Penske
436,469,172,1962,John Campbell-Jones,Rob Schroeder,0,0,0,Rob Schroeder
436,473,172,1962,John Campbell-Jones,Gary Hocking,0,0,0,Gary Hocking
436,474,172,1962,John Campbell-Jones,Syd van der Vyver,0,0,0,Syd van der Vyver
440,446,172,1962,Jim Hall,Carlo Abate,0,0,0,Carlo Abate
440,460,172,1962,Jim Hall,Gerry Ashmore,0,0,0,Gerry Ashmore
440,463,172,1962,Jim Hall,Jay Chamberlain,0,0,0,Jay Chamberlain
440,464,172,1962,Jim Hall,Tony Shelly,0,0,0,Tony Shelly
440,465,172,1962,Jim Hall,Keith Greene,0,0,0,Keith Greene
440,467,172,1962,Jim Hall,Ernesto Prinoth,0,0,0,Ernesto Prinoth
440,468,172,1962,Jim Hall,Roger Penske,0,0,0,Roger Penske
440,469,172,1962,Jim Hall,Rob Schroeder,0,0,0,Rob Schroeder
440,473,172,1962,Jim Hall,Gary Hocking,0,0,0,Gary Hocking
440,474,172,1962,Jim Hall,Syd van der Vyver,0,0,0,Syd van der Vyver
446,460,172,1962,Carlo Abate,Gerry Ashmore,0,0,0,Gerry Ashmore
446,463,172,1962,Carlo Abate,Jay Chamberlain,0,0,0,Jay Chamberlain
446,464,172,1962,Carlo Abate,Tony Shelly,0,0,0,Tony Shelly
446,465,172,1962,Carlo Abate,Keith Greene,0,0,0,Keith Greene
446,467,172,1962,Carlo Abate,Ernesto Prinoth,0,0,0,Ernesto Prinoth
446,468,172,1962,Carlo Abate,Roger Penske,0,0,0,Roger Penske
446,469,172,1962,Carlo Abate,Rob Schroeder,0,0,0,Rob Schroeder
446,473,172,1962,Carlo Abate,Gary Hocking,0,0,0,Gary Hocking
446,474,172,1962,Carlo Abate,Syd van der Vyver,0,0,0,Syd van der Vyver
460,463,172,1962,Gerry Ashmore,Jay Chamberlain,0,0,0,Jay Chamberlain
460,464,172,1962,Gerry Ashmore,Tony Shelly,0,0,0,Tony Shelly
460,465,172,1962,Gerry Ashmore,Keith Greene,0,0,0,Keith Greene
460,467,172,1962,Gerry Ashmore,Ernesto Prinoth,0,0,0,Ernesto Prinoth
460,468,172,1962,Gerry Ashmore,Roger Penske,0,0,0,Roger Penske
460,469,172,1962,Gerry Ashmore,Rob Schroeder,0,0,0,Rob Schroeder
460,473,172,1962,Gerry Ashmore,Gary Hocking,0,0,0,Gary Hocking
460,474,172,1962,Gerry Ashmore,Syd van der Vyver,0,0,0,Syd van der Vyver
463,464,172,1962,Jay Chamberlain,Tony Shelly,0,0,0,Tony Shelly
463,465,172,1962,Jay Chamberlain,Keith Greene,0,0,0,Keith Greene
463,467,172,1962,Jay Chamberlain,Ernesto Prinoth,0,0,0,Ernesto Prinoth
463,468,172,1962,Jay Chamberlain,Roger Penske,0,0,0,Roger Penske
463,469,172,1962,Jay Chamberlain,Rob Schroeder,0,0,0,Rob Schroeder
463,473,172,1962,Jay Chamberlain,Gary Hocking,0,0,0,Gary Hocking
463,474,172,1962,Jay Chamberlain,Syd van der Vyver,0,0,0,Syd van der Vyver
464,465,172,1962,Tony Shelly,Keith Greene,0,0,0,Keith Greene
464,467,172,1962,Tony Shelly,Ernesto Prinoth,0,0,0,Ernesto Prinoth
464,468,172,1962,Tony Shelly,Roger Penske,0,0,0,Roger Penske
464,469,172,1962,Tony Shelly,Rob Schroeder,0,0,0,Rob Schroeder
464,473,172,1962,Tony Shelly,Gary Hocking,0,0,0,Gary Hocking
464,474,172,1962,Tony Shelly,Syd van der Vyver,0,0,0,Syd van der Vyver
465,467,172,1962,Keith Greene,Ernesto Prinoth,0,0,0,Ernesto Prinoth
465,468,172,1962,Keith Greene,Roger Penske,0,0,0,Roger Penske
465,469,172,1962,Keith Greene,Rob Schroeder,0,0,0,Rob Schroeder
465,473,172,1962,Keith Greene,Gary Hocking,0,0,0,Gary Hocking
465,474,172,1962,Keith Greene,Syd van der Vyver,0,0,0,Syd van der Vyver
467,468,172,1962,Ernesto Prinoth,Roger Penske,0,0,0,Roger Penske
467,469,172,1962,Ernesto Prinoth,Rob Schroeder,0,0,0,Rob Schroeder
467,473,172,1962,Ernesto Prinoth,Gary Hocking,0,0,0,Gary Hocking
467,474,172,1962,Ernesto Prinoth,Syd van der Vyver,0,0,0,Syd van der Vyver
468,469,172,1962,Roger Penske,Rob Schroeder,0,0,0,Rob Schroeder
468,473,172,1962,Roger Penske,Gary Hocking,0,0,0,Gary Hocking
468,474,172,1962,Roger Penske,Syd van der Vyver,0,0,0,Syd van der Vyver
469,473,172,1962,Rob Schroeder,Gary Hocking,0,0,0,Gary Hocking
469,474,172,1962,Rob Schroeder,Syd van der Vyver,0,0,0,Syd van der Vyver
473,474,172,1962,Gary Hocking,Syd van der Vyver,0,0,0,Syd van der Vyver
305,345,172,1963,Mike Hailwood,Pedro RodrÃ­guez,0,0,0,Pedro RodrÃ­guez
305,356,172,1963,Mike Hailwood,Jack Brabham,0,0,0,Jack Brabham
305,373,172,1963,Mike Hailwood,Jim Clark,0,73,73,Jim Clark
305,374,172,1963,Mike Hailwood,Mike Spence,0,0,0,Mike Spence
305,397,172,1963,Mike Hailwood,Peter Arundell,0,0,0,Peter Arundell
305,401,172,1963,Mike Hailwood,Trevor Taylor,0,1,1,Trevor Taylor
305,410,172,1963,Mike Hailwood,Neville Lederle,0,0,0,Neville Lederle
305,413,172,1963,Mike Hailwood,Ernie Pieterse,0,0,0,Ernie Pieterse
305,427,172,1963,Mike Hailwood,Maurice Trintignant,0,0,0,Maurice Trintignant
305,428,172,1963,Mike Hailwood,Bernard Collomb,0,0,0,Bernard Collomb
305,429,172,1963,Mike Hailwood,AndrÃ© Pilette,0,0,0,AndrÃ© Pilette
305,433,172,1963,Mike Hailwood,Walt Hansgen,0,0,0,Walt Hansgen
305,441,172,1963,Mike Hailwood,Tim Parnell,0,0,0,Tim Parnell
305,452,172,1963,Mike Hailwood,Thomas Monarch,0,0,0,Thomas Monarch
345,356,172,1963,Pedro RodrÃ­guez,Jack Brabham,0,0,0,Jack Brabham
345,373,172,1963,Pedro RodrÃ­guez,Jim Clark,0,73,73,Jim Clark
345,374,172,1963,Pedro RodrÃ­guez,Mike Spence,0,0,0,Mike Spence
345,397,172,1963,Pedro RodrÃ­guez,Peter Arundell,0,0,0,Peter Arundell
345,401,172,1963,Pedro RodrÃ­guez,Trevor Taylor,0,1,1,Trevor Taylor
345,410,172,1963,Pedro RodrÃ­guez,Neville Lederle,0,0,0,Neville Lederle
345,413,172,1963,Pedro RodrÃ­guez,Ernie Pieterse,0,0,0,Ernie Pieterse
345,427,172,1963,Pedro RodrÃ­guez,Maurice Trintignant,0,0,0,Maurice Trintignant
345,428,172,1963,Pedro RodrÃ­guez,Bernard Collomb,0,0,0,Bernard Collomb
345,429,172,1963,Pedro RodrÃ­guez,AndrÃ© Pilette,0,0,0,AndrÃ© Pilette
345,433,172,1963,Pedro RodrÃ­guez,Walt Hansgen,0,0,0,Walt Hansgen
345,441,172,1963,Pedro RodrÃ­guez,Tim Parnell,0,0,0,Tim Parnell
345,452,172,1963,Pedro RodrÃ­guez,Thomas Monarch,0,0,0,Thomas Monarch
356,373,172,1963,Jack Brabham,Jim Clark,0,73,73,Jim Clark
356,374,172,1963,Jack Brabham,Mike Spence,0,0,0,Mike Spence
356,397,172,1963,Jack Brabham,Peter Arundell,0,0,0,Peter Arundell
356,401,172,1963,Jack Brabham,Trevor Taylor,0,1,1,Trevor Taylor
356,410,172,1963,Jack Brabham,Neville Lederle,0,0,0,Neville Lederle
356,413,172,1963,Jack Brabham,Ernie Pieterse,0,0,0,Ernie Pieterse
356,427,172,1963,Jack Brabham,Maurice Trintignant,0,0,0,Maurice Trintignant
356,428,172,1963,Jack Brabham,Bernard Collomb,0,0,0,Bernard Collomb
356,429,172,1963,Jack Brabham,AndrÃ© Pilette,0,0,0,AndrÃ© Pilette
356,433,172,1963,Jack Brabham,Walt Hansgen,0,0,0,Walt Hansgen
356,441,172,1963,Jack Brabham,Tim Parnell,0,0,0,Tim Parnell
356,452,172,1963,Jack Brabham,Thomas Monarch,0,0,0,Thomas Monarch
373,374,172,1963,Jim Clark,Mike Spence,73,0,73,Jim Clark
373,397,172,1963,Jim Clark,Peter Arundell,73,0,73,Jim Clark
373,401,172,1963,Jim Clark,Trevor Taylor,73,1,72,Jim Clark
373,410,172,1963,Jim Clark,Neville Lederle,73,0,73,Jim Clark
373,413,172,1963,Jim Clark,Ernie Pieterse,73,0,73,Jim Clark
373,427,172,1963,Jim Clark,Maurice Trintignant,73,0,73,Jim Clark
373,428,172,1963,Jim Clark,Bernard Collomb,73,0,73,Jim Clark
373,429,172,1963,Jim Clark,AndrÃ© Pilette,73,0,73,Jim Clark
373,433,172,1963,Jim Clark,Walt Hansgen,73,0,73,Jim Clark
373,441,172,1963,Jim Clark,Tim Parnell,73,0,73,Jim Clark
373,452,172,1963,Jim Clark,Thomas Monarch,73,0,73,Jim Clark
374,397,172,1963,Mike Spence,Peter Arundell,0,0,0,Peter Arundell
374,401,172,1963,Mike Spence,Trevor Taylor,0,1,1,Trevor Taylor
374,410,172,1963,Mike Spence,Neville Lederle,0,0,0,Neville Lederle
374,413,172,1963,Mike Spence,Ernie Pieterse,0,0,0,Ernie Pieterse
374,427,172,1963,Mike Spence,Maurice Trintignant,0,0,0,Maurice Trintignant
374,428,172,1963,Mike Spence,Bernard Collomb,0,0,0,Bernard Collomb
374,429,172,1963,Mike Spence,AndrÃ© Pilette,0,0,0,AndrÃ© Pilette
374,433,172,1963,Mike Spence,Walt Hansgen,0,0,0,Walt Hansgen
374,441,172,1963,Mike Spence,Tim Parnell,0,0,0,Tim Parnell
374,452,172,1963,Mike Spence,Thomas Monarch,0,0,0,Thomas Monarch
397,401,172,1963,Peter Arundell,Trevor Taylor,0,1,1,Trevor Taylor
397,410,172,1963,Peter Arundell,Neville Lederle,0,0,0,Neville Lederle
397,413,172,1963,Peter Arundell,Ernie Pieterse,0,0,0,Ernie Pieterse
397,427,172,1963,Peter Arundell,Maurice Trintignant,0,0,0,Maurice Trintignant
397,428,172,1963,Peter Arundell,Bernard Collomb,0,0,0,Bernard Collomb
397,429,172,1963,Peter Arundell,AndrÃ© Pilette,0,0,0,AndrÃ© Pilette
397,433,172,1963,Peter Arundell,Walt Hansgen,0,0,0,Walt Hansgen
397,441,172,1963,Peter Arundell,Tim Parnell,0,0,0,Tim Parnell
397,452,172,1963,Peter Arundell,Thomas Monarch,0,0,0,Thomas Monarch
401,410,172,1963,Trevor Taylor,Neville Lederle,1,0,1,Trevor Taylor
401,413,172,1963,Trevor Taylor,Ernie Pieterse,1,0,1,Trevor Taylor
401,427,172,1963,Trevor Taylor,Maurice Trintignant,1,0,1,Trevor Taylor
401,428,172,1963,Trevor Taylor,Bernard Collomb,1,0,1,Trevor Taylor
401,429,172,1963,Trevor Taylor,AndrÃ© Pilette,1,0,1,Trevor Taylor
401,433,172,1963,Trevor Taylor,Walt Hansgen,1,0,1,Trevor Taylor
401,441,172,1963,Trevor Taylor,Tim Parnell,1,0,1,Trevor Taylor
401,452,172,1963,Trevor Taylor,Thomas Monarch,1,0,1,Trevor Taylor
410,413,172,1963,Neville Lederle,Ernie Pieterse,0,0,0,Ernie Pieterse
410,427,172,1963,Neville Lederle,Maurice Trintignant,0,0,0,Maurice Trintignant
410,428,172,1963,Neville Lederle,Bernard Collomb,0,0,0,Bernard Collomb
410,429,172,1963,Neville Lederle,AndrÃ© Pilette,0,0,0,AndrÃ© Pilette
410,433,172,1963,Neville Lederle,Walt Hansgen,0,0,0,Walt Hansgen
410,441,172,1963,Neville Lederle,Tim Parnell,0,0,0,Tim Parnell
410,452,172,1963,Neville Lederle,Thomas Monarch,0,0,0,Thomas Monarch
413,427,172,1963,Ernie Pieterse,Maurice Trintignant,0,0,0,Maurice Trintignant
413,428,172,1963,Ernie Pieterse,Bernard Collomb,0,0,0,Bernard Collomb
413,429,172,1963,Ernie Pieterse,AndrÃ© Pilette,0,0,0,AndrÃ© Pilette
413,433,172,1963,Ernie Pieterse,Walt Hansgen,0,0,0,Walt Hansgen
413,441,172,1963,Ernie Pieterse,Tim Parnell,0,0,0,Tim Parnell
413,452,172,1963,Ernie Pieterse,Thomas Monarch,0,0,0,Thomas Monarch
427,428,172,1963,Maurice Trintignant,Bernard Collomb,0,0,0,Bernard Collomb
427,429,172,1963,Maurice Trintignant,AndrÃ© Pilette,0,0,0,AndrÃ© Pilette
427,433,172,1963,Maurice Trintignant,Walt Hansgen,0,0,0,Walt Hansgen
427,441,172,1963,Maurice Trintignant,Tim Parnell,0,0,0,Tim Parnell
427,452,172,1963,Maurice Trintignant,Thomas Monarch,0,0,0,Thomas Monarch
428,429,172,1963,Bernard Collomb,AndrÃ© Pilette,0,0,0,AndrÃ© Pilette
428,433,172,1963,Bernard Collomb,Walt Hansgen,0,0,0,Walt Hansgen
428,441,172,1963,Bernard Collomb,Tim Parnell,0,0,0,Tim Parnell
428,452,172,1963,Bernard Collomb,Thomas Monarch,0,0,0,Thomas Monarch
429,433,172,1963,AndrÃ© Pilette,Walt Hansgen,0,0,0,Walt Hansgen
429,441,172,1963,AndrÃ© Pilette,Tim Parnell,0,0,0,Tim Parnell
429,452,172,1963,AndrÃ© Pilette,Thomas Monarch,0,0,0,Thomas Monarch
433,441,172,1963,Walt Hansgen,Tim Parnell,0,0,0,Tim Parnell
433,452,172,1963,Walt Hansgen,Thomas Monarch,0,0,0,Thomas Monarch
441,452,172,1963,Tim Parnell,Thomas Monarch,0,0,0,Thomas Monarch
278,309,172,1964,Chris Amon,Peter Revson,0,0,0,Peter Revson
278,373,172,1964,Chris Amon,Jim Clark,0,32,32,Jim Clark
278,374,172,1964,Chris Amon,Mike Spence,0,4,4,Mike Spence
278,382,172,1964,Chris Amon,MoisÃ©s Solana,0,0,0,MoisÃ©s Solana
278,397,172,1964,Chris Amon,Peter Arundell,0,11,11,Peter Arundell
278,423,172,1964,Chris Amon,Gerhard Mitter,0,0,0,Gerhard Mitter
278,433,172,1964,Chris Amon,Walt Hansgen,0,2,2,Walt Hansgen
309,373,172,1964,Peter Revson,Jim Clark,0,32,32,Jim Clark
309,374,172,1964,Peter Revson,Mike Spence,0,4,4,Mike Spence
309,382,172,1964,Peter Revson,MoisÃ©s Solana,0,0,0,MoisÃ©s Solana
309,397,172,1964,Peter Revson,Peter Arundell,0,11,11,Peter Arundell
309,423,172,1964,Peter Revson,Gerhard Mitter,0,0,0,Gerhard Mitter
309,433,172,1964,Peter Revson,Walt Hansgen,0,2,2,Walt Hansgen
373,374,172,1964,Jim Clark,Mike Spence,32,4,28,Jim Clark
373,382,172,1964,Jim Clark,MoisÃ©s Solana,32,0,32,Jim Clark
373,397,172,1964,Jim Clark,Peter Arundell,32,11,21,Jim Clark
373,423,172,1964,Jim Clark,Gerhard Mitter,32,0,32,Jim Clark
373,433,172,1964,Jim Clark,Walt Hansgen,32,2,30,Jim Clark
374,382,172,1964,Mike Spence,MoisÃ©s Solana,4,0,4,Mike Spence
374,397,172,1964,Mike Spence,Peter Arundell,4,11,7,Peter Arundell
374,423,172,1964,Mike Spence,Gerhard Mitter,4,0,4,Mike Spence
374,433,172,1964,Mike Spence,Walt Hansgen,4,2,2,Mike Spence
382,397,172,1964,MoisÃ©s Solana,Peter Arundell,0,11,11,Peter Arundell
382,423,172,1964,MoisÃ©s Solana,Gerhard Mitter,0,0,0,Gerhard Mitter
382,433,172,1964,MoisÃ©s Solana,Walt Hansgen,0,2,2,Walt Hansgen
397,423,172,1964,Peter Arundell,Gerhard Mitter,11,0,11,Peter Arundell
397,433,172,1964,Peter Arundell,Walt Hansgen,11,2,9,Peter Arundell
423,433,172,1964,Gerhard Mitter,Walt Hansgen,0,2,2,Walt Hansgen
373,374,172,1965,Jim Clark,Mike Spence,54,10,44,Jim Clark
373,382,172,1965,Jim Clark,MoisÃ©s Solana,54,0,54,Jim Clark
373,402,172,1965,Jim Clark,Giacomo Russo,54,0,54,Jim Clark
373,406,172,1965,Jim Clark,Paul Hawkins,54,0,54,Jim Clark
373,410,172,1965,Jim Clark,Neville Lederle,54,0,54,Jim Clark
373,413,172,1965,Jim Clark,Ernie Pieterse,54,0,54,Jim Clark
373,414,172,1965,Jim Clark,Clive Puzey,54,0,54,Jim Clark
373,422,172,1965,Jim Clark,Brian Gubby,54,0,54,Jim Clark
373,423,172,1965,Jim Clark,Gerhard Mitter,54,0,54,Jim Clark
374,382,172,1965,Mike Spence,MoisÃ©s Solana,10,0,10,Mike Spence
374,402,172,1965,Mike Spence,Giacomo Russo,10,0,10,Mike Spence
374,406,172,1965,Mike Spence,Paul Hawkins,10,0,10,Mike Spence
374,410,172,1965,Mike Spence,Neville Lederle,10,0,10,Mike Spence
374,413,172,1965,Mike Spence,Ernie Pieterse,10,0,10,Mike Spence
374,414,172,1965,Mike Spence,Clive Puzey,10,0,10,Mike Spence
374,422,172,1965,Mike Spence,Brian Gubby,10,0,10,Mike Spence
374,423,172,1965,Mike Spence,Gerhard Mitter,10,0,10,Mike Spence
382,402,172,1965,MoisÃ©s Solana,Giacomo Russo,0,0,0,Giacomo Russo
382,406,172,1965,MoisÃ©s Solana,Paul Hawkins,0,0,0,Paul Hawkins
382,410,172,1965,MoisÃ©s Solana,Neville Lederle,0,0,0,Neville Lederle
382,413,172,1965,MoisÃ©s Solana,Ernie Pieterse,0,0,0,Ernie Pieterse
382,414,172,1965,MoisÃ©s Solana,Clive Puzey,0,0,0,Clive Puzey
382,422,172,1965,MoisÃ©s Solana,Brian Gubby,0,0,0,Brian Gubby
382,423,172,1965,MoisÃ©s Solana,Gerhard Mitter,0,0,0,Gerhard Mitter
402,406,172,1965,Giacomo Russo,Paul Hawkins,0,0,0,Paul Hawkins
402,410,172,1965,Giacomo Russo,Neville Lederle,0,0,0,Neville Lederle
402,413,172,1965,Giacomo Russo,Ernie Pieterse,0,0,0,Ernie Pieterse
402,414,172,1965,Giacomo Russo,Clive Puzey,0,0,0,Clive Puzey
402,422,172,1965,Giacomo Russo,Brian Gubby,0,0,0,Brian Gubby
402,423,172,1965,Giacomo Russo,Gerhard Mitter,0,0,0,Gerhard Mitter
406,410,172,1965,Paul Hawkins,Neville Lederle,0,0,0,Neville Lederle
406,413,172,1965,Paul Hawkins,Ernie Pieterse,0,0,0,Ernie Pieterse
406,414,172,1965,Paul Hawkins,Clive Puzey,0,0,0,Clive Puzey
406,422,172,1965,Paul Hawkins,Brian Gubby,0,0,0,Brian Gubby
406,423,172,1965,Paul Hawkins,Gerhard Mitter,0,0,0,Gerhard Mitter
410,413,172,1965,Neville Lederle,Ernie Pieterse,0,0,0,Ernie Pieterse
410,414,172,1965,Neville Lederle,Clive Puzey,0,0,0,Clive Puzey
410,422,172,1965,Neville Lederle,Brian Gubby,0,0,0,Brian Gubby
410,423,172,1965,Neville Lederle,Gerhard Mitter,0,0,0,Gerhard Mitter
413,414,172,1965,Ernie Pieterse,Clive Puzey,0,0,0,Clive Puzey
413,422,172,1965,Ernie Pieterse,Brian Gubby,0,0,0,Brian Gubby
413,423,172,1965,Ernie Pieterse,Gerhard Mitter,0,0,0,Gerhard Mitter
414,422,172,1965,Clive Puzey,Brian Gubby,0,0,0,Brian Gubby
414,423,172,1965,Clive Puzey,Gerhard Mitter,0,0,0,Gerhard Mitter
422,423,172,1965,Brian Gubby,Gerhard Mitter,0,0,0,Gerhard Mitter
345,373,172,1966,Pedro RodrÃ­guez,Jim Clark,0,7,7,Jim Clark
345,397,172,1966,Pedro RodrÃ­guez,Peter Arundell,0,1,1,Peter Arundell
345,402,172,1966,Pedro RodrÃ­guez,Giacomo Russo,0,0,0,Giacomo Russo
373,397,172,1966,Jim Clark,Peter Arundell,7,1,6,Jim Clark
373,402,172,1966,Jim Clark,Giacomo Russo,7,0,7,Jim Clark
397,402,172,1966,Peter Arundell,Giacomo Russo,1,0,1,Peter Arundell
444,483,174,1961,Roberto Lippi,Giorgio Scarlatti,0,0,0,Giorgio Scarlatti
424,425,175,1961,Roberto Bussinello,Nino Vaccarella,0,0,0,Nino Vaccarella
346,364,176,1962,Jo Siffert,Dan Gurney,0,0,0,Dan Gurney
346,418,176,1962,Jo Siffert,Masten Gregory,0,1,1,Masten Gregory
346,445,176,1962,Jo Siffert,GÃ¼nther Seiffert,0,0,0,GÃ¼nther Seiffert
346,455,176,1962,Jo Siffert,Wolfgang Seidel,0,0,0,Wolfgang Seidel
346,461,176,1962,Jo Siffert,Heinz Schiller,0,0,0,Heinz Schiller
346,464,176,1962,Jo Siffert,Tony Shelly,0,0,0,Tony Shelly
364,418,176,1962,Dan Gurney,Masten Gregory,0,1,1,Masten Gregory
364,445,176,1962,Dan Gurney,GÃ¼nther Seiffert,0,0,0,GÃ¼nther Seiffert
364,455,176,1962,Dan Gurney,Wolfgang Seidel,0,0,0,Wolfgang Seidel
364,461,176,1962,Dan Gurney,Heinz Schiller,0,0,0,Heinz Schiller
364,464,176,1962,Dan Gurney,Tony Shelly,0,0,0,Tony Shelly
418,445,176,1962,Masten Gregory,GÃ¼nther Seiffert,1,0,1,Masten Gregory
418,455,176,1962,Masten Gregory,Wolfgang Seidel,1,0,1,Masten Gregory
418,461,176,1962,Masten Gregory,Heinz Schiller,1,0,1,Masten Gregory
418,464,176,1962,Masten Gregory,Tony Shelly,1,0,1,Masten Gregory
445,455,176,1962,GÃ¼nther Seiffert,Wolfgang Seidel,0,0,0,Wolfgang Seidel
445,461,176,1962,GÃ¼nther Seiffert,Heinz Schiller,0,0,0,Heinz Schiller
445,464,176,1962,GÃ¼nther Seiffert,Tony Shelly,0,0,0,Tony Shelly
455,461,176,1962,Wolfgang Seidel,Heinz Schiller,0,0,0,Heinz Schiller
455,464,176,1962,Wolfgang Seidel,Tony Shelly,0,0,0,Tony Shelly
461,464,176,1962,Heinz Schiller,Tony Shelly,0,0,0,Tony Shelly
278,310,176,1963,Chris Amon,Paddy Driver,0,0,0,Paddy Driver
278,346,176,1963,Chris Amon,Jo Siffert,0,1,1,Jo Siffert
278,403,176,1963,Chris Amon,Phil Hill,0,0,0,Phil Hill
278,404,176,1963,Chris Amon,Innes Ireland,0,0,0,Innes Ireland
278,418,176,1963,Chris Amon,Masten Gregory,0,0,0,Masten Gregory
278,434,176,1963,Chris Amon,Hap Sharp,0,0,0,Hap Sharp
278,436,176,1963,Chris Amon,John Campbell-Jones,0,0,0,John Campbell-Jones
278,440,176,1963,Chris Amon,Jim Hall,0,3,3,Jim Hall
278,445,176,1963,Chris Amon,GÃ¼nther Seiffert,0,0,0,GÃ¼nther Seiffert
278,449,176,1963,Chris Amon,Rodger Ward,0,0,0,Rodger Ward
310,346,176,1963,Paddy Driver,Jo Siffert,0,1,1,Jo Siffert
310,403,176,1963,Paddy Driver,Phil Hill,0,0,0,Phil Hill
310,404,176,1963,Paddy Driver,Innes Ireland,0,0,0,Innes Ireland
310,418,176,1963,Paddy Driver,Masten Gregory,0,0,0,Masten Gregory
310,434,176,1963,Paddy Driver,Hap Sharp,0,0,0,Hap Sharp
310,436,176,1963,Paddy Driver,John Campbell-Jones,0,0,0,John Campbell-Jones
310,440,176,1963,Paddy Driver,Jim Hall,0,3,3,Jim Hall
310,445,176,1963,Paddy Driver,GÃ¼nther Seiffert,0,0,0,GÃ¼nther Seiffert
310,449,176,1963,Paddy Driver,Rodger Ward,0,0,0,Rodger Ward
346,403,176,1963,Jo Siffert,Phil Hill,1,0,1,Jo Siffert
346,404,176,1963,Jo Siffert,Innes Ireland,1,0,1,Jo Siffert
346,418,176,1963,Jo Siffert,Masten Gregory,1,0,1,Jo Siffert
346,434,176,1963,Jo Siffert,Hap Sharp,1,0,1,Jo Siffert
346,436,176,1963,Jo Siffert,John Campbell-Jones,1,0,1,Jo Siffert
346,440,176,1963,Jo Siffert,Jim Hall,1,3,2,Jim Hall
346,445,176,1963,Jo Siffert,GÃ¼nther Seiffert,1,0,1,Jo Siffert
346,449,176,1963,Jo Siffert,Rodger Ward,1,0,1,Jo Siffert
403,404,176,1963,Phil Hill,Innes Ireland,0,0,0,Innes Ireland
403,418,176,1963,Phil Hill,Masten Gregory,0,0,0,Masten Gregory
403,434,176,1963,Phil Hill,Hap Sharp,0,0,0,Hap Sharp
403,436,176,1963,Phil Hill,John Campbell-Jones,0,0,0,John Campbell-Jones
403,440,176,1963,Phil Hill,Jim Hall,0,3,3,Jim Hall
403,445,176,1963,Phil Hill,GÃ¼nther Seiffert,0,0,0,GÃ¼nther Seiffert
403,449,176,1963,Phil Hill,Rodger Ward,0,0,0,Rodger Ward
404,418,176,1963,Innes Ireland,Masten Gregory,0,0,0,Masten Gregory
404,434,176,1963,Innes Ireland,Hap Sharp,0,0,0,Hap Sharp
404,436,176,1963,Innes Ireland,John Campbell-Jones,0,0,0,John Campbell-Jones
404,440,176,1963,Innes Ireland,Jim Hall,0,3,3,Jim Hall
404,445,176,1963,Innes Ireland,GÃ¼nther Seiffert,0,0,0,GÃ¼nther Seiffert
404,449,176,1963,Innes Ireland,Rodger Ward,0,0,0,Rodger Ward
418,434,176,1963,Masten Gregory,Hap Sharp,0,0,0,Hap Sharp
418,436,176,1963,Masten Gregory,John Campbell-Jones,0,0,0,John Campbell-Jones
418,440,176,1963,Masten Gregory,Jim Hall,0,3,3,Jim Hall
418,445,176,1963,Masten Gregory,GÃ¼nther Seiffert,0,0,0,GÃ¼nther Seiffert
418,449,176,1963,Masten Gregory,Rodger Ward,0,0,0,Rodger Ward
434,436,176,1963,Hap Sharp,John Campbell-Jones,0,0,0,John Campbell-Jones
434,440,176,1963,Hap Sharp,Jim Hall,0,3,3,Jim Hall
434,445,176,1963,Hap Sharp,GÃ¼nther Seiffert,0,0,0,GÃ¼nther Seiffert
434,449,176,1963,Hap Sharp,Rodger Ward,0,0,0,Rodger Ward
436,440,176,1963,John Campbell-Jones,Jim Hall,0,3,3,Jim Hall
436,445,176,1963,John Campbell-Jones,GÃ¼nther Seiffert,0,0,0,GÃ¼nther Seiffert
436,449,176,1963,John Campbell-Jones,Rodger Ward,0,0,0,Rodger Ward
440,445,176,1963,Jim Hall,GÃ¼nther Seiffert,3,0,3,Jim Hall
440,449,176,1963,Jim Hall,Rodger Ward,3,0,3,Jim Hall
445,449,176,1963,GÃ¼nther Seiffert,Rodger Ward,0,0,0,Rodger Ward
278,305,176,1964,Chris Amon,Mike Hailwood,2,1,1,Chris Amon
278,309,176,1964,Chris Amon,Peter Revson,2,0,2,Chris Amon
278,346,176,1964,Chris Amon,Jo Siffert,2,0,2,Chris Amon
278,401,176,1964,Chris Amon,Trevor Taylor,2,0,2,Chris Amon
278,404,176,1964,Chris Amon,Innes Ireland,2,0,2,Chris Amon
278,428,176,1964,Chris Amon,Bernard Collomb,2,0,2,Chris Amon
305,309,176,1964,Mike Hailwood,Peter Revson,1,0,1,Mike Hailwood
305,346,176,1964,Mike Hailwood,Jo Siffert,1,0,1,Mike Hailwood
305,401,176,1964,Mike Hailwood,Trevor Taylor,1,0,1,Mike Hailwood
305,404,176,1964,Mike Hailwood,Innes Ireland,1,0,1,Mike Hailwood
305,428,176,1964,Mike Hailwood,Bernard Collomb,1,0,1,Mike Hailwood
309,346,176,1964,Peter Revson,Jo Siffert,0,0,0,Jo Siffert
309,401,176,1964,Peter Revson,Trevor Taylor,0,0,0,Trevor Taylor
309,404,176,1964,Peter Revson,Innes Ireland,0,0,0,Innes Ireland
309,428,176,1964,Peter Revson,Bernard Collomb,0,0,0,Bernard Collomb
346,401,176,1964,Jo Siffert,Trevor Taylor,0,0,0,Trevor Taylor
346,404,176,1964,Jo Siffert,Innes Ireland,0,0,0,Innes Ireland
346,428,176,1964,Jo Siffert,Bernard Collomb,0,0,0,Bernard Collomb
401,404,176,1964,Trevor Taylor,Innes Ireland,0,0,0,Innes Ireland
401,428,176,1964,Trevor Taylor,Bernard Collomb,0,0,0,Bernard Collomb
404,428,176,1964,Innes Ireland,Bernard Collomb,0,0,0,Bernard Collomb
278,305,176,1965,Chris Amon,Mike Hailwood,0,0,0,Mike Hailwood
278,370,176,1965,Chris Amon,Richard Attwood,0,2,2,Richard Attwood
278,396,176,1965,Chris Amon,Bob Bondurant,0,0,0,Bob Bondurant
278,404,176,1965,Chris Amon,Innes Ireland,0,0,0,Innes Ireland
278,408,176,1965,Chris Amon,Tony Maggs,0,0,0,Tony Maggs
305,370,176,1965,Mike Hailwood,Richard Attwood,0,2,2,Richard Attwood
305,396,176,1965,Mike Hailwood,Bob Bondurant,0,0,0,Bob Bondurant
305,404,176,1965,Mike Hailwood,Innes Ireland,0,0,0,Innes Ireland
305,408,176,1965,Mike Hailwood,Tony Maggs,0,0,0,Tony Maggs
370,396,176,1965,Richard Attwood,Bob Bondurant,2,0,2,Richard Attwood
370,404,176,1965,Richard Attwood,Innes Ireland,2,0,2,Richard Attwood
370,408,176,1965,Richard Attwood,Tony Maggs,2,0,2,Richard Attwood
396,404,176,1965,Bob Bondurant,Innes Ireland,0,0,0,Innes Ireland
396,408,176,1965,Bob Bondurant,Tony Maggs,0,0,0,Tony Maggs
404,408,176,1965,Innes Ireland,Tony Maggs,0,0,0,Tony Maggs
345,373,176,1966,Pedro RodrÃ­guez,Jim Clark,0,9,9,Jim Clark
345,374,176,1966,Pedro RodrÃ­guez,Mike Spence,0,4,4,Mike Spence
345,397,176,1966,Pedro RodrÃ­guez,Peter Arundell,0,0,0,Peter Arundell
373,374,176,1966,Jim Clark,Mike Spence,9,4,5,Jim Clark
373,397,176,1966,Jim Clark,Peter Arundell,9,0,9,Jim Clark
374,397,176,1966,Mike Spence,Peter Arundell,4,0,4,Mike Spence
289,361,176,1967,Graham Hill,Piers Courage,6,0,6,Graham Hill
289,373,176,1967,Graham Hill,Jim Clark,6,0,6,Graham Hill
289,382,176,1967,Graham Hill,MoisÃ©s Solana,6,0,6,Graham Hill
289,388,176,1967,Graham Hill,Chris Irwin,6,0,6,Graham Hill
289,392,176,1967,Graham Hill,Mike Fisher,6,0,6,Graham Hill
361,373,176,1967,Piers Courage,Jim Clark,0,0,0,Jim Clark
361,382,176,1967,Piers Courage,MoisÃ©s Solana,0,0,0,MoisÃ©s Solana
361,388,176,1967,Piers Courage,Chris Irwin,0,0,0,Chris Irwin
361,392,176,1967,Piers Courage,Mike Fisher,0,0,0,Mike Fisher
373,382,176,1967,Jim Clark,MoisÃ©s Solana,0,0,0,MoisÃ©s Solana
373,388,176,1967,Jim Clark,Chris Irwin,0,0,0,Chris Irwin
373,392,176,1967,Jim Clark,Mike Fisher,0,0,0,Mike Fisher
382,388,176,1967,MoisÃ©s Solana,Chris Irwin,0,0,0,Chris Irwin
382,392,176,1967,MoisÃ©s Solana,Mike Fisher,0,0,0,Mike Fisher
388,392,176,1967,Chris Irwin,Mike Fisher,0,0,0,Mike Fisher
110,145,18,1986,Andrea de Cesaris,Alessandro Nannini,0,0,0,Alessandro Nannini
145,167,18,1987,Alessandro Nannini,AdriÃ¡n Campos,0,0,0,AdriÃ¡n Campos
159,167,18,1988,Luis PÃ©rez-Sala,AdriÃ¡n Campos,0,0,0,AdriÃ¡n Campos
159,94,18,1988,Luis PÃ©rez-Sala,Pierluigi Martini,0,1,1,Pierluigi Martini
167,94,18,1988,AdriÃ¡n Campos,Pierluigi Martini,0,1,1,Pierluigi Martini
147,159,18,1989,Paolo Barilla,Luis PÃ©rez-Sala,0,1,1,Luis PÃ©rez-Sala
147,94,18,1989,Paolo Barilla,Pierluigi Martini,0,5,5,Pierluigi Martini
159,94,18,1989,Luis PÃ©rez-Sala,Pierluigi Martini,1,5,4,Pierluigi Martini
147,81,18,1990,Paolo Barilla,Gianni Morbidelli,0,0,0,Gianni Morbidelli
147,94,18,1990,Paolo Barilla,Pierluigi Martini,0,0,0,Pierluigi Martini
81,94,18,1990,Gianni Morbidelli,Pierluigi Martini,0,0,0,Pierluigi Martini
81,90,18,1991,Gianni Morbidelli,Roberto Moreno,0,0,0,Roberto Moreno
81,94,18,1991,Gianni Morbidelli,Pierluigi Martini,0,6,6,Pierluigi Martini
90,94,18,1991,Roberto Moreno,Pierluigi Martini,0,6,6,Pierluigi Martini
104,70,18,1992,Christian Fittipaldi,Alessandro Zanardi,1,0,1,Christian Fittipaldi
104,81,18,1992,Christian Fittipaldi,Gianni Morbidelli,1,0,1,Christian Fittipaldi
70,81,18,1992,Alessandro Zanardi,Gianni Morbidelli,0,0,0,Gianni Morbidelli
104,111,18,1993,Christian Fittipaldi,Jean-Marc Gounon,5,0,5,Christian Fittipaldi
104,120,18,1993,Christian Fittipaldi,Fabrizio Barbazza,5,2,3,Christian Fittipaldi
104,94,18,1993,Christian Fittipaldi,Pierluigi Martini,5,0,5,Christian Fittipaldi
111,120,18,1993,Jean-Marc Gounon,Fabrizio Barbazza,0,2,2,Fabrizio Barbazza
111,94,18,1993,Jean-Marc Gounon,Pierluigi Martini,0,0,0,Pierluigi Martini
120,94,18,1993,Fabrizio Barbazza,Pierluigi Martini,2,0,2,Fabrizio Barbazza
105,94,18,1994,Michele Alboreto,Pierluigi Martini,1,4,3,Pierluigi Martini
69,83,18,1995,Luca Badoer,Pedro Lamy,0,1,1,Pedro Lamy
69,94,18,1995,Luca Badoer,Pierluigi Martini,0,0,0,Pierluigi Martini
83,94,18,1995,Pedro Lamy,Pierluigi Martini,1,0,1,Pedro Lamy
21,58,18,1996,Giancarlo Fisichella,Tarso Marques,0,0,0,Tarso Marques
21,83,18,1996,Giancarlo Fisichella,Pedro Lamy,0,0,0,Pedro Lamy
21,86,18,1996,Giancarlo Fisichella,Giovanni Lavaggi,0,0,0,Giovanni Lavaggi
58,83,18,1996,Tarso Marques,Pedro Lamy,0,0,0,Pedro Lamy
58,86,18,1996,Tarso Marques,Giovanni Lavaggi,0,0,0,Giovanni Lavaggi
83,86,18,1996,Pedro Lamy,Giovanni Lavaggi,0,0,0,Giovanni Lavaggi
15,58,18,1997,Jarno Trulli,Tarso Marques,0,0,0,Tarso Marques
15,79,18,1997,Jarno Trulli,Ukyo Katayama,0,0,0,Ukyo Katayama
58,79,18,1997,Tarso Marques,Ukyo Katayama,0,0,0,Ukyo Katayama
74,75,18,1998,Esteban Tuero,Shinji Nakano,0,0,0,Shinji Nakano
48,69,18,1999,Marc GenÃ©,Luca Badoer,1,0,1,Marc GenÃ©
48,72,18,1999,Marc GenÃ©,StÃ©phane Sarrazin,1,0,1,Marc GenÃ©
69,72,18,1999,Luca Badoer,StÃ©phane Sarrazin,0,0,0,StÃ©phane Sarrazin
48,60,18,2000,Marc GenÃ©,GastÃ³n Mazzacane,0,0,0,GastÃ³n Mazzacane
4,58,18,2001,Fernando Alonso,Tarso Marques,0,0,0,Tarso Marques
4,62,18,2001,Fernando Alonso,Alex Yoong,0,0,0,Alex Yoong
58,62,18,2001,Tarso Marques,Alex Yoong,0,0,0,Alex Yoong
17,19,18,2002,Mark Webber,Anthony Davidson,2,0,2,Mark Webber
17,62,18,2002,Mark Webber,Alex Yoong,2,0,2,Mark Webber
19,62,18,2002,Anthony Davidson,Alex Yoong,0,0,0,Alex Yoong
50,51,18,2003,Jos Verstappen,Justin Wilson,0,0,0,Justin Wilson
50,53,18,2003,Jos Verstappen,Nicolas Kiesa,0,0,0,Nicolas Kiesa
51,53,18,2003,Justin Wilson,Nicolas Kiesa,0,0,0,Nicolas Kiesa
46,47,18,2004,Gianmaria Bruni,Zsolt Baumgartner,0,1,1,Zsolt Baumgartner
27,38,18,2005,Christijan Albers,Robert Doornbos,4,0,4,Christijan Albers
27,40,18,2005,Christijan Albers,Patrick Friesacher,4,3,1,Christijan Albers
38,40,18,2005,Robert Doornbos,Patrick Friesacher,0,3,3,Patrick Friesacher
293,412,180,1965,Dave Charlton,Brausch Niemann,0,0,0,Brausch Niemann
262,289,180,1967,Jackie Oliver,Graham Hill,0,9,9,Graham Hill
262,326,180,1967,Jackie Oliver,Eppie Wietzes,0,0,0,Eppie Wietzes
262,373,180,1967,Jackie Oliver,Jim Clark,0,41,41,Jim Clark
262,382,180,1967,Jackie Oliver,MoisÃ©s Solana,0,0,0,MoisÃ©s Solana
262,394,180,1967,Jackie Oliver,Giancarlo Baghetti,0,0,0,Giancarlo Baghetti
289,326,180,1967,Graham Hill,Eppie Wietzes,9,0,9,Graham Hill
289,373,180,1967,Graham Hill,Jim Clark,9,41,32,Jim Clark
289,382,180,1967,Graham Hill,MoisÃ©s Solana,9,0,9,Graham Hill
289,394,180,1967,Graham Hill,Giancarlo Baghetti,9,0,9,Graham Hill
326,373,180,1967,Eppie Wietzes,Jim Clark,0,41,41,Jim Clark
326,382,180,1967,Eppie Wietzes,MoisÃ©s Solana,0,0,0,MoisÃ©s Solana
326,394,180,1967,Eppie Wietzes,Giancarlo Baghetti,0,0,0,Giancarlo Baghetti
373,382,180,1967,Jim Clark,MoisÃ©s Solana,41,0,41,Jim Clark
373,394,180,1967,Jim Clark,Giancarlo Baghetti,41,0,41,Jim Clark
382,394,180,1967,MoisÃ©s Solana,Giancarlo Baghetti,0,0,0,Giancarlo Baghetti
207,262,180,1968,Mario Andretti,Jackie Oliver,0,6,6,Jackie Oliver
207,289,180,1968,Mario Andretti,Graham Hill,0,48,48,Graham Hill
207,343,180,1968,Mario Andretti,Bill Brack,0,0,0,Bill Brack
207,346,180,1968,Mario Andretti,Jo Siffert,0,12,12,Jo Siffert
207,373,180,1968,Mario Andretti,Jim Clark,0,9,9,Jim Clark
207,382,180,1968,Mario Andretti,MoisÃ©s Solana,0,0,0,MoisÃ©s Solana
262,289,180,1968,Jackie Oliver,Graham Hill,6,48,42,Graham Hill
262,343,180,1968,Jackie Oliver,Bill Brack,6,0,6,Jackie Oliver
262,346,180,1968,Jackie Oliver,Jo Siffert,6,12,6,Jo Siffert
262,373,180,1968,Jackie Oliver,Jim Clark,6,9,3,Jim Clark
262,382,180,1968,Jackie Oliver,MoisÃ©s Solana,6,0,6,Jackie Oliver
289,343,180,1968,Graham Hill,Bill Brack,48,0,48,Graham Hill
289,346,180,1968,Graham Hill,Jo Siffert,48,12,36,Graham Hill
289,373,180,1968,Graham Hill,Jim Clark,48,9,39,Graham Hill
289,382,180,1968,Graham Hill,MoisÃ©s Solana,48,0,48,Graham Hill
343,346,180,1968,Bill Brack,Jo Siffert,0,12,12,Jo Siffert
343,373,180,1968,Bill Brack,Jim Clark,0,9,9,Jim Clark
343,382,180,1968,Bill Brack,MoisÃ©s Solana,0,0,0,MoisÃ©s Solana
346,373,180,1968,Jo Siffert,Jim Clark,12,9,3,Jo Siffert
346,382,180,1968,Jo Siffert,MoisÃ©s Solana,12,0,12,Jo Siffert
373,382,180,1968,Jim Clark,MoisÃ©s Solana,9,0,9,Jim Clark
207,289,180,1969,Mario Andretti,Graham Hill,0,19,19,Graham Hill
207,340,180,1969,Mario Andretti,John Love,0,0,0,John Love
207,346,180,1969,Mario Andretti,Jo Siffert,0,15,15,Jo Siffert
207,347,180,1969,Mario Andretti,Jo Bonnier,0,0,0,Jo Bonnier
207,353,180,1969,Mario Andretti,Pete Lovely,0,0,0,Pete Lovely
207,357,180,1969,Mario Andretti,John Miles,0,0,0,John Miles
207,358,180,1969,Mario Andretti,Jochen Rindt,0,22,22,Jochen Rindt
207,370,180,1969,Mario Andretti,Richard Attwood,0,3,3,Richard Attwood
289,340,180,1969,Graham Hill,John Love,19,0,19,Graham Hill
289,346,180,1969,Graham Hill,Jo Siffert,19,15,4,Graham Hill
289,347,180,1969,Graham Hill,Jo Bonnier,19,0,19,Graham Hill
289,353,180,1969,Graham Hill,Pete Lovely,19,0,19,Graham Hill
289,357,180,1969,Graham Hill,John Miles,19,0,19,Graham Hill
289,358,180,1969,Graham Hill,Jochen Rindt,19,22,3,Jochen Rindt
289,370,180,1969,Graham Hill,Richard Attwood,19,3,16,Graham Hill
340,346,180,1969,John Love,Jo Siffert,0,15,15,Jo Siffert
340,347,180,1969,John Love,Jo Bonnier,0,0,0,Jo Bonnier
340,353,180,1969,John Love,Pete Lovely,0,0,0,Pete Lovely
340,357,180,1969,John Love,John Miles,0,0,0,John Miles
340,358,180,1969,John Love,Jochen Rindt,0,22,22,Jochen Rindt
340,370,180,1969,John Love,Richard Attwood,0,3,3,Richard Attwood
346,347,180,1969,Jo Siffert,Jo Bonnier,15,0,15,Jo Siffert
346,353,180,1969,Jo Siffert,Pete Lovely,15,0,15,Jo Siffert
346,357,180,1969,Jo Siffert,John Miles,15,0,15,Jo Siffert
346,358,180,1969,Jo Siffert,Jochen Rindt,15,22,7,Jochen Rindt
346,370,180,1969,Jo Siffert,Richard Attwood,15,3,12,Jo Siffert
347,353,180,1969,Jo Bonnier,Pete Lovely,0,0,0,Pete Lovely
347,357,180,1969,Jo Bonnier,John Miles,0,0,0,John Miles
347,358,180,1969,Jo Bonnier,Jochen Rindt,0,22,22,Jochen Rindt
347,370,180,1969,Jo Bonnier,Richard Attwood,0,3,3,Richard Attwood
353,357,180,1969,Pete Lovely,John Miles,0,0,0,John Miles
353,358,180,1969,Pete Lovely,Jochen Rindt,0,22,22,Jochen Rindt
353,370,180,1969,Pete Lovely,Richard Attwood,0,3,3,Richard Attwood
357,358,180,1969,John Miles,Jochen Rindt,0,22,22,Jochen Rindt
357,370,180,1969,John Miles,Richard Attwood,0,3,3,Richard Attwood
358,370,180,1969,Jochen Rindt,Richard Attwood,22,3,19,Jochen Rindt
224,293,180,1971,Emerson Fittipaldi,Dave Charlton,16,0,16,Emerson Fittipaldi
224,317,180,1971,Emerson Fittipaldi,Reine Wisell,16,9,7,Emerson Fittipaldi
224,353,180,1971,Emerson Fittipaldi,Pete Lovely,16,0,16,Emerson Fittipaldi
293,317,180,1971,Dave Charlton,Reine Wisell,0,9,9,Reine Wisell
293,353,180,1971,Dave Charlton,Pete Lovely,0,0,0,Pete Lovely
317,353,180,1971,Reine Wisell,Pete Lovely,9,0,9,Reine Wisell
346,347,181,1964,Jo Siffert,Jo Bonnier,7,0,7,Jo Siffert
346,358,181,1964,Jo Siffert,Jochen Rindt,7,0,7,Jo Siffert
346,402,181,1964,Jo Siffert,Giacomo Russo,7,0,7,Jo Siffert
346,420,181,1964,Jo Siffert,Ian Raby,7,0,7,Jo Siffert
346,434,181,1964,Jo Siffert,Hap Sharp,7,0,7,Jo Siffert
347,358,181,1964,Jo Bonnier,Jochen Rindt,0,0,0,Jochen Rindt
347,402,181,1964,Jo Bonnier,Giacomo Russo,0,0,0,Giacomo Russo
347,420,181,1964,Jo Bonnier,Ian Raby,0,0,0,Ian Raby
347,434,181,1964,Jo Bonnier,Hap Sharp,0,0,0,Hap Sharp
358,402,181,1964,Jochen Rindt,Giacomo Russo,0,0,0,Giacomo Russo
358,420,181,1964,Jochen Rindt,Ian Raby,0,0,0,Ian Raby
358,434,181,1964,Jochen Rindt,Hap Sharp,0,0,0,Hap Sharp
402,420,181,1964,Giacomo Russo,Ian Raby,0,0,0,Ian Raby
402,434,181,1964,Giacomo Russo,Hap Sharp,0,0,0,Hap Sharp
420,434,181,1964,Ian Raby,Hap Sharp,0,0,0,Hap Sharp
346,380,181,1965,Jo Siffert,Frank Gardner,5,0,5,Jo Siffert
346,420,181,1965,Jo Siffert,Ian Raby,5,0,5,Jo Siffert
380,420,181,1965,Frank Gardner,Ian Raby,0,0,0,Ian Raby
278,346,181,1966,Chris Amon,Jo Siffert,0,0,0,Jo Siffert
278,399,181,1966,Chris Amon,John Taylor,0,1,1,John Taylor
346,399,181,1966,Jo Siffert,John Taylor,0,1,1,John Taylor
406,407,182,1965,Paul Hawkins,David Prophet,0,0,0,David Prophet
235,351,182,1969,Jacky Ickx,Silvio Moser,37,1,36,Jacky Ickx
235,356,182,1969,Jacky Ickx,Jack Brabham,37,14,23,Jacky Ickx
235,361,182,1969,Jacky Ickx,Piers Courage,37,16,21,Jacky Ickx
351,356,182,1969,Silvio Moser,Jack Brabham,1,14,13,Jack Brabham
351,361,182,1969,Silvio Moser,Piers Courage,1,16,15,Piers Courage
356,361,182,1969,Jack Brabham,Piers Courage,14,16,2,Piers Courage
208,258,182,1976,Emilio de Villota,Patrick NÃ¨ve,0,0,0,Patrick NÃ¨ve
208,271,182,1976,Emilio de Villota,Loris Kessel,0,0,0,Loris Kessel
208,275,182,1976,Emilio de Villota,Lella Lombardi,0,0,0,Lella Lombardi
208,276,182,1976,Emilio de Villota,Bob Evans,0,0,0,Bob Evans
208,281,182,1976,Emilio de Villota,Jac Nelleman,0,0,0,Jac Nelleman
208,282,182,1976,Emilio de Villota,Damien Magee,0,0,0,Damien Magee
258,271,182,1976,Patrick NÃ¨ve,Loris Kessel,0,0,0,Loris Kessel
258,275,182,1976,Patrick NÃ¨ve,Lella Lombardi,0,0,0,Lella Lombardi
258,276,182,1976,Patrick NÃ¨ve,Bob Evans,0,0,0,Bob Evans
258,281,182,1976,Patrick NÃ¨ve,Jac Nelleman,0,0,0,Jac Nelleman
258,282,182,1976,Patrick NÃ¨ve,Damien Magee,0,0,0,Damien Magee
271,275,182,1976,Loris Kessel,Lella Lombardi,0,0,0,Lella Lombardi
271,276,182,1976,Loris Kessel,Bob Evans,0,0,0,Bob Evans
271,281,182,1976,Loris Kessel,Jac Nelleman,0,0,0,Jac Nelleman
271,282,182,1976,Loris Kessel,Damien Magee,0,0,0,Damien Magee
275,276,182,1976,Lella Lombardi,Bob Evans,0,0,0,Bob Evans
275,281,182,1976,Lella Lombardi,Jac Nelleman,0,0,0,Jac Nelleman
275,282,182,1976,Lella Lombardi,Damien Magee,0,0,0,Damien Magee
276,281,182,1976,Bob Evans,Jac Nelleman,0,0,0,Jac Nelleman
276,282,182,1976,Bob Evans,Damien Magee,0,0,0,Damien Magee
281,282,182,1976,Jac Nelleman,Damien Magee,0,0,0,Damien Magee
137,182,182,1979,Nelson Piquet,Niki Lauda,0,0,0,Niki Lauda
137,217,182,1979,Nelson Piquet,Ricardo Zunino,0,0,0,Ricardo Zunino
182,217,182,1979,Niki Lauda,Ricardo Zunino,0,0,0,Ricardo Zunino
346,347,183,1964,Jo Siffert,Jo Bonnier,0,1,1,Jo Bonnier
346,356,183,1964,Jo Siffert,Jack Brabham,0,11,11,Jack Brabham
346,364,183,1964,Jo Siffert,Dan Gurney,0,19,19,Dan Gurney
346,383,183,1964,Jo Siffert,Bob Anderson,0,5,5,Bob Anderson
347,356,183,1964,Jo Bonnier,Jack Brabham,1,11,10,Jack Brabham
347,364,183,1964,Jo Bonnier,Dan Gurney,1,19,18,Dan Gurney
347,383,183,1964,Jo Bonnier,Bob Anderson,1,5,4,Bob Anderson
356,364,183,1964,Jack Brabham,Dan Gurney,11,19,8,Dan Gurney
356,383,183,1964,Jack Brabham,Bob Anderson,11,5,6,Jack Brabham
364,383,183,1964,Dan Gurney,Bob Anderson,19,5,14,Dan Gurney
304,347,183,1965,Denny Hulme,Jo Bonnier,5,0,5,Denny Hulme
304,356,183,1965,Denny Hulme,Jack Brabham,5,9,4,Jack Brabham
304,364,183,1965,Denny Hulme,Dan Gurney,5,25,20,Dan Gurney
304,383,183,1965,Denny Hulme,Bob Anderson,5,0,5,Denny Hulme
304,394,183,1965,Denny Hulme,Giancarlo Baghetti,5,0,5,Denny Hulme
304,420,183,1965,Denny Hulme,Ian Raby,5,0,5,Denny Hulme
347,356,183,1965,Jo Bonnier,Jack Brabham,0,9,9,Jack Brabham
347,364,183,1965,Jo Bonnier,Dan Gurney,0,25,25,Dan Gurney
347,383,183,1965,Jo Bonnier,Bob Anderson,0,0,0,Bob Anderson
347,394,183,1965,Jo Bonnier,Giancarlo Baghetti,0,0,0,Giancarlo Baghetti
347,420,183,1965,Jo Bonnier,Ian Raby,0,0,0,Ian Raby
356,364,183,1965,Jack Brabham,Dan Gurney,9,25,16,Dan Gurney
356,383,183,1965,Jack Brabham,Bob Anderson,9,0,9,Jack Brabham
356,394,183,1965,Jack Brabham,Giancarlo Baghetti,9,0,9,Jack Brabham
356,420,183,1965,Jack Brabham,Ian Raby,9,0,9,Jack Brabham
364,383,183,1965,Dan Gurney,Bob Anderson,25,0,25,Dan Gurney
364,394,183,1965,Dan Gurney,Giancarlo Baghetti,25,0,25,Dan Gurney
364,420,183,1965,Dan Gurney,Ian Raby,25,0,25,Dan Gurney
383,394,183,1965,Bob Anderson,Giancarlo Baghetti,0,0,0,Giancarlo Baghetti
383,420,183,1965,Bob Anderson,Ian Raby,0,0,0,Ian Raby
394,420,183,1965,Giancarlo Baghetti,Ian Raby,0,0,0,Ian Raby
304,347,183,1966,Denny Hulme,Jo Bonnier,0,0,0,Jo Bonnier
304,383,183,1966,Denny Hulme,Bob Anderson,0,1,1,Bob Anderson
304,388,183,1966,Denny Hulme,Chris Irwin,0,0,0,Chris Irwin
347,383,183,1966,Jo Bonnier,Bob Anderson,0,1,1,Bob Anderson
347,388,183,1966,Jo Bonnier,Chris Irwin,0,0,0,Chris Irwin
383,388,183,1966,Bob Anderson,Chris Irwin,1,0,1,Bob Anderson
293,383,183,1967,Dave Charlton,Bob Anderson,0,2,2,Bob Anderson
293,384,183,1967,Dave Charlton,Luki Botha,0,0,0,Luki Botha
383,384,183,1967,Bob Anderson,Luki Botha,2,0,2,Bob Anderson
334,368,185,1965,Jackie Pretorius,Sam Tingle,0,0,0,Sam Tingle
409,421,186,1965,Trevor Blokdyk,Alan Rollinson,0,0,0,Alan Rollinson
304,360,187,1968,Denny Hulme,Bruce McLaren,31,22,9,Denny Hulme
304,364,187,1968,Denny Hulme,Dan Gurney,31,3,28,Denny Hulme
360,364,187,1968,Bruce McLaren,Dan Gurney,22,3,19,Bruce McLaren
304,306,187,1969,Denny Hulme,Jean-Pierre Beltoise,20,0,20,Denny Hulme
304,321,187,1969,Denny Hulme,Derek Bell,20,0,20,Denny Hulme
304,350,187,1969,Denny Hulme,Vic Elford,20,3,17,Denny Hulme
304,360,187,1969,Denny Hulme,Bruce McLaren,20,26,6,Bruce McLaren
304,369,187,1969,Denny Hulme,Basil van Rooyen,20,0,20,Denny Hulme
306,321,187,1969,Jean-Pierre Beltoise,Derek Bell,0,0,0,Derek Bell
306,350,187,1969,Jean-Pierre Beltoise,Vic Elford,0,3,3,Vic Elford
306,360,187,1969,Jean-Pierre Beltoise,Bruce McLaren,0,26,26,Bruce McLaren
306,369,187,1969,Jean-Pierre Beltoise,Basil van Rooyen,0,0,0,Basil van Rooyen
321,350,187,1969,Derek Bell,Vic Elford,0,3,3,Vic Elford
321,360,187,1969,Derek Bell,Bruce McLaren,0,26,26,Bruce McLaren
321,369,187,1969,Derek Bell,Basil van Rooyen,0,0,0,Basil van Rooyen
350,360,187,1969,Vic Elford,Bruce McLaren,3,26,23,Bruce McLaren
350,369,187,1969,Vic Elford,Basil van Rooyen,3,0,3,Vic Elford
360,369,187,1969,Bruce McLaren,Basil van Rooyen,26,0,26,Bruce McLaren
304,320,187,1970,Denny Hulme,Peter Gethin,27,1,26,Denny Hulme
304,341,187,1970,Denny Hulme,John Surtees,27,1,26,Denny Hulme
304,347,187,1970,Denny Hulme,Jo Bonnier,27,0,27,Denny Hulme
304,360,187,1970,Denny Hulme,Bruce McLaren,27,6,21,Denny Hulme
304,364,187,1970,Denny Hulme,Dan Gurney,27,1,26,Denny Hulme
320,341,187,1970,Peter Gethin,John Surtees,1,1,0,John Surtees
320,347,187,1970,Peter Gethin,Jo Bonnier,1,0,1,Peter Gethin
320,360,187,1970,Peter Gethin,Bruce McLaren,1,6,5,Bruce McLaren
320,364,187,1970,Peter Gethin,Dan Gurney,1,1,0,Dan Gurney
341,347,187,1970,John Surtees,Jo Bonnier,1,0,1,John Surtees
341,360,187,1970,John Surtees,Bruce McLaren,1,6,5,Bruce McLaren
341,364,187,1970,John Surtees,Dan Gurney,1,1,0,Dan Gurney
347,360,187,1970,Jo Bonnier,Bruce McLaren,0,6,6,Bruce McLaren
347,364,187,1970,Jo Bonnier,Dan Gurney,0,1,1,Dan Gurney
360,364,187,1970,Bruce McLaren,Dan Gurney,6,1,5,Bruce McLaren
364,396,189,1966,Dan Gurney,Bob Bondurant,4,0,4,Dan Gurney
364,403,189,1966,Dan Gurney,Phil Hill,4,0,4,Dan Gurney
396,403,189,1966,Bob Bondurant,Phil Hill,0,0,0,Phil Hill
364,371,189,1967,Dan Gurney,Al Pease,0,0,0,Al Pease
364,386,189,1967,Dan Gurney,Richie Ginther,0,0,0,Richie Ginther
371,386,189,1967,Al Pease,Richie Ginther,0,0,0,Richie Ginther
54,56,19,2000,Luciano Burti,Eddie Irvine,0,4,4,Eddie Irvine
54,65,19,2000,Luciano Burti,Johnny Herbert,0,0,0,Johnny Herbert
56,65,19,2000,Eddie Irvine,Johnny Herbert,4,0,4,Eddie Irvine
37,54,19,2001,Pedro de la Rosa,Luciano Burti,3,0,3,Pedro de la Rosa
37,56,19,2001,Pedro de la Rosa,Eddie Irvine,3,6,3,Eddie Irvine
54,56,19,2001,Luciano Burti,Eddie Irvine,0,6,6,Eddie Irvine
37,56,19,2002,Pedro de la Rosa,Eddie Irvine,0,8,8,Eddie Irvine
17,42,19,2003,Mark Webber,AntÃ´nio Pizzonia,17,0,17,Mark Webber
17,51,19,2003,Mark Webber,Justin Wilson,17,1,16,Mark Webber
42,51,19,2003,AntÃ´nio Pizzonia,Justin Wilson,0,1,1,Justin Wilson
17,32,19,2004,Mark Webber,Christian Klien,7,3,4,Mark Webber
364,396,190,1966,Dan Gurney,Bob Bondurant,0,0,0,Bob Bondurant
360,364,190,1967,Bruce McLaren,Dan Gurney,0,13,13,Dan Gurney
360,375,190,1967,Bruce McLaren,Ludovico Scarfiotti,0,0,0,Ludovico Scarfiotti
364,375,190,1967,Dan Gurney,Ludovico Scarfiotti,13,0,13,Dan Gurney
304,356,191,1966,Denny Hulme,Jack Brabham,18,45,27,Jack Brabham
304,356,191,1967,Denny Hulme,Jack Brabham,51,48,3,Denny Hulme
304,389,191,1967,Denny Hulme,Guy Ligier,51,1,50,Denny Hulme
356,389,191,1967,Jack Brabham,Guy Ligier,48,1,47,Jack Brabham
293,340,191,1968,Dave Charlton,John Love,0,0,0,John Love
293,351,191,1968,Dave Charlton,Silvio Moser,0,2,2,Silvio Moser
293,356,191,1968,Dave Charlton,Jack Brabham,0,2,2,Jack Brabham
293,358,191,1968,Dave Charlton,Jochen Rindt,0,8,8,Jochen Rindt
293,364,191,1968,Dave Charlton,Dan Gurney,0,0,0,Dan Gurney
293,379,191,1968,Dave Charlton,Kurt Ahrens,0,0,0,Kurt Ahrens
340,351,191,1968,John Love,Silvio Moser,0,2,2,Silvio Moser
340,356,191,1968,John Love,Jack Brabham,0,2,2,Jack Brabham
340,358,191,1968,John Love,Jochen Rindt,0,8,8,Jochen Rindt
340,364,191,1968,John Love,Dan Gurney,0,0,0,Dan Gurney
340,379,191,1968,John Love,Kurt Ahrens,0,0,0,Kurt Ahrens
351,356,191,1968,Silvio Moser,Jack Brabham,2,2,0,Jack Brabham
351,358,191,1968,Silvio Moser,Jochen Rindt,2,8,6,Jochen Rindt
351,364,191,1968,Silvio Moser,Dan Gurney,2,0,2,Silvio Moser
351,379,191,1968,Silvio Moser,Kurt Ahrens,2,0,2,Silvio Moser
356,358,191,1968,Jack Brabham,Jochen Rindt,2,8,6,Jochen Rindt
356,364,191,1968,Jack Brabham,Dan Gurney,2,0,2,Jack Brabham
356,379,191,1968,Jack Brabham,Kurt Ahrens,2,0,2,Jack Brabham
358,364,191,1968,Jochen Rindt,Dan Gurney,8,0,8,Jochen Rindt
358,379,191,1968,Jochen Rindt,Kurt Ahrens,8,0,8,Jochen Rindt
364,379,191,1968,Dan Gurney,Kurt Ahrens,0,0,0,Kurt Ahrens
362,368,191,1969,Peter de Klerk,Sam Tingle,0,0,0,Sam Tingle
304,347,194,1968,Denny Hulme,Jo Bonnier,2,1,1,Denny Hulme
312,350,195,1968,Brian Redman,Vic Elford,4,5,1,Vic Elford
312,359,195,1968,Brian Redman,Johnny Servoz-Gavin,4,0,4,Brian Redman
312,375,195,1968,Brian Redman,Ludovico Scarfiotti,4,6,2,Ludovico Scarfiotti
312,376,195,1968,Brian Redman,Lucien Bianchi,4,5,1,Lucien Bianchi
312,378,195,1968,Brian Redman,Robin Widdows,4,0,4,Brian Redman
350,359,195,1968,Vic Elford,Johnny Servoz-Gavin,5,0,5,Vic Elford
350,375,195,1968,Vic Elford,Ludovico Scarfiotti,5,6,1,Ludovico Scarfiotti
350,376,195,1968,Vic Elford,Lucien Bianchi,5,5,0,Lucien Bianchi
350,378,195,1968,Vic Elford,Robin Widdows,5,0,5,Vic Elford
359,375,195,1968,Johnny Servoz-Gavin,Ludovico Scarfiotti,0,6,6,Ludovico Scarfiotti
359,376,195,1968,Johnny Servoz-Gavin,Lucien Bianchi,0,5,5,Lucien Bianchi
359,378,195,1968,Johnny Servoz-Gavin,Robin Widdows,0,0,0,Robin Widdows
375,376,195,1968,Ludovico Scarfiotti,Lucien Bianchi,6,5,1,Ludovico Scarfiotti
375,378,195,1968,Ludovico Scarfiotti,Robin Widdows,6,0,6,Ludovico Scarfiotti
376,378,195,1968,Lucien Bianchi,Robin Widdows,5,0,5,Lucien Bianchi
306,328,196,1968,Jean-Pierre Beltoise,Jackie Stewart,3,36,33,Jackie Stewart
306,359,196,1968,Jean-Pierre Beltoise,Johnny Servoz-Gavin,3,6,3,Johnny Servoz-Gavin
328,359,196,1968,Jackie Stewart,Johnny Servoz-Gavin,36,6,30,Jackie Stewart
306,328,196,1969,Jean-Pierre Beltoise,Jackie Stewart,21,63,42,Jackie Stewart
306,359,196,1969,Jean-Pierre Beltoise,Johnny Servoz-Gavin,21,1,20,Jean-Pierre Beltoise
328,359,196,1969,Jackie Stewart,Johnny Servoz-Gavin,63,1,62,Jackie Stewart
330,333,198,1970,Nanni Galli,Andrea de Adamich,0,0,0,Andrea de Adamich
238,330,199,1971,Ronnie Peterson,Nanni Galli,0,0,0,Nanni Galli
238,333,199,1971,Ronnie Peterson,Andrea de Adamich,0,0,0,Andrea de Adamich
330,333,199,1971,Nanni Galli,Andrea de Adamich,0,0,0,Andrea de Adamich
2,35,2,2006,Nick Heidfeld,Jacques Villeneuve,23,7,16,Nick Heidfeld
2,9,2,2006,Nick Heidfeld,Robert Kubica,23,6,17,Nick Heidfeld
35,9,2,2006,Jacques Villeneuve,Robert Kubica,7,6,1,Jacques Villeneuve
2,20,2,2007,Nick Heidfeld,Sebastian Vettel,61,1,60,Nick Heidfeld
2,9,2,2007,Nick Heidfeld,Robert Kubica,61,39,22,Nick Heidfeld
20,9,2,2007,Sebastian Vettel,Robert Kubica,1,39,38,Robert Kubica
2,9,2,2008,Nick Heidfeld,Robert Kubica,60,75,15,Robert Kubica
2,9,2,2009,Nick Heidfeld,Robert Kubica,19,17,2,Nick Heidfeld
15,44,20,1997,Jarno Trulli,Olivier Panis,3,16,13,Olivier Panis
15,75,20,1997,Jarno Trulli,Shinji Nakano,3,2,1,Jarno Trulli
44,75,20,1997,Olivier Panis,Shinji Nakano,16,2,14,Olivier Panis
15,44,20,1998,Jarno Trulli,Olivier Panis,1,0,1,Jarno Trulli
15,44,20,1999,Jarno Trulli,Olivier Panis,7,2,5,Jarno Trulli
2,55,20,2000,Nick Heidfeld,Jean Alesi,0,0,0,Jean Alesi
49,54,20,2001,Heinz-Harald Frentzen,Luciano Burti,0,0,0,Luciano Burti
49,55,20,2001,Heinz-Harald Frentzen,Jean Alesi,0,4,4,Jean Alesi
49,60,20,2001,Heinz-Harald Frentzen,GastÃ³n Mazzacane,0,0,0,GastÃ³n Mazzacane
49,61,20,2001,Heinz-Harald Frentzen,TomÃ¡Å¡ Enge,0,0,0,TomÃ¡Å¡ Enge
54,55,20,2001,Luciano Burti,Jean Alesi,0,4,4,Jean Alesi
54,60,20,2001,Luciano Burti,GastÃ³n Mazzacane,0,0,0,GastÃ³n Mazzacane
54,61,20,2001,Luciano Burti,TomÃ¡Å¡ Enge,0,0,0,TomÃ¡Å¡ Enge
55,60,20,2001,Jean Alesi,GastÃ³n Mazzacane,4,0,4,Jean Alesi
55,61,20,2001,Jean Alesi,TomÃ¡Å¡ Enge,4,0,4,Jean Alesi
60,61,20,2001,GastÃ³n Mazzacane,TomÃ¡Å¡ Enge,0,0,0,TomÃ¡Å¡ Enge
182,197,200,1971,Niki Lauda,Jean-Pierre Jarier,0,0,0,Jean-Pierre Jarier
182,238,200,1971,Niki Lauda,Ronnie Peterson,0,33,33,Ronnie Peterson
182,280,200,1971,Niki Lauda,Henri Pescarolo,0,4,4,Henri Pescarolo
182,329,200,1971,Niki Lauda,Mike Beuttler,0,0,0,Mike Beuttler
182,330,200,1971,Niki Lauda,Nanni Galli,0,0,0,Nanni Galli
182,339,200,1971,Niki Lauda,Alex Soler-Roig,0,0,0,Alex Soler-Roig
182,340,200,1971,Niki Lauda,John Love,0,0,0,John Love
182,342,200,1971,Niki Lauda,Skip Barber,0,0,0,Skip Barber
182,348,200,1971,Niki Lauda,FranÃ§ois Mazet,0,0,0,FranÃ§ois Mazet
182,349,200,1971,Niki Lauda,Max Jean,0,0,0,Max Jean
197,238,200,1971,Jean-Pierre Jarier,Ronnie Peterson,0,33,33,Ronnie Peterson
197,280,200,1971,Jean-Pierre Jarier,Henri Pescarolo,0,4,4,Henri Pescarolo
197,329,200,1971,Jean-Pierre Jarier,Mike Beuttler,0,0,0,Mike Beuttler
197,330,200,1971,Jean-Pierre Jarier,Nanni Galli,0,0,0,Nanni Galli
197,339,200,1971,Jean-Pierre Jarier,Alex Soler-Roig,0,0,0,Alex Soler-Roig
197,340,200,1971,Jean-Pierre Jarier,John Love,0,0,0,John Love
197,342,200,1971,Jean-Pierre Jarier,Skip Barber,0,0,0,Skip Barber
197,348,200,1971,Jean-Pierre Jarier,FranÃ§ois Mazet,0,0,0,FranÃ§ois Mazet
197,349,200,1971,Jean-Pierre Jarier,Max Jean,0,0,0,Max Jean
238,280,200,1971,Ronnie Peterson,Henri Pescarolo,33,4,29,Ronnie Peterson
238,329,200,1971,Ronnie Peterson,Mike Beuttler,33,0,33,Ronnie Peterson
238,330,200,1971,Ronnie Peterson,Nanni Galli,33,0,33,Ronnie Peterson
238,339,200,1971,Ronnie Peterson,Alex Soler-Roig,33,0,33,Ronnie Peterson
238,340,200,1971,Ronnie Peterson,John Love,33,0,33,Ronnie Peterson
238,342,200,1971,Ronnie Peterson,Skip Barber,33,0,33,Ronnie Peterson
238,348,200,1971,Ronnie Peterson,FranÃ§ois Mazet,33,0,33,Ronnie Peterson
238,349,200,1971,Ronnie Peterson,Max Jean,33,0,33,Ronnie Peterson
280,329,200,1971,Henri Pescarolo,Mike Beuttler,4,0,4,Henri Pescarolo
280,330,200,1971,Henri Pescarolo,Nanni Galli,4,0,4,Henri Pescarolo
280,339,200,1971,Henri Pescarolo,Alex Soler-Roig,4,0,4,Henri Pescarolo
280,340,200,1971,Henri Pescarolo,John Love,4,0,4,Henri Pescarolo
280,342,200,1971,Henri Pescarolo,Skip Barber,4,0,4,Henri Pescarolo
280,348,200,1971,Henri Pescarolo,FranÃ§ois Mazet,4,0,4,Henri Pescarolo
280,349,200,1971,Henri Pescarolo,Max Jean,4,0,4,Henri Pescarolo
329,330,200,1971,Mike Beuttler,Nanni Galli,0,0,0,Nanni Galli
329,339,200,1971,Mike Beuttler,Alex Soler-Roig,0,0,0,Alex Soler-Roig
329,340,200,1971,Mike Beuttler,John Love,0,0,0,John Love
329,342,200,1971,Mike Beuttler,Skip Barber,0,0,0,Skip Barber
329,348,200,1971,Mike Beuttler,FranÃ§ois Mazet,0,0,0,FranÃ§ois Mazet
329,349,200,1971,Mike Beuttler,Max Jean,0,0,0,Max Jean
330,339,200,1971,Nanni Galli,Alex Soler-Roig,0,0,0,Alex Soler-Roig
330,340,200,1971,Nanni Galli,John Love,0,0,0,John Love
330,342,200,1971,Nanni Galli,Skip Barber,0,0,0,Skip Barber
330,348,200,1971,Nanni Galli,FranÃ§ois Mazet,0,0,0,FranÃ§ois Mazet
330,349,200,1971,Nanni Galli,Max Jean,0,0,0,Max Jean
339,340,200,1971,Alex Soler-Roig,John Love,0,0,0,John Love
339,342,200,1971,Alex Soler-Roig,Skip Barber,0,0,0,Skip Barber
339,348,200,1971,Alex Soler-Roig,FranÃ§ois Mazet,0,0,0,FranÃ§ois Mazet
339,349,200,1971,Alex Soler-Roig,Max Jean,0,0,0,Max Jean
340,342,200,1971,John Love,Skip Barber,0,0,0,Skip Barber
340,348,200,1971,John Love,FranÃ§ois Mazet,0,0,0,FranÃ§ois Mazet
340,349,200,1971,John Love,Max Jean,0,0,0,Max Jean
342,348,200,1971,Skip Barber,FranÃ§ois Mazet,0,0,0,FranÃ§ois Mazet
342,349,200,1971,Skip Barber,Max Jean,0,0,0,Max Jean
348,349,200,1971,FranÃ§ois Mazet,Max Jean,0,0,0,Max Jean
224,317,201,1971,Emerson Fittipaldi,Reine Wisell,0,0,0,Reine Wisell
224,338,201,1971,Emerson Fittipaldi,David Walker,0,0,0,David Walker
317,338,201,1971,Reine Wisell,David Walker,0,0,0,David Walker
197,252,202,1975,Jean-Pierre Jarier,Tom Pryce,2,8,6,Tom Pryce
199,243,204,1976,Carlos Reutemann,Rolf Stommelen,3,1,2,Carlos Reutemann
199,250,204,1976,Carlos Reutemann,Carlos Pace,3,7,4,Carlos Pace
199,256,204,1976,Carlos Reutemann,Larry Perkins,3,0,3,Carlos Reutemann
243,250,204,1976,Rolf Stommelen,Carlos Pace,1,7,6,Carlos Pace
243,256,204,1976,Rolf Stommelen,Larry Perkins,1,0,1,Rolf Stommelen
250,256,204,1976,Carlos Pace,Larry Perkins,7,0,7,Carlos Pace
137,182,204,1979,Nelson Piquet,Niki Lauda,3,4,1,Niki Lauda
15,5,205,2010,Jarno Trulli,Heikki Kovalainen,0,0,0,Heikki Kovalainen
15,5,205,2011,Jarno Trulli,Heikki Kovalainen,0,0,0,Heikki Kovalainen
15,812,205,2011,Jarno Trulli,Karun Chandhok,0,0,0,Karun Chandhok
5,812,205,2011,Heikki Kovalainen,Karun Chandhok,0,0,0,Karun Chandhok
10,819,206,2012,Timo Glock,Charles Pic,0,0,0,Charles Pic
820,824,206,2013,Max Chilton,Jules Bianchi,0,0,0,Jules Bianchi
820,824,206,2014,Max Chilton,Jules Bianchi,0,2,2,Jules Bianchi
5,808,207,2012,Heikki Kovalainen,Vitaly Petrov,0,0,0,Vitaly Petrov
819,823,207,2013,Charles Pic,Giedo van der Garde,0,0,0,Giedo van der Garde
155,827,207,2014,Kamui Kobayashi,AndrÃ© Lotterer,0,0,0,AndrÃ© Lotterer
155,828,207,2014,Kamui Kobayashi,Marcus Ericsson,0,0,0,Marcus Ericsson
155,829,207,2014,Kamui Kobayashi,Will Stevens,0,0,0,Will Stevens
827,828,207,2014,AndrÃ© Lotterer,Marcus Ericsson,0,0,0,Marcus Ericsson
827,829,207,2014,AndrÃ© Lotterer,Will Stevens,0,0,0,Will Stevens
828,829,207,2014,Marcus Ericsson,Will Stevens,0,0,0,Will Stevens
154,8,208,2012,Romain Grosjean,Kimi RÃ¤ikkÃ¶nen,96,207,111,Kimi RÃ¤ikkÃ¶nen
154,816,208,2012,Romain Grosjean,JÃ©rÃ´me d'Ambrosio,96,0,96,Romain Grosjean
8,816,208,2012,Kimi RÃ¤ikkÃ¶nen,JÃ©rÃ´me d'Ambrosio,207,0,207,Kimi RÃ¤ikkÃ¶nen
154,5,208,2013,Romain Grosjean,Heikki Kovalainen,132,0,132,Romain Grosjean
154,8,208,2013,Romain Grosjean,Kimi RÃ¤ikkÃ¶nen,132,183,51,Kimi RÃ¤ikkÃ¶nen
5,8,208,2013,Heikki Kovalainen,Kimi RÃ¤ikkÃ¶nen,0,183,183,Kimi RÃ¤ikkÃ¶nen
154,813,208,2014,Romain Grosjean,Pastor Maldonado,8,2,6,Romain Grosjean
154,813,208,2015,Romain Grosjean,Pastor Maldonado,51,27,24,Romain Grosjean
829,833,209,2015,Will Stevens,Roberto Merhi,0,0,0,Roberto Merhi
829,834,209,2015,Will Stevens,Alexander Rossi,0,0,0,Alexander Rossi
833,834,209,2015,Roberto Merhi,Alexander Rossi,0,0,0,Alexander Rossi
836,837,209,2016,Pascal Wehrlein,Rio Haryanto,1,0,1,Pascal Wehrlein
836,839,209,2016,Pascal Wehrlein,Esteban Ocon,1,0,1,Pascal Wehrlein
837,839,209,2016,Rio Haryanto,Esteban Ocon,0,0,0,Esteban Ocon
119,243,21,1978,Riccardo Patrese,Rolf Stommelen,11,0,11,Riccardo Patrese
119,200,21,1979,Riccardo Patrese,Jochen Mass,2,3,1,Jochen Mass
119,181,21,1980,Riccardo Patrese,Manfred Winkelhock,7,0,7,Riccardo Patrese
119,191,21,1980,Riccardo Patrese,Mike Thackwell,7,0,7,Riccardo Patrese
119,200,21,1980,Riccardo Patrese,Jochen Mass,7,4,3,Riccardo Patrese
181,191,21,1980,Manfred Winkelhock,Mike Thackwell,0,0,0,Mike Thackwell
181,200,21,1980,Manfred Winkelhock,Jochen Mass,0,4,4,Jochen Mass
191,200,21,1980,Mike Thackwell,Jochen Mass,0,4,4,Jochen Mass
119,198,21,1981,Riccardo Patrese,Jacques Villeneuve Sr.,10,0,10,Riccardo Patrese
119,216,21,1981,Riccardo Patrese,Siegfried Stohr,10,0,10,Riccardo Patrese
198,216,21,1981,Jacques Villeneuve Sr.,Siegfried Stohr,0,0,0,Siegfried Stohr
176,184,21,1982,Marc Surer,Mauro Baldi,3,2,1,Marc Surer
176,205,21,1982,Marc Surer,Brian Henton,3,0,3,Marc Surer
184,205,21,1982,Mauro Baldi,Brian Henton,2,0,2,Mauro Baldi
123,176,21,1983,Thierry Boutsen,Marc Surer,0,4,4,Marc Surer
123,178,21,1983,Thierry Boutsen,Alan Jones,0,0,0,Alan Jones
123,192,21,1983,Thierry Boutsen,Chico Serra,0,0,0,Chico Serra
176,178,21,1983,Marc Surer,Alan Jones,4,0,4,Marc Surer
176,192,21,1983,Marc Surer,Chico Serra,4,0,4,Marc Surer
178,192,21,1983,Alan Jones,Chico Serra,0,0,0,Chico Serra
123,176,21,1984,Thierry Boutsen,Marc Surer,5,1,4,Thierry Boutsen
123,77,21,1985,Thierry Boutsen,Gerhard Berger,11,3,8,Thierry Boutsen
123,157,21,1986,Thierry Boutsen,Christian Danner,0,1,1,Christian Danner
123,176,21,1986,Thierry Boutsen,Marc Surer,0,0,0,Marc Surer
157,176,21,1986,Christian Danner,Marc Surer,1,0,1,Christian Danner
118,158,21,1987,Derek Warwick,Eddie Cheever,3,8,5,Eddie Cheever
118,158,21,1988,Derek Warwick,Eddie Cheever,17,6,11,Derek Warwick
118,151,21,1989,Derek Warwick,Martin Donnelly,7,0,7,Derek Warwick
118,158,21,1989,Derek Warwick,Eddie Cheever,7,6,1,Derek Warwick
151,158,21,1989,Martin Donnelly,Eddie Cheever,0,6,6,Eddie Cheever
105,133,21,1990,Michele Alboreto,Alex Caffi,0,2,2,Alex Caffi
105,146,21,1990,Michele Alboreto,Bernd Schneider,0,0,0,Bernd Schneider
133,146,21,1990,Alex Caffi,Bernd Schneider,2,0,2,Alex Caffi
64,71,21,1997,Pedro Diniz,Damon Hill,2,7,5,Damon Hill
63,64,21,1998,Mika Salo,Pedro Diniz,3,3,0,Pedro Diniz
37,68,21,1999,Pedro de la Rosa,Toranosuke Takagi,1,0,1,Pedro de la Rosa
37,50,21,2000,Pedro de la Rosa,Jos Verstappen,2,5,3,Jos Verstappen
50,59,21,2001,Jos Verstappen,Enrique Bernoldi,1,0,1,Jos Verstappen
49,59,21,2002,Heinz-Harald Frentzen,Enrique Bernoldi,2,0,2,Heinz-Harald Frentzen
154,821,210,2016,Romain Grosjean,Esteban GutiÃ©rrez,29,0,29,Romain Grosjean
154,825,210,2017,Romain Grosjean,Kevin Magnussen,28,19,9,Romain Grosjean
154,825,210,2018,Romain Grosjean,Kevin Magnussen,37,56,19,Kevin Magnussen
154,825,210,2019,Romain Grosjean,Kevin Magnussen,8,20,12,Kevin Magnussen
154,825,210,2020,Romain Grosjean,Kevin Magnussen,2,1,1,Romain Grosjean
154,850,210,2020,Romain Grosjean,Pietro Fittipaldi,2,0,2,Romain Grosjean
825,850,210,2020,Kevin Magnussen,Pietro Fittipaldi,1,0,1,Kevin Magnussen
853,854,210,2021,Nikita Mazepin,Mick Schumacher,0,0,0,Mick Schumacher
825,854,210,2022,Kevin Magnussen,Mick Schumacher,21,12,9,Kevin Magnussen
807,825,210,2023,Nico HÃ¼lkenberg,Kevin Magnussen,6,3,3,Nico HÃ¼lkenberg
807,825,210,2024,Nico HÃ¼lkenberg,Kevin Magnussen,20,5,15,Nico HÃ¼lkenberg
815,840,211,2019,Sergio PÃ©rez,Lance Stroll,52,21,31,Sergio PÃ©rez
807,815,211,2020,Nico HÃ¼lkenberg,Sergio PÃ©rez,10,125,115,Sergio PÃ©rez
807,840,211,2020,Nico HÃ¼lkenberg,Lance Stroll,10,75,65,Lance Stroll
815,840,211,2020,Sergio PÃ©rez,Lance Stroll,125,75,50,Sergio PÃ©rez
826,842,213,2020,Daniil Kvyat,Pierre Gasly,32,75,43,Pierre Gasly
842,852,213,2021,Pierre Gasly,Yuki Tsunoda,110,32,78,Pierre Gasly
842,852,213,2022,Pierre Gasly,Yuki Tsunoda,23,12,11,Pierre Gasly
817,852,213,2023,Daniel Ricciardo,Yuki Tsunoda,6,14,8,Yuki Tsunoda
817,856,213,2023,Daniel Ricciardo,Nyck de Vries,6,0,6,Daniel Ricciardo
817,859,213,2023,Daniel Ricciardo,Liam Lawson,6,2,4,Daniel Ricciardo
852,856,213,2023,Yuki Tsunoda,Nyck de Vries,14,0,14,Yuki Tsunoda
852,859,213,2023,Yuki Tsunoda,Liam Lawson,14,2,12,Yuki Tsunoda
856,859,213,2023,Nyck de Vries,Liam Lawson,0,2,2,Liam Lawson
4,839,214,2021,Fernando Alonso,Esteban Ocon,81,74,7,Fernando Alonso
4,839,214,2022,Fernando Alonso,Esteban Ocon,81,89,8,Esteban Ocon
839,842,214,2023,Esteban Ocon,Pierre Gasly,56,54,2,Esteban Ocon
839,842,214,2024,Esteban Ocon,Pierre Gasly,3,6,3,Pierre Gasly
817,852,215,2024,Daniel Ricciardo,Yuki Tsunoda,6,19,13,Yuki Tsunoda
170,77,22,1986,Teo Fabi,Gerhard Berger,2,17,15,Gerhard Berger
123,170,22,1987,Thierry Boutsen,Teo Fabi,16,12,4,Thierry Boutsen
123,145,22,1988,Thierry Boutsen,Alessandro Nannini,27,12,15,Thierry Boutsen
139,145,22,1989,Emanuele Pirro,Alessandro Nannini,2,32,30,Alessandro Nannini
139,65,22,1989,Emanuele Pirro,Johnny Herbert,2,5,3,Johnny Herbert
145,65,22,1989,Alessandro Nannini,Johnny Herbert,32,5,27,Alessandro Nannini
137,145,22,1990,Nelson Piquet,Alessandro Nannini,44,21,23,Nelson Piquet
137,90,22,1990,Nelson Piquet,Roberto Moreno,44,6,38,Nelson Piquet
145,90,22,1990,Alessandro Nannini,Roberto Moreno,21,6,15,Alessandro Nannini
137,30,22,1991,Nelson Piquet,Michael Schumacher,27,4,23,Nelson Piquet
137,90,22,1991,Nelson Piquet,Roberto Moreno,27,8,19,Nelson Piquet
30,90,22,1991,Michael Schumacher,Roberto Moreno,4,8,4,Roberto Moreno
30,84,22,1992,Michael Schumacher,Martin Brundle,53,38,15,Michael Schumacher
119,30,22,1993,Riccardo Patrese,Michael Schumacher,20,52,32,Michael Schumacher
109,30,22,1994,Jyrki JÃ¤rvilehto,Michael Schumacher,1,92,91,Michael Schumacher
109,50,22,1994,Jyrki JÃ¤rvilehto,Jos Verstappen,1,10,9,Jos Verstappen
109,65,22,1994,Jyrki JÃ¤rvilehto,Johnny Herbert,1,0,1,Jyrki JÃ¤rvilehto
30,50,22,1994,Michael Schumacher,Jos Verstappen,92,10,82,Michael Schumacher
30,65,22,1994,Michael Schumacher,Johnny Herbert,92,0,92,Michael Schumacher
50,65,22,1994,Jos Verstappen,Johnny Herbert,10,0,10,Jos Verstappen
30,65,22,1995,Michael Schumacher,Johnny Herbert,102,45,57,Michael Schumacher
55,77,22,1996,Jean Alesi,Gerhard Berger,47,21,26,Jean Alesi
25,55,22,1997,Alexander Wurz,Jean Alesi,4,36,32,Jean Alesi
25,77,22,1997,Alexander Wurz,Gerhard Berger,4,27,23,Gerhard Berger
55,77,22,1997,Jean Alesi,Gerhard Berger,36,27,9,Jean Alesi
21,25,22,1998,Giancarlo Fisichella,Alexander Wurz,16,17,1,Alexander Wurz
21,25,22,1999,Giancarlo Fisichella,Alexander Wurz,13,3,10,Giancarlo Fisichella
21,25,22,2000,Giancarlo Fisichella,Alexander Wurz,18,2,16,Giancarlo Fisichella
18,21,22,2001,Jenson Button,Giancarlo Fisichella,2,8,6,Giancarlo Fisichella
18,22,23,2009,Jenson Button,Rubens Barrichello,95,77,18,Jenson Button
22,76,24,1997,Rubens Barrichello,Jan Magnussen,6,0,6,Rubens Barrichello
22,50,24,1998,Rubens Barrichello,Jos Verstappen,4,0,4,Rubens Barrichello
22,76,24,1998,Rubens Barrichello,Jan Magnussen,4,1,3,Rubens Barrichello
50,76,24,1998,Jos Verstappen,Jan Magnussen,0,1,1,Jan Magnussen
22,65,24,1999,Rubens Barrichello,Johnny Herbert,21,15,6,Rubens Barrichello
309,327,25,1971,Peter Revson,FranÃ§ois Cevert,0,26,26,FranÃ§ois Cevert
309,328,25,1971,Peter Revson,Jackie Stewart,0,62,62,Jackie Stewart
327,328,25,1971,FranÃ§ois Cevert,Jackie Stewart,26,62,36,Jackie Stewart
221,327,25,1972,Patrick Depailler,FranÃ§ois Cevert,0,15,15,FranÃ§ois Cevert
221,328,25,1972,Patrick Depailler,Jackie Stewart,0,45,45,Jackie Stewart
327,328,25,1972,FranÃ§ois Cevert,Jackie Stewart,15,45,30,Jackie Stewart
278,292,25,1973,Chris Amon,Eddie Keizan,0,0,0,Eddie Keizan
278,327,25,1973,Chris Amon,FranÃ§ois Cevert,0,47,47,FranÃ§ois Cevert
278,328,25,1973,Chris Amon,Jackie Stewart,0,71,71,Jackie Stewart
292,327,25,1973,Eddie Keizan,FranÃ§ois Cevert,0,47,47,FranÃ§ois Cevert
292,328,25,1973,Eddie Keizan,Jackie Stewart,0,71,71,Jackie Stewart
327,328,25,1973,FranÃ§ois Cevert,Jackie Stewart,47,71,24,Jackie Stewart
221,222,25,1974,Patrick Depailler,Jody Scheckter,14,45,31,Jody Scheckter
221,292,25,1974,Patrick Depailler,Eddie Keizan,14,0,14,Patrick Depailler
222,292,25,1974,Jody Scheckter,Eddie Keizan,45,0,45,Jody Scheckter
219,221,25,1975,Jean-Pierre Jabouille,Patrick Depailler,0,12,12,Patrick Depailler
219,222,25,1975,Jean-Pierre Jabouille,Jody Scheckter,0,20,20,Jody Scheckter
219,251,25,1975,Jean-Pierre Jabouille,Ian Scheckter,0,0,0,Ian Scheckter
219,277,25,1975,Jean-Pierre Jabouille,Michel LeclÃ¨re,0,0,0,Michel LeclÃ¨re
221,222,25,1975,Patrick Depailler,Jody Scheckter,12,20,8,Jody Scheckter
221,251,25,1975,Patrick Depailler,Ian Scheckter,12,0,12,Patrick Depailler
221,277,25,1975,Patrick Depailler,Michel LeclÃ¨re,12,0,12,Patrick Depailler
222,251,25,1975,Jody Scheckter,Ian Scheckter,20,0,20,Jody Scheckter
222,277,25,1975,Jody Scheckter,Michel LeclÃ¨re,20,0,20,Jody Scheckter
251,277,25,1975,Ian Scheckter,Michel LeclÃ¨re,0,0,0,Michel LeclÃ¨re
221,222,25,1976,Patrick Depailler,Jody Scheckter,39,49,10,Jody Scheckter
221,251,25,1976,Patrick Depailler,Ian Scheckter,39,0,39,Patrick Depailler
221,273,25,1976,Patrick Depailler,Kazuyoshi Hoshino,39,0,39,Patrick Depailler
221,284,25,1976,Patrick Depailler,Alessandro Pesenti-Rossi,39,0,39,Patrick Depailler
221,285,25,1976,Patrick Depailler,Otto Stuppacher,39,0,39,Patrick Depailler
222,251,25,1976,Jody Scheckter,Ian Scheckter,49,0,49,Jody Scheckter
222,273,25,1976,Jody Scheckter,Kazuyoshi Hoshino,49,0,49,Jody Scheckter
222,284,25,1976,Jody Scheckter,Alessandro Pesenti-Rossi,49,0,49,Jody Scheckter
222,285,25,1976,Jody Scheckter,Otto Stuppacher,49,0,49,Jody Scheckter
251,273,25,1976,Ian Scheckter,Kazuyoshi Hoshino,0,0,0,Kazuyoshi Hoshino
251,284,25,1976,Ian Scheckter,Alessandro Pesenti-Rossi,0,0,0,Alessandro Pesenti-Rossi
251,285,25,1976,Ian Scheckter,Otto Stuppacher,0,0,0,Otto Stuppacher
273,284,25,1976,Kazuyoshi Hoshino,Alessandro Pesenti-Rossi,0,0,0,Alessandro Pesenti-Rossi
273,285,25,1976,Kazuyoshi Hoshino,Otto Stuppacher,0,0,0,Otto Stuppacher
284,285,25,1976,Alessandro Pesenti-Rossi,Otto Stuppacher,0,0,0,Otto Stuppacher
221,238,25,1977,Patrick Depailler,Ronnie Peterson,20,7,13,Patrick Depailler
221,272,25,1977,Patrick Depailler,Kunimitsu Takahashi,20,0,20,Patrick Depailler
238,272,25,1977,Ronnie Peterson,Kunimitsu Takahashi,7,0,7,Ronnie Peterson
202,221,25,1978,Didier Pironi,Patrick Depailler,7,34,27,Patrick Depailler
197,202,25,1979,Jean-Pierre Jarier,Didier Pironi,14,14,0,Didier Pironi
197,206,25,1979,Jean-Pierre Jarier,Derek Daly,14,0,14,Jean-Pierre Jarier
197,209,25,1979,Jean-Pierre Jarier,Geoff Lees,14,0,14,Jean-Pierre Jarier
202,206,25,1979,Didier Pironi,Derek Daly,14,0,14,Didier Pironi
202,209,25,1979,Didier Pironi,Geoff Lees,14,0,14,Didier Pironi
206,209,25,1979,Derek Daly,Geoff Lees,0,0,0,Geoff Lees
191,197,25,1980,Mike Thackwell,Jean-Pierre Jarier,0,6,6,Jean-Pierre Jarier
191,206,25,1980,Mike Thackwell,Derek Daly,0,6,6,Derek Daly
197,206,25,1980,Jean-Pierre Jarier,Derek Daly,6,6,0,Derek Daly
105,158,25,1981,Michele Alboreto,Eddie Cheever,0,10,10,Eddie Cheever
105,214,25,1981,Michele Alboreto,Kevin Cogan,0,0,0,Kevin Cogan
105,217,25,1981,Michele Alboreto,Ricardo Zunino,0,0,0,Ricardo Zunino
158,214,25,1981,Eddie Cheever,Kevin Cogan,10,0,10,Eddie Cheever
158,217,25,1981,Eddie Cheever,Ricardo Zunino,10,0,10,Eddie Cheever
214,217,25,1981,Kevin Cogan,Ricardo Zunino,0,0,0,Ricardo Zunino
105,201,25,1982,Michele Alboreto,Slim Borgudd,25,0,25,Michele Alboreto
105,205,25,1982,Michele Alboreto,Brian Henton,25,0,25,Michele Alboreto
201,205,25,1982,Slim Borgudd,Brian Henton,0,0,0,Brian Henton
105,193,25,1983,Michele Alboreto,Danny Sullivan,10,2,8,Michele Alboreto
140,185,25,1984,Stefan Johansson,Stefan Bellof,0,0,0,Stefan Bellof
140,191,25,1984,Stefan Johansson,Mike Thackwell,0,0,0,Mike Thackwell
140,84,25,1984,Stefan Johansson,Martin Brundle,0,0,0,Martin Brundle
185,191,25,1984,Stefan Bellof,Mike Thackwell,0,0,0,Mike Thackwell
185,84,25,1984,Stefan Bellof,Martin Brundle,0,0,0,Martin Brundle
191,84,25,1984,Mike Thackwell,Martin Brundle,0,0,0,Martin Brundle
122,140,25,1985,Ivan Capelli,Stefan Johansson,3,0,3,Ivan Capelli
122,166,25,1985,Ivan Capelli,Philippe Streiff,3,0,3,Ivan Capelli
122,185,25,1985,Ivan Capelli,Stefan Bellof,3,4,1,Stefan Bellof
122,84,25,1985,Ivan Capelli,Martin Brundle,3,0,3,Ivan Capelli
140,166,25,1985,Stefan Johansson,Philippe Streiff,0,0,0,Philippe Streiff
140,185,25,1985,Stefan Johansson,Stefan Bellof,0,4,4,Stefan Bellof
140,84,25,1985,Stefan Johansson,Martin Brundle,0,0,0,Martin Brundle
166,185,25,1985,Philippe Streiff,Stefan Bellof,0,4,4,Stefan Bellof
166,84,25,1985,Philippe Streiff,Martin Brundle,0,0,0,Martin Brundle
185,84,25,1985,Stefan Bellof,Martin Brundle,4,0,4,Stefan Bellof
166,84,25,1986,Philippe Streiff,Martin Brundle,3,8,5,Martin Brundle
156,166,25,1987,Jonathan Palmer,Philippe Streiff,7,4,3,Jonathan Palmer
141,156,25,1988,Julian Bailey,Jonathan Palmer,0,5,5,Jonathan Palmer
105,156,25,1989,Michele Alboreto,Jonathan Palmer,6,2,4,Michele Alboreto
105,55,25,1989,Michele Alboreto,Jean Alesi,6,8,2,Jean Alesi
105,65,25,1989,Michele Alboreto,Johnny Herbert,6,0,6,Michele Alboreto
156,55,25,1989,Jonathan Palmer,Jean Alesi,2,8,6,Jean Alesi
156,65,25,1989,Jonathan Palmer,Johnny Herbert,2,0,2,Jonathan Palmer
55,65,25,1989,Jean Alesi,Johnny Herbert,8,0,8,Jean Alesi
138,55,25,1990,Satoru Nakajima,Jean Alesi,3,13,10,Jean Alesi
131,138,25,1991,Stefano Modena,Satoru Nakajima,10,2,8,Stefano Modena
110,129,25,1992,Andrea de Cesaris,Olivier Grouillard,8,0,8,Andrea de Cesaris
110,79,25,1993,Andrea de Cesaris,Ukyo Katayama,0,0,0,Ukyo Katayama
79,87,25,1994,Ukyo Katayama,Mark Blundell,5,8,3,Mark Blundell
63,79,25,1995,Mika Salo,Ukyo Katayama,5,0,5,Mika Salo
63,99,25,1995,Mika Salo,Gabriele Tarquini,5,0,5,Mika Salo
79,99,25,1995,Ukyo Katayama,Gabriele Tarquini,0,0,0,Gabriele Tarquini
63,79,25,1996,Mika Salo,Ukyo Katayama,5,0,5,Mika Salo
50,63,25,1997,Jos Verstappen,Mika Salo,0,2,2,Mika Salo
68,73,25,1998,Toranosuke Takagi,Ricardo Rosset,0,0,0,Ricardo Rosset
341,456,26,1962,John Surtees,Roy Salvadori,19,0,19,John Surtees
278,305,26,1963,Chris Amon,Mike Hailwood,0,0,0,Mike Hailwood
278,376,26,1963,Chris Amon,Lucien Bianchi,0,0,0,Lucien Bianchi
278,383,26,1963,Chris Amon,Bob Anderson,0,0,0,Bob Anderson
278,418,26,1963,Chris Amon,Masten Gregory,0,0,0,Masten Gregory
278,427,26,1963,Chris Amon,Maurice Trintignant,0,0,0,Maurice Trintignant
278,436,26,1963,Chris Amon,John Campbell-Jones,0,0,0,John Campbell-Jones
305,376,26,1963,Mike Hailwood,Lucien Bianchi,0,0,0,Lucien Bianchi
305,383,26,1963,Mike Hailwood,Bob Anderson,0,0,0,Bob Anderson
305,418,26,1963,Mike Hailwood,Masten Gregory,0,0,0,Masten Gregory
305,427,26,1963,Mike Hailwood,Maurice Trintignant,0,0,0,Maurice Trintignant
305,436,26,1963,Mike Hailwood,John Campbell-Jones,0,0,0,John Campbell-Jones
376,383,26,1963,Lucien Bianchi,Bob Anderson,0,0,0,Bob Anderson
376,418,26,1963,Lucien Bianchi,Masten Gregory,0,0,0,Masten Gregory
376,427,26,1963,Lucien Bianchi,Maurice Trintignant,0,0,0,Maurice Trintignant
376,436,26,1963,Lucien Bianchi,John Campbell-Jones,0,0,0,John Campbell-Jones
383,418,26,1963,Bob Anderson,Masten Gregory,0,0,0,Masten Gregory
383,427,26,1963,Bob Anderson,Maurice Trintignant,0,0,0,Maurice Trintignant
383,436,26,1963,Bob Anderson,John Campbell-Jones,0,0,0,John Campbell-Jones
418,427,26,1963,Masten Gregory,Maurice Trintignant,0,0,0,Maurice Trintignant
418,436,26,1963,Masten Gregory,John Campbell-Jones,0,0,0,John Campbell-Jones
427,436,26,1963,Maurice Trintignant,John Campbell-Jones,0,0,0,John Campbell-Jones
322,365,26,1967,David Hobbs,Hubert Hahne,0,0,0,Hubert Hahne
243,265,26,1974,Rolf Stommelen,Guy Edwards,0,0,0,Guy Edwards
243,289,26,1974,Rolf Stommelen,Graham Hill,0,1,1,Graham Hill
243,320,26,1974,Rolf Stommelen,Peter Gethin,0,0,0,Peter Gethin
265,289,26,1974,Guy Edwards,Graham Hill,0,1,1,Graham Hill
265,320,26,1974,Guy Edwards,Peter Gethin,0,0,0,Peter Gethin
289,320,26,1974,Graham Hill,Peter Gethin,1,0,1,Graham Hill
243,289,26,1975,Rolf Stommelen,Graham Hill,0,0,0,Graham Hill
243,296,26,1975,Rolf Stommelen,FranÃ§ois Migault,0,0,0,FranÃ§ois Migault
289,296,26,1975,Graham Hill,FranÃ§ois Migault,0,0,0,FranÃ§ois Migault
158,175,26,1986,Eddie Cheever,Patrick Tambay,0,2,2,Patrick Tambay
158,178,26,1986,Eddie Cheever,Alan Jones,0,4,4,Alan Jones
175,178,26,1986,Patrick Tambay,Alan Jones,2,4,2,Alan Jones
103,88,26,1991,Ã‰ric Bernard,Aguri Suzuki,1,0,1,Ã‰ric Bernard
105,69,26,1993,Michele Alboreto,Luca Badoer,0,0,0,Luca Badoer
73,80,26,1997,Ricardo Rosset,Vincenzo Sospiri,0,0,0,Vincenzo Sospiri
172,197,27,1977,Jacques Laffite,Jean-Pierre Jarier,18,0,18,Jacques Laffite
172,221,27,1979,Jacques Laffite,Patrick Depailler,36,22,14,Jacques Laffite
172,235,27,1979,Jacques Laffite,Jacky Ickx,36,3,33,Jacques Laffite
221,235,27,1979,Patrick Depailler,Jacky Ickx,22,3,19,Patrick Depailler
172,202,27,1980,Jacques Laffite,Didier Pironi,34,32,2,Jacques Laffite
172,175,27,1981,Jacques Laffite,Patrick Tambay,44,0,44,Jacques Laffite
172,197,27,1981,Jacques Laffite,Jean-Pierre Jarier,44,0,44,Jacques Laffite
172,219,27,1981,Jacques Laffite,Jean-Pierre Jabouille,44,0,44,Jacques Laffite
175,197,27,1981,Patrick Tambay,Jean-Pierre Jarier,0,0,0,Jean-Pierre Jarier
175,219,27,1981,Patrick Tambay,Jean-Pierre Jabouille,0,0,0,Jean-Pierre Jabouille
197,219,27,1981,Jean-Pierre Jarier,Jean-Pierre Jabouille,0,0,0,Jean-Pierre Jabouille
158,172,27,1982,Eddie Cheever,Jacques Laffite,15,5,10,Eddie Cheever
196,197,27,1983,Raul Boesel,Jean-Pierre Jarier,0,0,0,Jean-Pierre Jarier
110,183,27,1984,Andrea de Cesaris,FranÃ§ois Hesnault,3,0,3,Andrea de Cesaris
110,166,27,1985,Andrea de Cesaris,Philippe Streiff,3,4,1,Philippe Streiff
110,172,27,1985,Andrea de Cesaris,Jacques Laffite,3,16,13,Jacques Laffite
166,172,27,1985,Philippe Streiff,Jacques Laffite,4,16,12,Jacques Laffite
112,163,27,1986,Philippe Alliot,RenÃ© Arnoux,1,14,13,RenÃ© Arnoux
112,172,27,1986,Philippe Alliot,Jacques Laffite,1,14,13,Jacques Laffite
163,172,27,1986,RenÃ© Arnoux,Jacques Laffite,14,14,0,Jacques Laffite
160,163,27,1987,Piercarlo Ghinzani,RenÃ© Arnoux,0,1,1,RenÃ© Arnoux
140,163,27,1988,Stefan Johansson,RenÃ© Arnoux,0,0,0,RenÃ© Arnoux
129,163,27,1989,Olivier Grouillard,RenÃ© Arnoux,1,2,1,RenÃ© Arnoux
112,78,27,1990,Philippe Alliot,Nicola Larini,0,0,0,Nicola Larini
100,123,27,1991,Ã‰rik Comas,Thierry Boutsen,0,0,0,Thierry Boutsen
100,123,27,1992,Ã‰rik Comas,Thierry Boutsen,4,2,2,Ã‰rik Comas
84,87,27,1993,Martin Brundle,Mark Blundell,13,10,3,Martin Brundle
103,116,27,1994,Ã‰ric Bernard,Franck Lagorce,4,0,4,Ã‰ric Bernard
103,44,27,1994,Ã‰ric Bernard,Olivier Panis,4,9,5,Olivier Panis
103,65,27,1994,Ã‰ric Bernard,Johnny Herbert,4,0,4,Ã‰ric Bernard
116,44,27,1994,Franck Lagorce,Olivier Panis,0,9,9,Olivier Panis
116,65,27,1994,Franck Lagorce,Johnny Herbert,0,0,0,Johnny Herbert
44,65,27,1994,Olivier Panis,Johnny Herbert,9,0,9,Olivier Panis
44,84,27,1995,Olivier Panis,Martin Brundle,16,7,9,Olivier Panis
44,88,27,1995,Olivier Panis,Aguri Suzuki,16,1,15,Olivier Panis
84,88,27,1995,Martin Brundle,Aguri Suzuki,7,1,6,Martin Brundle
44,64,27,1996,Olivier Panis,Pedro Diniz,13,2,11,Olivier Panis
64,90,28,1995,Pedro Diniz,Roberto Moreno,0,0,0,Roberto Moreno
69,85,28,1996,Luca Badoer,Andrea Montermini,0,0,0,Andrea Montermini
105,133,29,1991,Michele Alboreto,Alex Caffi,0,0,0,Alex Caffi
105,140,29,1991,Michele Alboreto,Stefan Johansson,0,0,0,Stefan Johansson
133,140,29,1991,Alex Caffi,Stefan Johansson,0,0,0,Stefan Johansson
105,88,29,1992,Michele Alboreto,Aguri Suzuki,6,0,6,Michele Alboreto
118,88,29,1993,Derek Warwick,Aguri Suzuki,4,0,4,Derek Warwick
104,81,29,1994,Christian Fittipaldi,Gianni Morbidelli,6,3,3,Christian Fittipaldi
81,89,29,1995,Gianni Morbidelli,Taki Inoue,5,0,5,Gianni Morbidelli
81,97,29,1995,Gianni Morbidelli,Massimiliano Papis,5,0,5,Gianni Morbidelli
89,97,29,1995,Taki Inoue,Massimiliano Papis,0,0,0,Massimiliano Papis
50,73,29,1996,Jos Verstappen,Ricardo Rosset,1,0,1,Jos Verstappen
172,232,3,1975,Jacques Laffite,Arturo Merzario,6,0,6,Jacques Laffite
172,251,3,1975,Jacques Laffite,Ian Scheckter,6,0,6,Jacques Laffite
172,254,3,1975,Jacques Laffite,Renzo Zorzi,6,0,6,Jacques Laffite
172,270,3,1975,Jacques Laffite,Ian Ashley,6,0,6,Jacques Laffite
172,275,3,1975,Jacques Laffite,Lella Lombardi,6,0,6,Jacques Laffite
172,282,3,1975,Jacques Laffite,Damien Magee,6,0,6,Jacques Laffite
172,294,3,1975,Jacques Laffite,Tony Brise,6,0,6,Jacques Laffite
172,296,3,1975,Jacques Laffite,FranÃ§ois Migault,6,0,6,Jacques Laffite
172,303,3,1975,Jacques Laffite,Jo Vonlanthen,6,0,6,Jacques Laffite
232,251,3,1975,Arturo Merzario,Ian Scheckter,0,0,0,Ian Scheckter
232,254,3,1975,Arturo Merzario,Renzo Zorzi,0,0,0,Renzo Zorzi
232,270,3,1975,Arturo Merzario,Ian Ashley,0,0,0,Ian Ashley
232,275,3,1975,Arturo Merzario,Lella Lombardi,0,0,0,Lella Lombardi
232,282,3,1975,Arturo Merzario,Damien Magee,0,0,0,Damien Magee
232,294,3,1975,Arturo Merzario,Tony Brise,0,0,0,Tony Brise
232,296,3,1975,Arturo Merzario,FranÃ§ois Migault,0,0,0,FranÃ§ois Migault
232,303,3,1975,Arturo Merzario,Jo Vonlanthen,0,0,0,Jo Vonlanthen
251,254,3,1975,Ian Scheckter,Renzo Zorzi,0,0,0,Renzo Zorzi
251,270,3,1975,Ian Scheckter,Ian Ashley,0,0,0,Ian Ashley
251,275,3,1975,Ian Scheckter,Lella Lombardi,0,0,0,Lella Lombardi
251,282,3,1975,Ian Scheckter,Damien Magee,0,0,0,Damien Magee
251,294,3,1975,Ian Scheckter,Tony Brise,0,0,0,Tony Brise
251,296,3,1975,Ian Scheckter,FranÃ§ois Migault,0,0,0,FranÃ§ois Migault
251,303,3,1975,Ian Scheckter,Jo Vonlanthen,0,0,0,Jo Vonlanthen
254,270,3,1975,Renzo Zorzi,Ian Ashley,0,0,0,Ian Ashley
254,275,3,1975,Renzo Zorzi,Lella Lombardi,0,0,0,Lella Lombardi
254,282,3,1975,Renzo Zorzi,Damien Magee,0,0,0,Damien Magee
254,294,3,1975,Renzo Zorzi,Tony Brise,0,0,0,Tony Brise
254,296,3,1975,Renzo Zorzi,FranÃ§ois Migault,0,0,0,FranÃ§ois Migault
254,303,3,1975,Renzo Zorzi,Jo Vonlanthen,0,0,0,Jo Vonlanthen
270,275,3,1975,Ian Ashley,Lella Lombardi,0,0,0,Lella Lombardi
270,282,3,1975,Ian Ashley,Damien Magee,0,0,0,Damien Magee
270,294,3,1975,Ian Ashley,Tony Brise,0,0,0,Tony Brise
270,296,3,1975,Ian Ashley,FranÃ§ois Migault,0,0,0,FranÃ§ois Migault
270,303,3,1975,Ian Ashley,Jo Vonlanthen,0,0,0,Jo Vonlanthen
275,282,3,1975,Lella Lombardi,Damien Magee,0,0,0,Damien Magee
275,294,3,1975,Lella Lombardi,Tony Brise,0,0,0,Tony Brise
275,296,3,1975,Lella Lombardi,FranÃ§ois Migault,0,0,0,FranÃ§ois Migault
275,303,3,1975,Lella Lombardi,Jo Vonlanthen,0,0,0,Jo Vonlanthen
282,294,3,1975,Damien Magee,Tony Brise,0,0,0,Tony Brise
282,296,3,1975,Damien Magee,FranÃ§ois Migault,0,0,0,FranÃ§ois Migault
282,303,3,1975,Damien Magee,Jo Vonlanthen,0,0,0,Jo Vonlanthen
294,296,3,1975,Tony Brise,FranÃ§ois Migault,0,0,0,FranÃ§ois Migault
294,303,3,1975,Tony Brise,Jo Vonlanthen,0,0,0,Jo Vonlanthen
296,303,3,1975,FranÃ§ois Migault,Jo Vonlanthen,0,0,0,Jo Vonlanthen
254,279,3,1976,Renzo Zorzi,Emilio Zapico,0,0,0,Emilio Zapico
178,223,3,1979,Alan Jones,Clay Regazzoni,43,32,11,Alan Jones
178,199,3,1980,Alan Jones,Carlos Reutemann,71,49,22,Alan Jones
178,209,3,1980,Alan Jones,Geoff Lees,71,0,71,Alan Jones
178,211,3,1980,Alan Jones,Rupert Keegan,71,0,71,Alan Jones
178,214,3,1980,Alan Jones,Kevin Cogan,71,0,71,Alan Jones
178,228,3,1980,Alan Jones,DesirÃ© Wilson,71,0,71,Alan Jones
199,209,3,1980,Carlos Reutemann,Geoff Lees,49,0,49,Carlos Reutemann
199,211,3,1980,Carlos Reutemann,Rupert Keegan,49,0,49,Carlos Reutemann
199,214,3,1980,Carlos Reutemann,Kevin Cogan,49,0,49,Carlos Reutemann
199,228,3,1980,Carlos Reutemann,DesirÃ© Wilson,49,0,49,Carlos Reutemann
209,211,3,1980,Geoff Lees,Rupert Keegan,0,0,0,Rupert Keegan
209,214,3,1980,Geoff Lees,Kevin Cogan,0,0,0,Kevin Cogan
209,228,3,1980,Geoff Lees,DesirÃ© Wilson,0,0,0,DesirÃ© Wilson
211,214,3,1980,Rupert Keegan,Kevin Cogan,0,0,0,Kevin Cogan
211,228,3,1980,Rupert Keegan,DesirÃ© Wilson,0,0,0,DesirÃ© Wilson
214,228,3,1980,Kevin Cogan,DesirÃ© Wilson,0,0,0,DesirÃ© Wilson
178,199,3,1981,Alan Jones,Carlos Reutemann,46,49,3,Carlos Reutemann
177,199,3,1982,Keke Rosberg,Carlos Reutemann,44,6,38,Keke Rosberg
177,206,3,1982,Keke Rosberg,Derek Daly,44,8,36,Keke Rosberg
177,207,3,1982,Keke Rosberg,Mario Andretti,44,0,44,Keke Rosberg
199,206,3,1982,Carlos Reutemann,Derek Daly,6,8,2,Derek Daly
199,207,3,1982,Carlos Reutemann,Mario Andretti,6,0,6,Carlos Reutemann
206,207,3,1982,Derek Daly,Mario Andretti,8,0,8,Derek Daly
156,172,3,1983,Jonathan Palmer,Jacques Laffite,0,11,11,Jacques Laffite
156,177,3,1983,Jonathan Palmer,Keke Rosberg,0,27,27,Keke Rosberg
172,177,3,1983,Jacques Laffite,Keke Rosberg,11,27,16,Keke Rosberg
172,177,3,1984,Jacques Laffite,Keke Rosberg,5,21,16,Keke Rosberg
177,95,3,1985,Keke Rosberg,Nigel Mansell,40,31,9,Keke Rosberg
137,95,3,1986,Nelson Piquet,Nigel Mansell,69,72,3,Nigel Mansell
119,137,3,1987,Riccardo Patrese,Nelson Piquet,0,76,76,Nelson Piquet
119,95,3,1987,Riccardo Patrese,Nigel Mansell,0,61,61,Nigel Mansell
137,95,3,1987,Nelson Piquet,Nigel Mansell,76,61,15,Nelson Piquet
119,168,3,1988,Riccardo Patrese,Jean-Louis Schlesser,8,0,8,Riccardo Patrese
119,84,3,1988,Riccardo Patrese,Martin Brundle,8,0,8,Riccardo Patrese
119,95,3,1988,Riccardo Patrese,Nigel Mansell,8,12,4,Nigel Mansell
168,84,3,1988,Jean-Louis Schlesser,Martin Brundle,0,0,0,Martin Brundle
168,95,3,1988,Jean-Louis Schlesser,Nigel Mansell,0,12,12,Nigel Mansell
84,95,3,1988,Martin Brundle,Nigel Mansell,0,12,12,Nigel Mansell
119,123,3,1989,Riccardo Patrese,Thierry Boutsen,40,37,3,Riccardo Patrese
119,123,3,1990,Riccardo Patrese,Thierry Boutsen,23,34,11,Thierry Boutsen
119,95,3,1991,Riccardo Patrese,Nigel Mansell,53,72,19,Nigel Mansell
119,95,3,1992,Riccardo Patrese,Nigel Mansell,56,108,52,Nigel Mansell
117,71,3,1993,Alain Prost,Damon Hill,99,69,30,Alain Prost
102,14,3,1994,Ayrton Senna,David Coulthard,0,14,14,David Coulthard
102,71,3,1994,Ayrton Senna,Damon Hill,0,91,91,Damon Hill
102,95,3,1994,Ayrton Senna,Nigel Mansell,0,13,13,Nigel Mansell
14,71,3,1994,David Coulthard,Damon Hill,14,91,77,Damon Hill
14,95,3,1994,David Coulthard,Nigel Mansell,14,13,1,David Coulthard
71,95,3,1994,Damon Hill,Nigel Mansell,91,13,78,Damon Hill
14,71,3,1995,David Coulthard,Damon Hill,49,69,20,Damon Hill
35,71,3,1996,Jacques Villeneuve,Damon Hill,78,97,19,Damon Hill
35,49,3,1997,Jacques Villeneuve,Heinz-Harald Frentzen,81,42,39,Jacques Villeneuve
35,49,3,1998,Jacques Villeneuve,Heinz-Harald Frentzen,21,17,4,Jacques Villeneuve
23,70,3,1999,Ralf Schumacher,Alessandro Zanardi,35,0,35,Ralf Schumacher
18,23,3,2000,Jenson Button,Ralf Schumacher,12,24,12,Ralf Schumacher
23,31,3,2001,Ralf Schumacher,Juan Pablo Montoya,49,31,18,Ralf Schumacher
23,31,3,2002,Ralf Schumacher,Juan Pablo Montoya,42,50,8,Juan Pablo Montoya
23,31,3,2003,Ralf Schumacher,Juan Pablo Montoya,58,82,24,Juan Pablo Montoya
23,48,3,2003,Ralf Schumacher,Marc GenÃ©,58,4,54,Ralf Schumacher
31,48,3,2003,Juan Pablo Montoya,Marc GenÃ©,82,4,78,Juan Pablo Montoya
23,31,3,2004,Ralf Schumacher,Juan Pablo Montoya,24,58,34,Juan Pablo Montoya
23,42,3,2004,Ralf Schumacher,AntÃ´nio Pizzonia,24,6,18,Ralf Schumacher
23,48,3,2004,Ralf Schumacher,Marc GenÃ©,24,0,24,Ralf Schumacher
31,42,3,2004,Juan Pablo Montoya,AntÃ´nio Pizzonia,58,6,52,Juan Pablo Montoya
31,48,3,2004,Juan Pablo Montoya,Marc GenÃ©,58,0,58,Juan Pablo Montoya
42,48,3,2004,AntÃ´nio Pizzonia,Marc GenÃ©,6,0,6,AntÃ´nio Pizzonia
17,2,3,2005,Mark Webber,Nick Heidfeld,36,28,8,Mark Webber
17,42,3,2005,Mark Webber,AntÃ´nio Pizzonia,36,2,34,Mark Webber
2,42,3,2005,Nick Heidfeld,AntÃ´nio Pizzonia,28,2,26,Nick Heidfeld
17,3,3,2006,Mark Webber,Nico Rosberg,7,4,3,Mark Webber
25,3,3,2007,Alexander Wurz,Nico Rosberg,13,20,7,Nico Rosberg
25,6,3,2007,Alexander Wurz,Kazuki Nakajima,13,0,13,Alexander Wurz
3,6,3,2007,Nico Rosberg,Kazuki Nakajima,20,0,20,Nico Rosberg
3,6,3,2008,Nico Rosberg,Kazuki Nakajima,17,9,8,Nico Rosberg
3,6,3,2009,Nico Rosberg,Kazuki Nakajima,34,0,34,Nico Rosberg
22,807,3,2010,Rubens Barrichello,Nico HÃ¼lkenberg,47,22,25,Rubens Barrichello
22,813,3,2011,Rubens Barrichello,Pastor Maldonado,4,1,3,Rubens Barrichello
811,813,3,2012,Bruno Senna,Pastor Maldonado,31,45,14,Pastor Maldonado
813,822,3,2013,Pastor Maldonado,Valtteri Bottas,1,4,3,Valtteri Bottas
13,822,3,2014,Felipe Massa,Valtteri Bottas,134,186,52,Valtteri Bottas
13,822,3,2015,Felipe Massa,Valtteri Bottas,121,136,15,Valtteri Bottas
13,822,3,2016,Felipe Massa,Valtteri Bottas,53,85,32,Valtteri Bottas
13,814,3,2017,Felipe Massa,Paul di Resta,43,0,43,Felipe Massa
13,840,3,2017,Felipe Massa,Lance Stroll,43,40,3,Felipe Massa
814,840,3,2017,Paul di Resta,Lance Stroll,0,40,40,Lance Stroll
840,845,3,2018,Lance Stroll,Sergey Sirotkin,6,1,5,Lance Stroll
847,9,3,2019,George Russell,Robert Kubica,0,1,1,Robert Kubica
847,849,3,2020,George Russell,Nicholas Latifi,0,0,0,Nicholas Latifi
847,851,3,2020,George Russell,Jack Aitken,0,0,0,Jack Aitken
849,851,3,2020,Nicholas Latifi,Jack Aitken,0,0,0,Jack Aitken
847,849,3,2021,George Russell,Nicholas Latifi,16,7,9,George Russell
848,849,3,2022,Alexander Albon,Nicholas Latifi,4,2,2,Alexander Albon
848,856,3,2022,Alexander Albon,Nyck de Vries,4,2,2,Alexander Albon
849,856,3,2022,Nicholas Latifi,Nyck de Vries,2,2,0,Nyck de Vries
848,858,3,2023,Alexander Albon,Logan Sargeant,25,1,24,Alexander Albon
848,858,3,2024,Alexander Albon,Logan Sargeant,4,0,4,Alexander Albon
108,92,30,1994,Paul Belmondo,Bertrand Gachot,0,0,0,Bertrand Gachot
85,86,30,1995,Andrea Montermini,Giovanni Lavaggi,0,0,0,Giovanni Lavaggi
85,92,30,1995,Andrea Montermini,Bertrand Gachot,0,0,0,Bertrand Gachot
85,98,30,1995,Andrea Montermini,Jean-Denis DÃ©lÃ©traz,0,0,0,Jean-Denis DÃ©lÃ©traz
86,92,30,1995,Giovanni Lavaggi,Bertrand Gachot,0,0,0,Bertrand Gachot
86,98,30,1995,Giovanni Lavaggi,Jean-Denis DÃ©lÃ©traz,0,0,0,Jean-Denis DÃ©lÃ©traz
92,98,30,1995,Bertrand Gachot,Jean-Denis DÃ©lÃ©traz,0,0,0,Jean-Denis DÃ©lÃ©traz
101,107,31,1994,David Brabham,Roland Ratzenberger,0,0,0,Roland Ratzenberger
101,111,31,1994,David Brabham,Jean-Marc Gounon,0,0,0,Jean-Marc Gounon
101,85,31,1994,David Brabham,Andrea Montermini,0,0,0,Andrea Montermini
101,89,31,1994,David Brabham,Taki Inoue,0,0,0,Taki Inoue
101,93,31,1994,David Brabham,Domenico Schiattarella,0,0,0,Domenico Schiattarella
107,111,31,1994,Roland Ratzenberger,Jean-Marc Gounon,0,0,0,Jean-Marc Gounon
107,85,31,1994,Roland Ratzenberger,Andrea Montermini,0,0,0,Andrea Montermini
107,89,31,1994,Roland Ratzenberger,Taki Inoue,0,0,0,Taki Inoue
107,93,31,1994,Roland Ratzenberger,Domenico Schiattarella,0,0,0,Domenico Schiattarella
111,85,31,1994,Jean-Marc Gounon,Andrea Montermini,0,0,0,Andrea Montermini
111,89,31,1994,Jean-Marc Gounon,Taki Inoue,0,0,0,Taki Inoue
111,93,31,1994,Jean-Marc Gounon,Domenico Schiattarella,0,0,0,Domenico Schiattarella
85,89,31,1994,Andrea Montermini,Taki Inoue,0,0,0,Taki Inoue
85,93,31,1994,Andrea Montermini,Domenico Schiattarella,0,0,0,Domenico Schiattarella
89,93,31,1994,Taki Inoue,Domenico Schiattarella,0,0,0,Domenico Schiattarella
50,93,31,1995,Jos Verstappen,Domenico Schiattarella,0,0,0,Domenico Schiattarella
289,477,32,1958,Graham Hill,Cliff Allison,0,3,3,Cliff Allison
289,502,32,1958,Graham Hill,Alan Stacey,0,0,0,Alan Stacey
289,549,32,1958,Graham Hill,Ivor Bueb,0,0,0,Ivor Bueb
477,502,32,1958,Cliff Allison,Alan Stacey,3,0,3,Cliff Allison
477,549,32,1958,Cliff Allison,Ivor Bueb,3,0,3,Cliff Allison
502,549,32,1958,Alan Stacey,Ivor Bueb,0,0,0,Ivor Bueb
289,353,32,1959,Graham Hill,Pete Lovely,0,0,0,Pete Lovely
289,404,32,1959,Graham Hill,Innes Ireland,0,5,5,Innes Ireland
289,502,32,1959,Graham Hill,Alan Stacey,0,0,0,Alan Stacey
289,506,32,1959,Graham Hill,Bruce Halford,0,0,0,Bruce Halford
289,542,32,1959,Graham Hill,David Piper,0,0,0,David Piper
289,571,32,1959,Graham Hill,Dennis Taylor,0,0,0,Dennis Taylor
353,404,32,1959,Pete Lovely,Innes Ireland,0,5,5,Innes Ireland
353,502,32,1959,Pete Lovely,Alan Stacey,0,0,0,Alan Stacey
353,506,32,1959,Pete Lovely,Bruce Halford,0,0,0,Bruce Halford
353,542,32,1959,Pete Lovely,David Piper,0,0,0,David Piper
353,571,32,1959,Pete Lovely,Dennis Taylor,0,0,0,Dennis Taylor
404,502,32,1959,Innes Ireland,Alan Stacey,5,0,5,Innes Ireland
404,506,32,1959,Innes Ireland,Bruce Halford,5,0,5,Innes Ireland
404,542,32,1959,Innes Ireland,David Piper,5,0,5,Innes Ireland
404,571,32,1959,Innes Ireland,Dennis Taylor,5,0,5,Innes Ireland
502,506,32,1959,Alan Stacey,Bruce Halford,0,0,0,Bruce Halford
502,542,32,1959,Alan Stacey,David Piper,0,0,0,David Piper
502,571,32,1959,Alan Stacey,Dennis Taylor,0,0,0,Dennis Taylor
506,542,32,1959,Bruce Halford,David Piper,0,0,0,David Piper
506,571,32,1959,Bruce Halford,Dennis Taylor,0,0,0,Dennis Taylor
542,571,32,1959,David Piper,Dennis Taylor,0,0,0,Dennis Taylor
341,373,32,1960,John Surtees,Jim Clark,6,8,2,Jim Clark
341,404,32,1960,John Surtees,Innes Ireland,6,18,12,Innes Ireland
341,440,32,1960,John Surtees,Jim Hall,6,0,6,John Surtees
341,475,32,1960,John Surtees,Stirling Moss,6,19,13,Stirling Moss
341,497,32,1960,John Surtees,Alberto Rodriguez Larreta,6,0,6,John Surtees
341,502,32,1960,John Surtees,Alan Stacey,6,0,6,John Surtees
341,540,32,1960,John Surtees,Mike Taylor,6,0,6,John Surtees
341,541,32,1960,John Surtees,Ron Flockhart,6,1,5,John Surtees
341,542,32,1960,John Surtees,David Piper,6,0,6,John Surtees
373,404,32,1960,Jim Clark,Innes Ireland,8,18,10,Innes Ireland
373,440,32,1960,Jim Clark,Jim Hall,8,0,8,Jim Clark
373,475,32,1960,Jim Clark,Stirling Moss,8,19,11,Stirling Moss
373,497,32,1960,Jim Clark,Alberto Rodriguez Larreta,8,0,8,Jim Clark
373,502,32,1960,Jim Clark,Alan Stacey,8,0,8,Jim Clark
373,540,32,1960,Jim Clark,Mike Taylor,8,0,8,Jim Clark
373,541,32,1960,Jim Clark,Ron Flockhart,8,1,7,Jim Clark
373,542,32,1960,Jim Clark,David Piper,8,0,8,Jim Clark
404,440,32,1960,Innes Ireland,Jim Hall,18,0,18,Innes Ireland
404,475,32,1960,Innes Ireland,Stirling Moss,18,19,1,Stirling Moss
404,497,32,1960,Innes Ireland,Alberto Rodriguez Larreta,18,0,18,Innes Ireland
404,502,32,1960,Innes Ireland,Alan Stacey,18,0,18,Innes Ireland
404,540,32,1960,Innes Ireland,Mike Taylor,18,0,18,Innes Ireland
404,541,32,1960,Innes Ireland,Ron Flockhart,18,1,17,Innes Ireland
404,542,32,1960,Innes Ireland,David Piper,18,0,18,Innes Ireland
440,475,32,1960,Jim Hall,Stirling Moss,0,19,19,Stirling Moss
440,497,32,1960,Jim Hall,Alberto Rodriguez Larreta,0,0,0,Alberto Rodriguez Larreta
440,502,32,1960,Jim Hall,Alan Stacey,0,0,0,Alan Stacey
440,540,32,1960,Jim Hall,Mike Taylor,0,0,0,Mike Taylor
440,541,32,1960,Jim Hall,Ron Flockhart,0,1,1,Ron Flockhart
440,542,32,1960,Jim Hall,David Piper,0,0,0,David Piper
475,497,32,1960,Stirling Moss,Alberto Rodriguez Larreta,19,0,19,Stirling Moss
475,502,32,1960,Stirling Moss,Alan Stacey,19,0,19,Stirling Moss
475,540,32,1960,Stirling Moss,Mike Taylor,19,0,19,Stirling Moss
475,541,32,1960,Stirling Moss,Ron Flockhart,19,1,18,Stirling Moss
475,542,32,1960,Stirling Moss,David Piper,19,0,19,Stirling Moss
497,502,32,1960,Alberto Rodriguez Larreta,Alan Stacey,0,0,0,Alan Stacey
497,540,32,1960,Alberto Rodriguez Larreta,Mike Taylor,0,0,0,Mike Taylor
497,541,32,1960,Alberto Rodriguez Larreta,Ron Flockhart,0,1,1,Ron Flockhart
497,542,32,1960,Alberto Rodriguez Larreta,David Piper,0,0,0,David Piper
502,540,32,1960,Alan Stacey,Mike Taylor,0,0,0,Mike Taylor
502,541,32,1960,Alan Stacey,Ron Flockhart,0,1,1,Ron Flockhart
502,542,32,1960,Alan Stacey,David Piper,0,0,0,David Piper
540,541,32,1960,Mike Taylor,Ron Flockhart,0,1,1,Ron Flockhart
540,542,32,1960,Mike Taylor,David Piper,0,0,0,David Piper
541,542,32,1960,Ron Flockhart,David Piper,1,0,1,Ron Flockhart
224,289,32,1970,Emerson Fittipaldi,Graham Hill,12,7,5,Emerson Fittipaldi
224,293,32,1970,Emerson Fittipaldi,Dave Charlton,12,0,12,Emerson Fittipaldi
224,317,32,1970,Emerson Fittipaldi,Reine Wisell,12,4,8,Emerson Fittipaldi
224,339,32,1970,Emerson Fittipaldi,Alex Soler-Roig,12,0,12,Emerson Fittipaldi
224,340,32,1970,Emerson Fittipaldi,John Love,12,0,12,Emerson Fittipaldi
224,353,32,1970,Emerson Fittipaldi,Pete Lovely,12,0,12,Emerson Fittipaldi
224,357,32,1970,Emerson Fittipaldi,John Miles,12,2,10,Emerson Fittipaldi
224,358,32,1970,Emerson Fittipaldi,Jochen Rindt,12,45,33,Jochen Rindt
289,293,32,1970,Graham Hill,Dave Charlton,7,0,7,Graham Hill
289,317,32,1970,Graham Hill,Reine Wisell,7,4,3,Graham Hill
289,339,32,1970,Graham Hill,Alex Soler-Roig,7,0,7,Graham Hill
289,340,32,1970,Graham Hill,John Love,7,0,7,Graham Hill
289,353,32,1970,Graham Hill,Pete Lovely,7,0,7,Graham Hill
289,357,32,1970,Graham Hill,John Miles,7,2,5,Graham Hill
289,358,32,1970,Graham Hill,Jochen Rindt,7,45,38,Jochen Rindt
293,317,32,1970,Dave Charlton,Reine Wisell,0,4,4,Reine Wisell
293,339,32,1970,Dave Charlton,Alex Soler-Roig,0,0,0,Alex Soler-Roig
293,340,32,1970,Dave Charlton,John Love,0,0,0,John Love
293,353,32,1970,Dave Charlton,Pete Lovely,0,0,0,Pete Lovely
293,357,32,1970,Dave Charlton,John Miles,0,2,2,John Miles
293,358,32,1970,Dave Charlton,Jochen Rindt,0,45,45,Jochen Rindt
317,339,32,1970,Reine Wisell,Alex Soler-Roig,4,0,4,Reine Wisell
317,340,32,1970,Reine Wisell,John Love,4,0,4,Reine Wisell
317,353,32,1970,Reine Wisell,Pete Lovely,4,0,4,Reine Wisell
317,357,32,1970,Reine Wisell,John Miles,4,2,2,Reine Wisell
317,358,32,1970,Reine Wisell,Jochen Rindt,4,45,41,Jochen Rindt
339,340,32,1970,Alex Soler-Roig,John Love,0,0,0,John Love
339,353,32,1970,Alex Soler-Roig,Pete Lovely,0,0,0,Pete Lovely
339,357,32,1970,Alex Soler-Roig,John Miles,0,2,2,John Miles
339,358,32,1970,Alex Soler-Roig,Jochen Rindt,0,45,45,Jochen Rindt
340,353,32,1970,John Love,Pete Lovely,0,0,0,Pete Lovely
340,357,32,1970,John Love,John Miles,0,2,2,John Miles
340,358,32,1970,John Love,Jochen Rindt,0,45,45,Jochen Rindt
353,357,32,1970,Pete Lovely,John Miles,0,2,2,John Miles
353,358,32,1970,Pete Lovely,Jochen Rindt,0,45,45,Jochen Rindt
357,358,32,1970,John Miles,Jochen Rindt,2,45,43,Jochen Rindt
224,293,32,1972,Emerson Fittipaldi,Dave Charlton,61,0,61,Emerson Fittipaldi
224,317,32,1972,Emerson Fittipaldi,Reine Wisell,61,0,61,Emerson Fittipaldi
224,338,32,1972,Emerson Fittipaldi,David Walker,61,0,61,Emerson Fittipaldi
293,317,32,1972,Dave Charlton,Reine Wisell,0,0,0,Reine Wisell
293,338,32,1972,Dave Charlton,David Walker,0,0,0,David Walker
317,338,32,1972,Reine Wisell,David Walker,0,0,0,David Walker
224,238,32,1973,Emerson Fittipaldi,Ronnie Peterson,55,52,3,Emerson Fittipaldi
224,293,32,1973,Emerson Fittipaldi,Dave Charlton,55,0,55,Emerson Fittipaldi
238,293,32,1973,Ronnie Peterson,Dave Charlton,52,0,52,Ronnie Peterson
235,238,32,1974,Jacky Ickx,Ronnie Peterson,12,35,23,Ronnie Peterson
235,251,32,1974,Jacky Ickx,Ian Scheckter,12,0,12,Jacky Ickx
235,310,32,1974,Jacky Ickx,Paddy Driver,12,0,12,Jacky Ickx
235,314,32,1974,Jacky Ickx,Tim Schenken,12,0,12,Jacky Ickx
238,251,32,1974,Ronnie Peterson,Ian Scheckter,35,0,35,Ronnie Peterson
238,310,32,1974,Ronnie Peterson,Paddy Driver,35,0,35,Ronnie Peterson
238,314,32,1974,Ronnie Peterson,Tim Schenken,35,0,35,Ronnie Peterson
251,310,32,1974,Ian Scheckter,Paddy Driver,0,0,0,Paddy Driver
251,314,32,1974,Ian Scheckter,Tim Schenken,0,0,0,Tim Schenken
310,314,32,1974,Paddy Driver,Tim Schenken,0,0,0,Tim Schenken
187,205,32,1975,John Watson,Brian Henton,0,0,0,Brian Henton
187,235,32,1975,John Watson,Jacky Ickx,0,3,3,Jacky Ickx
187,238,32,1975,John Watson,Ronnie Peterson,0,6,6,Ronnie Peterson
187,291,32,1975,John Watson,Guy Tunmer,0,0,0,Guy Tunmer
187,292,32,1975,John Watson,Eddie Keizan,0,0,0,Eddie Keizan
187,302,32,1975,John Watson,Jim Crawford,0,0,0,Jim Crawford
205,235,32,1975,Brian Henton,Jacky Ickx,0,3,3,Jacky Ickx
205,238,32,1975,Brian Henton,Ronnie Peterson,0,6,6,Ronnie Peterson
205,291,32,1975,Brian Henton,Guy Tunmer,0,0,0,Guy Tunmer
205,292,32,1975,Brian Henton,Eddie Keizan,0,0,0,Eddie Keizan
205,302,32,1975,Brian Henton,Jim Crawford,0,0,0,Jim Crawford
235,238,32,1975,Jacky Ickx,Ronnie Peterson,3,6,3,Ronnie Peterson
235,291,32,1975,Jacky Ickx,Guy Tunmer,3,0,3,Jacky Ickx
235,292,32,1975,Jacky Ickx,Eddie Keizan,3,0,3,Jacky Ickx
235,302,32,1975,Jacky Ickx,Jim Crawford,3,0,3,Jacky Ickx
238,291,32,1975,Ronnie Peterson,Guy Tunmer,6,0,6,Ronnie Peterson
238,292,32,1975,Ronnie Peterson,Eddie Keizan,6,0,6,Ronnie Peterson
238,302,32,1975,Ronnie Peterson,Jim Crawford,6,0,6,Ronnie Peterson
291,292,32,1975,Guy Tunmer,Eddie Keizan,0,0,0,Eddie Keizan
291,302,32,1975,Guy Tunmer,Jim Crawford,0,0,0,Jim Crawford
292,302,32,1975,Eddie Keizan,Jim Crawford,0,0,0,Jim Crawford
207,238,32,1976,Mario Andretti,Ronnie Peterson,21,0,21,Mario Andretti
207,255,32,1976,Mario Andretti,Gunnar Nilsson,21,11,10,Mario Andretti
207,276,32,1976,Mario Andretti,Bob Evans,21,0,21,Mario Andretti
238,255,32,1976,Ronnie Peterson,Gunnar Nilsson,0,11,11,Gunnar Nilsson
238,276,32,1976,Ronnie Peterson,Bob Evans,0,0,0,Bob Evans
255,276,32,1976,Gunnar Nilsson,Bob Evans,11,0,11,Gunnar Nilsson
207,255,32,1977,Mario Andretti,Gunnar Nilsson,47,20,27,Mario Andretti
197,207,32,1978,Jean-Pierre Jarier,Mario Andretti,0,64,64,Mario Andretti
197,212,32,1978,Jean-Pierre Jarier,Hector Rebaque,0,1,1,Hector Rebaque
197,238,32,1978,Jean-Pierre Jarier,Ronnie Peterson,0,51,51,Ronnie Peterson
207,212,32,1978,Mario Andretti,Hector Rebaque,64,1,63,Mario Andretti
207,238,32,1978,Mario Andretti,Ronnie Peterson,64,51,13,Mario Andretti
212,238,32,1978,Hector Rebaque,Ronnie Peterson,1,51,50,Ronnie Peterson
199,207,32,1979,Carlos Reutemann,Mario Andretti,25,14,11,Carlos Reutemann
199,212,32,1979,Carlos Reutemann,Hector Rebaque,25,0,25,Carlos Reutemann
207,212,32,1979,Mario Andretti,Hector Rebaque,14,0,14,Mario Andretti
173,207,32,1980,Elio de Angelis,Mario Andretti,13,1,12,Elio de Angelis
173,95,32,1980,Elio de Angelis,Nigel Mansell,13,0,13,Elio de Angelis
207,95,32,1980,Mario Andretti,Nigel Mansell,1,0,1,Mario Andretti
173,95,32,1981,Elio de Angelis,Nigel Mansell,14,8,6,Elio de Angelis
173,209,32,1982,Elio de Angelis,Geoff Lees,23,0,23,Elio de Angelis
173,90,32,1982,Elio de Angelis,Roberto Moreno,23,0,23,Elio de Angelis
173,95,32,1982,Elio de Angelis,Nigel Mansell,23,7,16,Elio de Angelis
209,90,32,1982,Geoff Lees,Roberto Moreno,0,0,0,Roberto Moreno
209,95,32,1982,Geoff Lees,Nigel Mansell,0,7,7,Nigel Mansell
90,95,32,1982,Roberto Moreno,Nigel Mansell,0,7,7,Nigel Mansell
173,95,32,1983,Elio de Angelis,Nigel Mansell,2,10,8,Nigel Mansell
173,95,32,1984,Elio de Angelis,Nigel Mansell,34,13,21,Elio de Angelis
102,173,32,1985,Ayrton Senna,Elio de Angelis,38,33,5,Ayrton Senna
102,174,32,1986,Ayrton Senna,Johnny Dumfries,55,3,52,Ayrton Senna
102,138,32,1987,Ayrton Senna,Satoru Nakajima,57,7,50,Ayrton Senna
137,138,32,1988,Nelson Piquet,Satoru Nakajima,22,1,21,Nelson Piquet
137,138,32,1989,Nelson Piquet,Satoru Nakajima,12,3,9,Nelson Piquet
118,151,32,1990,Derek Warwick,Martin Donnelly,3,0,3,Derek Warwick
118,65,32,1990,Derek Warwick,Johnny Herbert,3,0,3,Derek Warwick
151,65,32,1990,Martin Donnelly,Johnny Herbert,0,0,0,Johnny Herbert
141,143,32,1991,Julian Bailey,Michael Bartels,1,0,1,Julian Bailey
141,57,32,1991,Julian Bailey,Mika HÃ¤kkinen,1,2,1,Mika HÃ¤kkinen
141,65,32,1991,Julian Bailey,Johnny Herbert,1,0,1,Julian Bailey
143,57,32,1991,Michael Bartels,Mika HÃ¤kkinen,0,2,2,Mika HÃ¤kkinen
143,65,32,1991,Michael Bartels,Johnny Herbert,0,0,0,Johnny Herbert
57,65,32,1991,Mika HÃ¤kkinen,Johnny Herbert,2,0,2,Mika HÃ¤kkinen
57,65,32,1992,Mika HÃ¤kkinen,Johnny Herbert,11,2,9,Mika HÃ¤kkinen
65,70,32,1993,Johnny Herbert,Alessandro Zanardi,11,1,10,Johnny Herbert
65,83,32,1993,Johnny Herbert,Pedro Lamy,11,0,11,Johnny Herbert
70,83,32,1993,Alessandro Zanardi,Pedro Lamy,1,0,1,Alessandro Zanardi
103,113,32,1994,Ã‰ric Bernard,Philippe Adams,0,0,0,Philippe Adams
103,63,32,1994,Ã‰ric Bernard,Mika Salo,0,0,0,Mika Salo
103,65,32,1994,Ã‰ric Bernard,Johnny Herbert,0,0,0,Johnny Herbert
103,70,32,1994,Ã‰ric Bernard,Alessandro Zanardi,0,0,0,Alessandro Zanardi
103,83,32,1994,Ã‰ric Bernard,Pedro Lamy,0,0,0,Pedro Lamy
113,63,32,1994,Philippe Adams,Mika Salo,0,0,0,Mika Salo
113,65,32,1994,Philippe Adams,Johnny Herbert,0,0,0,Johnny Herbert
113,70,32,1994,Philippe Adams,Alessandro Zanardi,0,0,0,Alessandro Zanardi
113,83,32,1994,Philippe Adams,Pedro Lamy,0,0,0,Pedro Lamy
63,65,32,1994,Mika Salo,Johnny Herbert,0,0,0,Johnny Herbert
63,70,32,1994,Mika Salo,Alessandro Zanardi,0,0,0,Alessandro Zanardi
63,83,32,1994,Mika Salo,Pedro Lamy,0,0,0,Pedro Lamy
65,70,32,1994,Johnny Herbert,Alessandro Zanardi,0,0,0,Alessandro Zanardi
65,83,32,1994,Johnny Herbert,Pedro Lamy,0,0,0,Pedro Lamy
70,83,32,1994,Alessandro Zanardi,Pedro Lamy,0,0,0,Pedro Lamy
112,114,33,1987,Philippe Alliot,Yannick Dalmas,3,0,3,Philippe Alliot
112,114,33,1988,Philippe Alliot,Yannick Dalmas,0,0,0,Yannick Dalmas
112,162,33,1988,Philippe Alliot,Pierre-Henri Raphanel,0,0,0,Pierre-Henri Raphanel
112,88,33,1988,Philippe Alliot,Aguri Suzuki,0,0,0,Aguri Suzuki
114,162,33,1988,Yannick Dalmas,Pierre-Henri Raphanel,0,0,0,Pierre-Henri Raphanel
114,88,33,1988,Yannick Dalmas,Aguri Suzuki,0,0,0,Aguri Suzuki
162,88,33,1988,Pierre-Henri Raphanel,Aguri Suzuki,0,0,0,Aguri Suzuki
103,105,33,1989,Ã‰ric Bernard,Michele Alboreto,0,0,0,Michele Alboreto
103,112,33,1989,Ã‰ric Bernard,Philippe Alliot,0,1,1,Philippe Alliot
103,114,33,1989,Ã‰ric Bernard,Yannick Dalmas,0,0,0,Yannick Dalmas
105,112,33,1989,Michele Alboreto,Philippe Alliot,0,1,1,Philippe Alliot
105,114,33,1989,Michele Alboreto,Yannick Dalmas,0,0,0,Yannick Dalmas
112,114,33,1989,Philippe Alliot,Yannick Dalmas,1,0,1,Philippe Alliot
103,88,33,1990,Ã‰ric Bernard,Aguri Suzuki,5,6,1,Aguri Suzuki
103,88,33,1991,Ã‰ric Bernard,Aguri Suzuki,0,1,1,Aguri Suzuki
103,92,33,1991,Ã‰ric Bernard,Bertrand Gachot,0,0,0,Bertrand Gachot
88,92,33,1991,Aguri Suzuki,Bertrand Gachot,1,0,1,Aguri Suzuki
79,92,33,1992,Ukyo Katayama,Bertrand Gachot,0,1,1,Bertrand Gachot
100,112,33,1993,Ã‰rik Comas,Philippe Alliot,1,2,1,Philippe Alliot
100,126,33,1993,Ã‰rik Comas,Toshio Suzuki,1,0,1,Ã‰rik Comas
112,126,33,1993,Philippe Alliot,Toshio Suzuki,2,0,2,Philippe Alliot
100,106,33,1994,Ã‰rik Comas,Olivier Beretta,2,0,2,Ã‰rik Comas
100,112,33,1994,Ã‰rik Comas,Philippe Alliot,2,0,2,Ã‰rik Comas
100,114,33,1994,Ã‰rik Comas,Yannick Dalmas,2,0,2,Ã‰rik Comas
100,115,33,1994,Ã‰rik Comas,Hideki Noda,2,0,2,Ã‰rik Comas
100,98,33,1994,Ã‰rik Comas,Jean-Denis DÃ©lÃ©traz,2,0,2,Ã‰rik Comas
106,112,33,1994,Olivier Beretta,Philippe Alliot,0,0,0,Philippe Alliot
106,114,33,1994,Olivier Beretta,Yannick Dalmas,0,0,0,Yannick Dalmas
106,115,33,1994,Olivier Beretta,Hideki Noda,0,0,0,Hideki Noda
106,98,33,1994,Olivier Beretta,Jean-Denis DÃ©lÃ©traz,0,0,0,Jean-Denis DÃ©lÃ©traz
112,114,33,1994,Philippe Alliot,Yannick Dalmas,0,0,0,Yannick Dalmas
112,115,33,1994,Philippe Alliot,Hideki Noda,0,0,0,Hideki Noda
112,98,33,1994,Philippe Alliot,Jean-Denis DÃ©lÃ©traz,0,0,0,Jean-Denis DÃ©lÃ©traz
114,115,33,1994,Yannick Dalmas,Hideki Noda,0,0,0,Hideki Noda
114,98,33,1994,Yannick Dalmas,Jean-Denis DÃ©lÃ©traz,0,0,0,Jean-Denis DÃ©lÃ©traz
115,98,33,1994,Hideki Noda,Jean-Denis DÃ©lÃ©traz,0,0,0,Jean-Denis DÃ©lÃ©traz
356,364,34,1963,Jack Brabham,Dan Gurney,14,19,5,Dan Gurney
356,407,34,1963,Jack Brabham,David Prophet,14,0,14,Jack Brabham
364,407,34,1963,Dan Gurney,David Prophet,19,0,19,Dan Gurney
243,321,34,1970,Rolf Stommelen,Derek Bell,10,0,10,Rolf Stommelen
243,356,34,1970,Rolf Stommelen,Jack Brabham,10,25,15,Jack Brabham
243,362,34,1970,Rolf Stommelen,Peter de Klerk,10,0,10,Rolf Stommelen
243,366,34,1970,Rolf Stommelen,Gus Hutchison,10,0,10,Rolf Stommelen
321,356,34,1970,Derek Bell,Jack Brabham,0,25,25,Jack Brabham
321,362,34,1970,Derek Bell,Peter de Klerk,0,0,0,Peter de Klerk
321,366,34,1970,Derek Bell,Gus Hutchison,0,0,0,Gus Hutchison
356,362,34,1970,Jack Brabham,Peter de Klerk,25,0,25,Jack Brabham
356,366,34,1970,Jack Brabham,Gus Hutchison,25,0,25,Jack Brabham
362,366,34,1970,Peter de Klerk,Gus Hutchison,0,0,0,Gus Hutchison
289,293,34,1971,Graham Hill,Dave Charlton,2,0,2,Graham Hill
289,314,34,1971,Graham Hill,Tim Schenken,2,5,3,Tim Schenken
289,334,34,1971,Graham Hill,Jackie Pretorius,2,0,2,Graham Hill
289,354,34,1971,Graham Hill,Chris Craft,2,0,2,Graham Hill
293,314,34,1971,Dave Charlton,Tim Schenken,0,5,5,Tim Schenken
293,334,34,1971,Dave Charlton,Jackie Pretorius,0,0,0,Jackie Pretorius
293,354,34,1971,Dave Charlton,Chris Craft,0,0,0,Chris Craft
314,334,34,1971,Tim Schenken,Jackie Pretorius,5,0,5,Tim Schenken
314,354,34,1971,Tim Schenken,Chris Craft,5,0,5,Tim Schenken
334,354,34,1971,Jackie Pretorius,Chris Craft,0,0,0,Chris Craft
199,289,34,1972,Carlos Reutemann,Graham Hill,3,4,1,Graham Hill
199,290,34,1972,Carlos Reutemann,Wilson Fittipaldi,3,0,3,Carlos Reutemann
289,290,34,1972,Graham Hill,Wilson Fittipaldi,4,0,4,Graham Hill
187,199,34,1973,John Watson,Carlos Reutemann,0,16,16,Carlos Reutemann
187,243,34,1973,John Watson,Rolf Stommelen,0,0,0,Rolf Stommelen
187,290,34,1973,John Watson,Wilson Fittipaldi,0,3,3,Wilson Fittipaldi
187,333,34,1973,John Watson,Andrea de Adamich,0,3,3,Andrea de Adamich
199,243,34,1973,Carlos Reutemann,Rolf Stommelen,16,0,16,Carlos Reutemann
199,290,34,1973,Carlos Reutemann,Wilson Fittipaldi,16,3,13,Carlos Reutemann
199,333,34,1973,Carlos Reutemann,Andrea de Adamich,16,3,13,Carlos Reutemann
243,290,34,1973,Rolf Stommelen,Wilson Fittipaldi,0,3,3,Wilson Fittipaldi
243,333,34,1973,Rolf Stommelen,Andrea de Adamich,0,3,3,Andrea de Adamich
290,333,34,1973,Wilson Fittipaldi,Andrea de Adamich,3,3,0,Andrea de Adamich
187,199,34,1974,John Watson,Carlos Reutemann,6,32,26,Carlos Reutemann
187,250,34,1974,John Watson,Carlos Pace,6,8,2,Carlos Pace
187,269,34,1974,John Watson,Teddy Pilette,6,0,6,John Watson
187,270,34,1974,John Watson,Ian Ashley,6,0,6,John Watson
187,275,34,1974,John Watson,Lella Lombardi,6,0,6,John Watson
187,308,34,1974,John Watson,Richard Robarts,6,0,6,John Watson
187,313,34,1974,John Watson,Rikky von Opel,6,0,6,John Watson
187,315,34,1974,John Watson,GÃ©rard Larrousse,6,0,6,John Watson
187,324,34,1974,John Watson,Helmuth Koinigg,6,0,6,John Watson
187,325,34,1974,John Watson,Carlo Facetti,6,0,6,John Watson
187,326,34,1974,John Watson,Eppie Wietzes,6,0,6,John Watson
199,250,34,1974,Carlos Reutemann,Carlos Pace,32,8,24,Carlos Reutemann
199,269,34,1974,Carlos Reutemann,Teddy Pilette,32,0,32,Carlos Reutemann
199,270,34,1974,Carlos Reutemann,Ian Ashley,32,0,32,Carlos Reutemann
199,275,34,1974,Carlos Reutemann,Lella Lombardi,32,0,32,Carlos Reutemann
199,308,34,1974,Carlos Reutemann,Richard Robarts,32,0,32,Carlos Reutemann
199,313,34,1974,Carlos Reutemann,Rikky von Opel,32,0,32,Carlos Reutemann
199,315,34,1974,Carlos Reutemann,GÃ©rard Larrousse,32,0,32,Carlos Reutemann
199,324,34,1974,Carlos Reutemann,Helmuth Koinigg,32,0,32,Carlos Reutemann
199,325,34,1974,Carlos Reutemann,Carlo Facetti,32,0,32,Carlos Reutemann
199,326,34,1974,Carlos Reutemann,Eppie Wietzes,32,0,32,Carlos Reutemann
250,269,34,1974,Carlos Pace,Teddy Pilette,8,0,8,Carlos Pace
250,270,34,1974,Carlos Pace,Ian Ashley,8,0,8,Carlos Pace
250,275,34,1974,Carlos Pace,Lella Lombardi,8,0,8,Carlos Pace
250,308,34,1974,Carlos Pace,Richard Robarts,8,0,8,Carlos Pace
250,313,34,1974,Carlos Pace,Rikky von Opel,8,0,8,Carlos Pace
250,315,34,1974,Carlos Pace,GÃ©rard Larrousse,8,0,8,Carlos Pace
250,324,34,1974,Carlos Pace,Helmuth Koinigg,8,0,8,Carlos Pace
250,325,34,1974,Carlos Pace,Carlo Facetti,8,0,8,Carlos Pace
250,326,34,1974,Carlos Pace,Eppie Wietzes,8,0,8,Carlos Pace
269,270,34,1974,Teddy Pilette,Ian Ashley,0,0,0,Ian Ashley
269,275,34,1974,Teddy Pilette,Lella Lombardi,0,0,0,Lella Lombardi
269,308,34,1974,Teddy Pilette,Richard Robarts,0,0,0,Richard Robarts
269,313,34,1974,Teddy Pilette,Rikky von Opel,0,0,0,Rikky von Opel
269,315,34,1974,Teddy Pilette,GÃ©rard Larrousse,0,0,0,GÃ©rard Larrousse
269,324,34,1974,Teddy Pilette,Helmuth Koinigg,0,0,0,Helmuth Koinigg
269,325,34,1974,Teddy Pilette,Carlo Facetti,0,0,0,Carlo Facetti
269,326,34,1974,Teddy Pilette,Eppie Wietzes,0,0,0,Eppie Wietzes
270,275,34,1974,Ian Ashley,Lella Lombardi,0,0,0,Lella Lombardi
270,308,34,1974,Ian Ashley,Richard Robarts,0,0,0,Richard Robarts
270,313,34,1974,Ian Ashley,Rikky von Opel,0,0,0,Rikky von Opel
270,315,34,1974,Ian Ashley,GÃ©rard Larrousse,0,0,0,GÃ©rard Larrousse
270,324,34,1974,Ian Ashley,Helmuth Koinigg,0,0,0,Helmuth Koinigg
270,325,34,1974,Ian Ashley,Carlo Facetti,0,0,0,Carlo Facetti
270,326,34,1974,Ian Ashley,Eppie Wietzes,0,0,0,Eppie Wietzes
275,308,34,1974,Lella Lombardi,Richard Robarts,0,0,0,Richard Robarts
275,313,34,1974,Lella Lombardi,Rikky von Opel,0,0,0,Rikky von Opel
275,315,34,1974,Lella Lombardi,GÃ©rard Larrousse,0,0,0,GÃ©rard Larrousse
275,324,34,1974,Lella Lombardi,Helmuth Koinigg,0,0,0,Helmuth Koinigg
275,325,34,1974,Lella Lombardi,Carlo Facetti,0,0,0,Carlo Facetti
275,326,34,1974,Lella Lombardi,Eppie Wietzes,0,0,0,Eppie Wietzes
308,313,34,1974,Richard Robarts,Rikky von Opel,0,0,0,Rikky von Opel
308,315,34,1974,Richard Robarts,GÃ©rard Larrousse,0,0,0,GÃ©rard Larrousse
308,324,34,1974,Richard Robarts,Helmuth Koinigg,0,0,0,Helmuth Koinigg
308,325,34,1974,Richard Robarts,Carlo Facetti,0,0,0,Carlo Facetti
308,326,34,1974,Richard Robarts,Eppie Wietzes,0,0,0,Eppie Wietzes
313,315,34,1974,Rikky von Opel,GÃ©rard Larrousse,0,0,0,GÃ©rard Larrousse
313,324,34,1974,Rikky von Opel,Helmuth Koinigg,0,0,0,Helmuth Koinigg
313,325,34,1974,Rikky von Opel,Carlo Facetti,0,0,0,Carlo Facetti
313,326,34,1974,Rikky von Opel,Eppie Wietzes,0,0,0,Eppie Wietzes
315,324,34,1974,GÃ©rard Larrousse,Helmuth Koinigg,0,0,0,Helmuth Koinigg
315,325,34,1974,GÃ©rard Larrousse,Carlo Facetti,0,0,0,Carlo Facetti
315,326,34,1974,GÃ©rard Larrousse,Eppie Wietzes,0,0,0,Eppie Wietzes
324,325,34,1974,Helmuth Koinigg,Carlo Facetti,0,0,0,Carlo Facetti
324,326,34,1974,Helmuth Koinigg,Eppie Wietzes,0,0,0,Eppie Wietzes
325,326,34,1974,Carlo Facetti,Eppie Wietzes,0,0,0,Eppie Wietzes
199,250,34,1975,Carlos Reutemann,Carlos Pace,37,24,13,Carlos Reutemann
187,220,34,1977,John Watson,Giorgio Francia,9,0,9,John Watson
187,233,34,1977,John Watson,Hans-Joachim Stuck,9,12,3,Hans-Joachim Stuck
187,250,34,1977,John Watson,Carlos Pace,9,6,3,John Watson
220,233,34,1977,Giorgio Francia,Hans-Joachim Stuck,0,12,12,Hans-Joachim Stuck
220,250,34,1977,Giorgio Francia,Carlos Pace,0,6,6,Carlos Pace
233,250,34,1977,Hans-Joachim Stuck,Carlos Pace,12,6,6,Hans-Joachim Stuck
137,182,34,1978,Nelson Piquet,Niki Lauda,0,44,44,Niki Lauda
137,187,34,1978,Nelson Piquet,John Watson,0,25,25,John Watson
182,187,34,1978,Niki Lauda,John Watson,44,25,19,Niki Lauda
137,212,34,1980,Nelson Piquet,Hector Rebaque,54,1,53,Nelson Piquet
137,217,34,1980,Nelson Piquet,Ricardo Zunino,54,0,54,Nelson Piquet
212,217,34,1980,Hector Rebaque,Ricardo Zunino,1,0,1,Hector Rebaque
137,212,34,1981,Nelson Piquet,Hector Rebaque,50,11,39,Nelson Piquet
119,137,34,1982,Riccardo Patrese,Nelson Piquet,21,20,1,Riccardo Patrese
119,137,34,1983,Riccardo Patrese,Nelson Piquet,13,59,46,Nelson Piquet
137,170,34,1984,Nelson Piquet,Teo Fabi,29,9,20,Nelson Piquet
137,181,34,1984,Nelson Piquet,Manfred Winkelhock,29,0,29,Nelson Piquet
137,190,34,1984,Nelson Piquet,Corrado Fabi,29,0,29,Nelson Piquet
170,181,34,1984,Teo Fabi,Manfred Winkelhock,9,0,9,Teo Fabi
170,190,34,1984,Teo Fabi,Corrado Fabi,9,0,9,Teo Fabi
181,190,34,1984,Manfred Winkelhock,Corrado Fabi,0,0,0,Corrado Fabi
137,176,34,1985,Nelson Piquet,Marc Surer,21,5,16,Nelson Piquet
137,183,34,1985,Nelson Piquet,FranÃ§ois Hesnault,21,0,21,Nelson Piquet
176,183,34,1985,Marc Surer,FranÃ§ois Hesnault,5,0,5,Marc Surer
118,119,34,1986,Derek Warwick,Riccardo Patrese,0,2,2,Riccardo Patrese
118,173,34,1986,Derek Warwick,Elio de Angelis,0,0,0,Elio de Angelis
119,173,34,1986,Riccardo Patrese,Elio de Angelis,2,0,2,Riccardo Patrese
110,119,34,1987,Andrea de Cesaris,Riccardo Patrese,4,6,2,Riccardo Patrese
110,131,34,1987,Andrea de Cesaris,Stefano Modena,4,0,4,Andrea de Cesaris
119,131,34,1987,Riccardo Patrese,Stefano Modena,6,0,6,Riccardo Patrese
131,84,34,1989,Stefano Modena,Martin Brundle,4,4,0,Martin Brundle
101,131,34,1990,David Brabham,Stefano Modena,0,2,2,Stefano Modena
101,148,34,1990,David Brabham,Gregor Foitek,0,0,0,Gregor Foitek
131,148,34,1990,Stefano Modena,Gregor Foitek,2,0,2,Stefano Modena
84,87,34,1991,Martin Brundle,Mark Blundell,2,1,1,Martin Brundle
128,132,34,1992,Eric van de Poele,Giovanna Amati,0,0,0,Giovanna Amati
128,71,34,1992,Eric van de Poele,Damon Hill,0,0,0,Damon Hill
132,71,34,1992,Giovanna Amati,Damon Hill,0,0,0,Damon Hill
110,133,35,1989,Andrea de Cesaris,Alex Caffi,4,4,0,Alex Caffi
110,139,35,1990,Andrea de Cesaris,Emanuele Pirro,0,0,0,Emanuele Pirro
110,81,35,1990,Andrea de Cesaris,Gianni Morbidelli,0,0,0,Gianni Morbidelli
139,81,35,1990,Emanuele Pirro,Gianni Morbidelli,0,0,0,Gianni Morbidelli
109,139,35,1991,Jyrki JÃ¤rvilehto,Emanuele Pirro,4,1,3,Jyrki JÃ¤rvilehto
109,94,35,1992,Jyrki JÃ¤rvilehto,Pierluigi Martini,0,2,2,Pierluigi Martini
129,99,36,1991,Olivier Grouillard,Gabriele Tarquini,0,0,0,Gabriele Tarquini
128,130,36,1992,Eric van de Poele,Andrea Chiesa,0,0,0,Andrea Chiesa
128,99,36,1992,Eric van de Poele,Gabriele Tarquini,0,0,0,Gabriele Tarquini
130,99,36,1992,Andrea Chiesa,Gabriele Tarquini,0,0,0,Gabriele Tarquini
207,238,37,1970,Mario Andretti,Ronnie Peterson,4,0,4,Mario Andretti
207,278,37,1970,Mario Andretti,Chris Amon,4,23,19,Chris Amon
207,327,37,1970,Mario Andretti,FranÃ§ois Cevert,4,1,3,Mario Andretti
207,328,37,1970,Mario Andretti,Jackie Stewart,4,25,21,Jackie Stewart
207,346,37,1970,Mario Andretti,Jo Siffert,4,0,4,Mario Andretti
207,359,37,1970,Mario Andretti,Johnny Servoz-Gavin,4,2,2,Mario Andretti
207,365,37,1970,Mario Andretti,Hubert Hahne,4,0,4,Mario Andretti
238,278,37,1970,Ronnie Peterson,Chris Amon,0,23,23,Chris Amon
238,327,37,1970,Ronnie Peterson,FranÃ§ois Cevert,0,1,1,FranÃ§ois Cevert
238,328,37,1970,Ronnie Peterson,Jackie Stewart,0,25,25,Jackie Stewart
238,346,37,1970,Ronnie Peterson,Jo Siffert,0,0,0,Jo Siffert
238,359,37,1970,Ronnie Peterson,Johnny Servoz-Gavin,0,2,2,Johnny Servoz-Gavin
238,365,37,1970,Ronnie Peterson,Hubert Hahne,0,0,0,Hubert Hahne
278,327,37,1970,Chris Amon,FranÃ§ois Cevert,23,1,22,Chris Amon
278,328,37,1970,Chris Amon,Jackie Stewart,23,25,2,Jackie Stewart
278,346,37,1970,Chris Amon,Jo Siffert,23,0,23,Chris Amon
278,359,37,1970,Chris Amon,Johnny Servoz-Gavin,23,2,21,Chris Amon
278,365,37,1970,Chris Amon,Hubert Hahne,23,0,23,Chris Amon
327,328,37,1970,FranÃ§ois Cevert,Jackie Stewart,1,25,24,Jackie Stewart
327,346,37,1970,FranÃ§ois Cevert,Jo Siffert,1,0,1,FranÃ§ois Cevert
327,359,37,1970,FranÃ§ois Cevert,Johnny Servoz-Gavin,1,2,1,Johnny Servoz-Gavin
327,365,37,1970,FranÃ§ois Cevert,Hubert Hahne,1,0,1,FranÃ§ois Cevert
328,346,37,1970,Jackie Stewart,Jo Siffert,25,0,25,Jackie Stewart
328,359,37,1970,Jackie Stewart,Johnny Servoz-Gavin,25,2,23,Jackie Stewart
328,365,37,1970,Jackie Stewart,Hubert Hahne,25,0,25,Jackie Stewart
346,359,37,1970,Jo Siffert,Johnny Servoz-Gavin,0,2,2,Johnny Servoz-Gavin
346,365,37,1970,Jo Siffert,Hubert Hahne,0,0,0,Hubert Hahne
359,365,37,1970,Johnny Servoz-Gavin,Hubert Hahne,2,0,2,Johnny Servoz-Gavin
182,238,37,1972,Niki Lauda,Ronnie Peterson,0,12,12,Ronnie Peterson
182,243,37,1972,Niki Lauda,Rolf Stommelen,0,0,0,Rolf Stommelen
182,250,37,1972,Niki Lauda,Carlos Pace,0,3,3,Carlos Pace
182,280,37,1972,Niki Lauda,Henri Pescarolo,0,0,0,Henri Pescarolo
182,329,37,1972,Niki Lauda,Mike Beuttler,0,0,0,Mike Beuttler
182,342,37,1972,Niki Lauda,Skip Barber,0,0,0,Skip Barber
238,243,37,1972,Ronnie Peterson,Rolf Stommelen,12,0,12,Ronnie Peterson
238,250,37,1972,Ronnie Peterson,Carlos Pace,12,3,9,Ronnie Peterson
238,280,37,1972,Ronnie Peterson,Henri Pescarolo,12,0,12,Ronnie Peterson
238,329,37,1972,Ronnie Peterson,Mike Beuttler,12,0,12,Ronnie Peterson
238,342,37,1972,Ronnie Peterson,Skip Barber,12,0,12,Ronnie Peterson
243,250,37,1972,Rolf Stommelen,Carlos Pace,0,3,3,Carlos Pace
243,280,37,1972,Rolf Stommelen,Henri Pescarolo,0,0,0,Henri Pescarolo
243,329,37,1972,Rolf Stommelen,Mike Beuttler,0,0,0,Mike Beuttler
243,342,37,1972,Rolf Stommelen,Skip Barber,0,0,0,Skip Barber
250,280,37,1972,Carlos Pace,Henri Pescarolo,3,0,3,Carlos Pace
250,329,37,1972,Carlos Pace,Mike Beuttler,3,0,3,Carlos Pace
250,342,37,1972,Carlos Pace,Skip Barber,3,0,3,Carlos Pace
280,329,37,1972,Henri Pescarolo,Mike Beuttler,0,0,0,Mike Beuttler
280,342,37,1972,Henri Pescarolo,Skip Barber,0,0,0,Skip Barber
329,342,37,1972,Mike Beuttler,Skip Barber,0,0,0,Skip Barber
197,231,37,1973,Jean-Pierre Jarier,James Hunt,0,14,14,James Hunt
197,259,37,1973,Jean-Pierre Jarier,David Purley,0,0,0,David Purley
197,280,37,1973,Jean-Pierre Jarier,Henri Pescarolo,0,0,0,Henri Pescarolo
197,317,37,1973,Jean-Pierre Jarier,Reine Wisell,0,0,0,Reine Wisell
197,329,37,1973,Jean-Pierre Jarier,Mike Beuttler,0,0,0,Mike Beuttler
197,335,37,1973,Jean-Pierre Jarier,Roger Williamson,0,0,0,Roger Williamson
231,259,37,1973,James Hunt,David Purley,14,0,14,James Hunt
231,280,37,1973,James Hunt,Henri Pescarolo,14,0,14,James Hunt
231,317,37,1973,James Hunt,Reine Wisell,14,0,14,James Hunt
231,329,37,1973,James Hunt,Mike Beuttler,14,0,14,James Hunt
231,335,37,1973,James Hunt,Roger Williamson,14,0,14,James Hunt
259,280,37,1973,David Purley,Henri Pescarolo,0,0,0,Henri Pescarolo
259,317,37,1973,David Purley,Reine Wisell,0,0,0,Reine Wisell
259,329,37,1973,David Purley,Mike Beuttler,0,0,0,Mike Beuttler
259,335,37,1973,David Purley,Roger Williamson,0,0,0,Roger Williamson
280,317,37,1973,Henri Pescarolo,Reine Wisell,0,0,0,Reine Wisell
280,329,37,1973,Henri Pescarolo,Mike Beuttler,0,0,0,Mike Beuttler
280,335,37,1973,Henri Pescarolo,Roger Williamson,0,0,0,Roger Williamson
317,329,37,1973,Reine Wisell,Mike Beuttler,0,0,0,Mike Beuttler
317,335,37,1973,Reine Wisell,Roger Williamson,0,0,0,Roger Williamson
329,335,37,1973,Mike Beuttler,Roger Williamson,0,0,0,Roger Williamson
230,231,37,1974,Vittorio Brambilla,James Hunt,1,0,1,Vittorio Brambilla
230,233,37,1974,Vittorio Brambilla,Hans-Joachim Stuck,1,5,4,Hans-Joachim Stuck
230,283,37,1974,Vittorio Brambilla,Mike Wilds,1,0,1,Vittorio Brambilla
230,307,37,1974,Vittorio Brambilla,Howden Ganley,1,0,1,Vittorio Brambilla
230,317,37,1974,Vittorio Brambilla,Reine Wisell,1,0,1,Vittorio Brambilla
231,233,37,1974,James Hunt,Hans-Joachim Stuck,0,5,5,Hans-Joachim Stuck
231,283,37,1974,James Hunt,Mike Wilds,0,0,0,Mike Wilds
231,307,37,1974,James Hunt,Howden Ganley,0,0,0,Howden Ganley
231,317,37,1974,James Hunt,Reine Wisell,0,0,0,Reine Wisell
233,283,37,1974,Hans-Joachim Stuck,Mike Wilds,5,0,5,Hans-Joachim Stuck
233,307,37,1974,Hans-Joachim Stuck,Howden Ganley,5,0,5,Hans-Joachim Stuck
233,317,37,1974,Hans-Joachim Stuck,Reine Wisell,5,0,5,Hans-Joachim Stuck
283,307,37,1974,Mike Wilds,Howden Ganley,0,0,0,Howden Ganley
283,317,37,1974,Mike Wilds,Reine Wisell,0,0,0,Reine Wisell
307,317,37,1974,Howden Ganley,Reine Wisell,0,0,0,Reine Wisell
230,233,37,1975,Vittorio Brambilla,Hans-Joachim Stuck,6,0,6,Vittorio Brambilla
230,275,37,1975,Vittorio Brambilla,Lella Lombardi,6,0,6,Vittorio Brambilla
230,288,37,1975,Vittorio Brambilla,Mark Donohue,6,2,4,Vittorio Brambilla
233,275,37,1975,Hans-Joachim Stuck,Lella Lombardi,0,0,0,Lella Lombardi
233,288,37,1975,Hans-Joachim Stuck,Mark Donohue,0,2,2,Mark Donohue
275,288,37,1975,Lella Lombardi,Mark Donohue,0,2,2,Mark Donohue
230,232,37,1976,Vittorio Brambilla,Arturo Merzario,1,0,1,Vittorio Brambilla
230,233,37,1976,Vittorio Brambilla,Hans-Joachim Stuck,1,8,7,Hans-Joachim Stuck
230,238,37,1976,Vittorio Brambilla,Ronnie Peterson,1,10,9,Ronnie Peterson
230,275,37,1976,Vittorio Brambilla,Lella Lombardi,1,0,1,Vittorio Brambilla
232,233,37,1976,Arturo Merzario,Hans-Joachim Stuck,0,8,8,Hans-Joachim Stuck
232,238,37,1976,Arturo Merzario,Ronnie Peterson,0,10,10,Ronnie Peterson
232,275,37,1976,Arturo Merzario,Lella Lombardi,0,0,0,Lella Lombardi
233,238,37,1976,Hans-Joachim Stuck,Ronnie Peterson,8,10,2,Ronnie Peterson
233,275,37,1976,Hans-Joachim Stuck,Lella Lombardi,8,0,8,Hans-Joachim Stuck
238,275,37,1976,Ronnie Peterson,Lella Lombardi,10,0,10,Ronnie Peterson
205,232,37,1977,Brian Henton,Arturo Merzario,0,0,0,Arturo Merzario
205,233,37,1977,Brian Henton,Hans-Joachim Stuck,0,0,0,Hans-Joachim Stuck
205,237,37,1977,Brian Henton,Alex Ribeiro,0,0,0,Alex Ribeiro
205,239,37,1977,Brian Henton,Brett Lunger,0,0,0,Brett Lunger
205,247,37,1977,Brian Henton,Michael Bleekemolen,0,0,0,Michael Bleekemolen
205,251,37,1977,Brian Henton,Ian Scheckter,0,0,0,Ian Scheckter
205,257,37,1977,Brian Henton,Boy Lunger,0,0,0,Boy Lunger
205,258,37,1977,Brian Henton,Patrick NÃ¨ve,0,0,0,Patrick NÃ¨ve
205,261,37,1977,Brian Henton,Bernard de Dryver,0,0,0,Bernard de Dryver
205,263,37,1977,Brian Henton,Mikko Kozarowitzky,0,0,0,Mikko Kozarowitzky
205,264,37,1977,Brian Henton,Andy Sutcliffe,0,0,0,Andy Sutcliffe
232,233,37,1977,Arturo Merzario,Hans-Joachim Stuck,0,0,0,Hans-Joachim Stuck
232,237,37,1977,Arturo Merzario,Alex Ribeiro,0,0,0,Alex Ribeiro
232,239,37,1977,Arturo Merzario,Brett Lunger,0,0,0,Brett Lunger
232,247,37,1977,Arturo Merzario,Michael Bleekemolen,0,0,0,Michael Bleekemolen
232,251,37,1977,Arturo Merzario,Ian Scheckter,0,0,0,Ian Scheckter
232,257,37,1977,Arturo Merzario,Boy Lunger,0,0,0,Boy Lunger
232,258,37,1977,Arturo Merzario,Patrick NÃ¨ve,0,0,0,Patrick NÃ¨ve
232,261,37,1977,Arturo Merzario,Bernard de Dryver,0,0,0,Bernard de Dryver
232,263,37,1977,Arturo Merzario,Mikko Kozarowitzky,0,0,0,Mikko Kozarowitzky
232,264,37,1977,Arturo Merzario,Andy Sutcliffe,0,0,0,Andy Sutcliffe
233,237,37,1977,Hans-Joachim Stuck,Alex Ribeiro,0,0,0,Alex Ribeiro
233,239,37,1977,Hans-Joachim Stuck,Brett Lunger,0,0,0,Brett Lunger
233,247,37,1977,Hans-Joachim Stuck,Michael Bleekemolen,0,0,0,Michael Bleekemolen
233,251,37,1977,Hans-Joachim Stuck,Ian Scheckter,0,0,0,Ian Scheckter
233,257,37,1977,Hans-Joachim Stuck,Boy Lunger,0,0,0,Boy Lunger
233,258,37,1977,Hans-Joachim Stuck,Patrick NÃ¨ve,0,0,0,Patrick NÃ¨ve
233,261,37,1977,Hans-Joachim Stuck,Bernard de Dryver,0,0,0,Bernard de Dryver
233,263,37,1977,Hans-Joachim Stuck,Mikko Kozarowitzky,0,0,0,Mikko Kozarowitzky
233,264,37,1977,Hans-Joachim Stuck,Andy Sutcliffe,0,0,0,Andy Sutcliffe
237,239,37,1977,Alex Ribeiro,Brett Lunger,0,0,0,Brett Lunger
237,247,37,1977,Alex Ribeiro,Michael Bleekemolen,0,0,0,Michael Bleekemolen
237,251,37,1977,Alex Ribeiro,Ian Scheckter,0,0,0,Ian Scheckter
237,257,37,1977,Alex Ribeiro,Boy Lunger,0,0,0,Boy Lunger
237,258,37,1977,Alex Ribeiro,Patrick NÃ¨ve,0,0,0,Patrick NÃ¨ve
237,261,37,1977,Alex Ribeiro,Bernard de Dryver,0,0,0,Bernard de Dryver
237,263,37,1977,Alex Ribeiro,Mikko Kozarowitzky,0,0,0,Mikko Kozarowitzky
237,264,37,1977,Alex Ribeiro,Andy Sutcliffe,0,0,0,Andy Sutcliffe
239,247,37,1977,Brett Lunger,Michael Bleekemolen,0,0,0,Michael Bleekemolen
239,251,37,1977,Brett Lunger,Ian Scheckter,0,0,0,Ian Scheckter
239,257,37,1977,Brett Lunger,Boy Lunger,0,0,0,Boy Lunger
239,258,37,1977,Brett Lunger,Patrick NÃ¨ve,0,0,0,Patrick NÃ¨ve
239,261,37,1977,Brett Lunger,Bernard de Dryver,0,0,0,Bernard de Dryver
239,263,37,1977,Brett Lunger,Mikko Kozarowitzky,0,0,0,Mikko Kozarowitzky
239,264,37,1977,Brett Lunger,Andy Sutcliffe,0,0,0,Andy Sutcliffe
247,251,37,1977,Michael Bleekemolen,Ian Scheckter,0,0,0,Ian Scheckter
247,257,37,1977,Michael Bleekemolen,Boy Lunger,0,0,0,Boy Lunger
247,258,37,1977,Michael Bleekemolen,Patrick NÃ¨ve,0,0,0,Patrick NÃ¨ve
247,261,37,1977,Michael Bleekemolen,Bernard de Dryver,0,0,0,Bernard de Dryver
247,263,37,1977,Michael Bleekemolen,Mikko Kozarowitzky,0,0,0,Mikko Kozarowitzky
247,264,37,1977,Michael Bleekemolen,Andy Sutcliffe,0,0,0,Andy Sutcliffe
251,257,37,1977,Ian Scheckter,Boy Lunger,0,0,0,Boy Lunger
251,258,37,1977,Ian Scheckter,Patrick NÃ¨ve,0,0,0,Patrick NÃ¨ve
251,261,37,1977,Ian Scheckter,Bernard de Dryver,0,0,0,Bernard de Dryver
251,263,37,1977,Ian Scheckter,Mikko Kozarowitzky,0,0,0,Mikko Kozarowitzky
251,264,37,1977,Ian Scheckter,Andy Sutcliffe,0,0,0,Andy Sutcliffe
257,258,37,1977,Boy Lunger,Patrick NÃ¨ve,0,0,0,Patrick NÃ¨ve
257,261,37,1977,Boy Lunger,Bernard de Dryver,0,0,0,Bernard de Dryver
257,263,37,1977,Boy Lunger,Mikko Kozarowitzky,0,0,0,Mikko Kozarowitzky
257,264,37,1977,Boy Lunger,Andy Sutcliffe,0,0,0,Andy Sutcliffe
258,261,37,1977,Patrick NÃ¨ve,Bernard de Dryver,0,0,0,Bernard de Dryver
258,263,37,1977,Patrick NÃ¨ve,Mikko Kozarowitzky,0,0,0,Mikko Kozarowitzky
258,264,37,1977,Patrick NÃ¨ve,Andy Sutcliffe,0,0,0,Andy Sutcliffe
261,263,37,1977,Bernard de Dryver,Mikko Kozarowitzky,0,0,0,Mikko Kozarowitzky
261,264,37,1977,Bernard de Dryver,Andy Sutcliffe,0,0,0,Andy Sutcliffe
263,264,37,1977,Mikko Kozarowitzky,Andy Sutcliffe,0,0,0,Andy Sutcliffe
194,206,37,1981,Eliseo Salazar,Derek Daly,0,0,0,Derek Daly
196,200,37,1982,Raul Boesel,Jochen Mass,0,0,0,Jochen Mass
196,208,37,1982,Raul Boesel,Emilio de Villota,0,0,0,Emilio de Villota
196,211,37,1982,Raul Boesel,Rupert Keegan,0,0,0,Rupert Keegan
200,208,37,1982,Jochen Mass,Emilio de Villota,0,0,0,Emilio de Villota
200,211,37,1982,Jochen Mass,Rupert Keegan,0,0,0,Rupert Keegan
208,211,37,1982,Emilio de Villota,Rupert Keegan,0,0,0,Rupert Keegan
122,127,37,1988,Ivan Capelli,MaurÃ­cio Gugelmin,17,5,12,Ivan Capelli
122,127,37,1989,Ivan Capelli,MaurÃ­cio Gugelmin,0,4,4,MaurÃ­cio Gugelmin
108,125,37,1992,Paul Belmondo,Emanuele Naspetti,0,0,0,Emanuele Naspetti
108,136,37,1992,Paul Belmondo,Jan Lammers,0,0,0,Jan Lammers
108,91,37,1992,Paul Belmondo,Karl Wendlinger,0,3,3,Karl Wendlinger
125,136,37,1992,Emanuele Naspetti,Jan Lammers,0,0,0,Jan Lammers
125,91,37,1992,Emanuele Naspetti,Karl Wendlinger,0,3,3,Karl Wendlinger
136,91,37,1992,Jan Lammers,Karl Wendlinger,0,3,3,Karl Wendlinger
135,90,38,1992,Perry McCarthy,Roberto Moreno,0,0,0,Roberto Moreno
169,90,39,1987,Pascal Fabre,Roberto Moreno,0,1,1,Roberto Moreno
114,164,39,1989,Yannick Dalmas,Joachim Winkelhock,0,0,0,Joachim Winkelhock
114,99,39,1989,Yannick Dalmas,Gabriele Tarquini,0,1,1,Gabriele Tarquini
164,99,39,1989,Joachim Winkelhock,Gabriele Tarquini,0,1,1,Gabriele Tarquini
114,99,39,1990,Yannick Dalmas,Gabriele Tarquini,0,0,0,Gabriele Tarquini
120,129,39,1991,Fabrizio Barbazza,Olivier Grouillard,0,0,0,Olivier Grouillard
120,140,39,1991,Fabrizio Barbazza,Stefan Johansson,0,0,0,Stefan Johansson
120,99,39,1991,Fabrizio Barbazza,Gabriele Tarquini,0,0,0,Gabriele Tarquini
129,140,39,1991,Olivier Grouillard,Stefan Johansson,0,0,0,Stefan Johansson
129,99,39,1991,Olivier Grouillard,Gabriele Tarquini,0,0,0,Gabriele Tarquini
140,99,39,1991,Stefan Johansson,Gabriele Tarquini,0,0,0,Gabriele Tarquini
163,219,4,1979,RenÃ© Arnoux,Jean-Pierre Jabouille,17,9,8,RenÃ© Arnoux
163,219,4,1980,RenÃ© Arnoux,Jean-Pierre Jabouille,29,9,20,RenÃ© Arnoux
117,163,4,1981,Alain Prost,RenÃ© Arnoux,43,11,32,Alain Prost
117,163,4,1982,Alain Prost,RenÃ© Arnoux,34,28,6,Alain Prost
117,158,4,1983,Alain Prost,Eddie Cheever,57,22,35,Alain Prost
118,166,4,1984,Derek Warwick,Philippe Streiff,23,0,23,Derek Warwick
118,175,4,1984,Derek Warwick,Patrick Tambay,23,11,12,Derek Warwick
166,175,4,1984,Philippe Streiff,Patrick Tambay,0,11,11,Patrick Tambay
118,175,4,1985,Derek Warwick,Patrick Tambay,5,11,6,Patrick Tambay
118,183,4,1985,Derek Warwick,FranÃ§ois Hesnault,5,0,5,Derek Warwick
175,183,4,1985,Patrick Tambay,FranÃ§ois Hesnault,11,0,11,Patrick Tambay
15,18,4,2002,Jarno Trulli,Jenson Button,9,14,5,Jenson Button
15,4,4,2003,Jarno Trulli,Fernando Alonso,33,55,22,Fernando Alonso
15,35,4,2004,Jarno Trulli,Jacques Villeneuve,46,0,46,Jarno Trulli
15,4,4,2004,Jarno Trulli,Fernando Alonso,46,59,13,Fernando Alonso
35,4,4,2004,Jacques Villeneuve,Fernando Alonso,0,59,59,Fernando Alonso
21,4,4,2005,Giancarlo Fisichella,Fernando Alonso,58,133,75,Fernando Alonso
21,4,4,2006,Giancarlo Fisichella,Fernando Alonso,72,134,62,Fernando Alonso
21,5,4,2007,Giancarlo Fisichella,Heikki Kovalainen,21,30,9,Heikki Kovalainen
12,4,4,2008,Nelson Piquet Jr.,Fernando Alonso,19,61,42,Fernando Alonso
12,154,4,2009,Nelson Piquet Jr.,Romain Grosjean,0,0,0,Romain Grosjean
12,4,4,2009,Nelson Piquet Jr.,Fernando Alonso,0,26,26,Fernando Alonso
154,4,4,2009,Romain Grosjean,Fernando Alonso,0,26,26,Fernando Alonso
808,9,4,2010,Vitaly Petrov,Robert Kubica,27,136,109,Robert Kubica
2,808,4,2011,Nick Heidfeld,Vitaly Petrov,34,37,3,Vitaly Petrov
2,811,4,2011,Nick Heidfeld,Bruno Senna,34,2,32,Nick Heidfeld
808,811,4,2011,Vitaly Petrov,Bruno Senna,37,2,35,Vitaly Petrov
825,835,4,2016,Kevin Magnussen,Jolyon Palmer,7,1,6,Kevin Magnussen
807,832,4,2017,Nico HÃ¼lkenberg,Carlos Sainz,43,6,37,Nico HÃ¼lkenberg
807,835,4,2017,Nico HÃ¼lkenberg,Jolyon Palmer,43,8,35,Nico HÃ¼lkenberg
832,835,4,2017,Carlos Sainz,Jolyon Palmer,6,8,2,Jolyon Palmer
807,832,4,2018,Nico HÃ¼lkenberg,Carlos Sainz,69,53,16,Nico HÃ¼lkenberg
807,817,4,2019,Nico HÃ¼lkenberg,Daniel Ricciardo,37,54,17,Daniel Ricciardo
817,839,4,2020,Daniel Ricciardo,Esteban Ocon,119,62,57,Daniel Ricciardo
128,78,40,1991,Eric van de Poele,Nicola Larini,0,0,0,Nicola Larini
122,127,41,1990,Ivan Capelli,MaurÃ­cio Gugelmin,6,1,5,Ivan Capelli
122,127,41,1991,Ivan Capelli,MaurÃ­cio Gugelmin,1,0,1,Ivan Capelli
122,91,41,1991,Ivan Capelli,Karl Wendlinger,1,0,1,Ivan Capelli
127,91,41,1991,MaurÃ­cio Gugelmin,Karl Wendlinger,0,0,0,Karl Wendlinger
134,162,42,1989,Enrico Bertaggia,Pierre-Henri Raphanel,0,0,0,Pierre-Henri Raphanel
134,90,42,1989,Enrico Bertaggia,Roberto Moreno,0,0,0,Roberto Moreno
162,90,42,1989,Pierre-Henri Raphanel,Roberto Moreno,0,0,0,Roberto Moreno
142,144,42,1991,Pedro Chaves,Naoki Hattori,0,0,0,Naoki Hattori
131,165,44,1988,Stefano Modena,Oscar Larrauri,0,0,0,Oscar Larrauri
148,165,44,1989,Gregor Foitek,Oscar Larrauri,0,0,0,Oscar Larrauri
149,90,44,1990,Claudio Langes,Roberto Moreno,0,0,0,Roberto Moreno
160,194,45,1981,Piercarlo Ghinzani,Eliseo Salazar,0,0,0,Eliseo Salazar
160,197,45,1981,Piercarlo Ghinzani,Jean-Pierre Jarier,0,0,0,Jean-Pierre Jarier
160,213,45,1981,Piercarlo Ghinzani,Beppe Gabbiani,0,0,0,Beppe Gabbiani
160,215,45,1981,Piercarlo Ghinzani,Miguel Ãngel Guerra,0,0,0,Miguel Ãngel Guerra
160,220,45,1981,Piercarlo Ghinzani,Giorgio Francia,0,0,0,Giorgio Francia
194,197,45,1981,Eliseo Salazar,Jean-Pierre Jarier,0,0,0,Jean-Pierre Jarier
194,213,45,1981,Eliseo Salazar,Beppe Gabbiani,0,0,0,Beppe Gabbiani
194,215,45,1981,Eliseo Salazar,Miguel Ãngel Guerra,0,0,0,Miguel Ãngel Guerra
194,220,45,1981,Eliseo Salazar,Giorgio Francia,0,0,0,Giorgio Francia
197,213,45,1981,Jean-Pierre Jarier,Beppe Gabbiani,0,0,0,Beppe Gabbiani
197,215,45,1981,Jean-Pierre Jarier,Miguel Ãngel Guerra,0,0,0,Miguel Ãngel Guerra
197,220,45,1981,Jean-Pierre Jarier,Giorgio Francia,0,0,0,Giorgio Francia
213,215,45,1981,Beppe Gabbiani,Miguel Ãngel Guerra,0,0,0,Miguel Ãngel Guerra
213,220,45,1981,Beppe Gabbiani,Giorgio Francia,0,0,0,Giorgio Francia
215,220,45,1981,Miguel Ãngel Guerra,Giorgio Francia,0,0,0,Giorgio Francia
197,204,45,1982,Jean-Pierre Jarier,Riccardo Paletti,3,0,3,Jean-Pierre Jarier
160,190,45,1983,Piercarlo Ghinzani,Corrado Fabi,0,0,0,Corrado Fabi
160,189,45,1984,Piercarlo Ghinzani,Jo Gartner,2,0,2,Piercarlo Ghinzani
160,179,45,1985,Piercarlo Ghinzani,Huub Rothengatter,0,0,0,Huub Rothengatter
133,157,45,1986,Alex Caffi,Christian Danner,0,0,0,Christian Danner
133,160,45,1986,Alex Caffi,Piercarlo Ghinzani,0,0,0,Piercarlo Ghinzani
133,180,45,1986,Alex Caffi,Allen Berg,0,0,0,Allen Berg
157,160,45,1986,Christian Danner,Piercarlo Ghinzani,0,0,0,Piercarlo Ghinzani
157,180,45,1986,Christian Danner,Allen Berg,0,0,0,Allen Berg
160,180,45,1986,Piercarlo Ghinzani,Allen Berg,0,0,0,Allen Berg
133,171,45,1987,Alex Caffi,Franco Forini,0,0,0,Franco Forini
133,99,45,1987,Alex Caffi,Gabriele Tarquini,0,0,0,Gabriele Tarquini
171,99,45,1987,Franco Forini,Gabriele Tarquini,0,0,0,Gabriele Tarquini
160,78,45,1989,Piercarlo Ghinzani,Nicola Larini,0,0,0,Nicola Larini
109,140,46,1989,Jyrki JÃ¤rvilehto,Stefan Johansson,0,6,6,Stefan Johansson
109,92,46,1989,Jyrki JÃ¤rvilehto,Bertrand Gachot,0,0,0,Bertrand Gachot
140,92,46,1989,Stefan Johansson,Bertrand Gachot,6,0,6,Stefan Johansson
109,140,46,1990,Jyrki JÃ¤rvilehto,Stefan Johansson,0,0,0,Stefan Johansson
109,148,46,1990,Jyrki JÃ¤rvilehto,Gregor Foitek,0,0,0,Gregor Foitek
140,148,46,1990,Stefan Johansson,Gregor Foitek,0,0,0,Gregor Foitek
150,152,47,1990,Gary Brabham,Bruno Giacomelli,0,0,0,Bruno Giacomelli
148,157,48,1989,Gregor Foitek,Christian Danner,0,3,3,Christian Danner
148,161,48,1989,Gregor Foitek,Volker Weidler,0,0,0,Volker Weidler
148,162,48,1989,Gregor Foitek,Pierre-Henri Raphanel,0,0,0,Pierre-Henri Raphanel
148,92,48,1989,Gregor Foitek,Bertrand Gachot,0,0,0,Bertrand Gachot
157,161,48,1989,Christian Danner,Volker Weidler,3,0,3,Christian Danner
157,162,48,1989,Christian Danner,Pierre-Henri Raphanel,3,0,3,Christian Danner
157,92,48,1989,Christian Danner,Bertrand Gachot,3,0,3,Christian Danner
161,162,48,1989,Volker Weidler,Pierre-Henri Raphanel,0,0,0,Pierre-Henri Raphanel
161,92,48,1989,Volker Weidler,Bertrand Gachot,0,0,0,Bertrand Gachot
162,92,48,1989,Pierre-Henri Raphanel,Bertrand Gachot,0,0,0,Bertrand Gachot
156,157,49,1985,Jonathan Palmer,Christian Danner,0,0,0,Christian Danner
156,179,49,1986,Jonathan Palmer,Huub Rothengatter,0,0,0,Huub Rothengatter
157,84,49,1987,Christian Danner,Martin Brundle,0,2,2,Martin Brundle
146,160,49,1988,Bernd Schneider,Piercarlo Ghinzani,0,0,0,Piercarlo Ghinzani
146,88,49,1989,Bernd Schneider,Aguri Suzuki,0,0,0,Aguri Suzuki
24,26,5,2006,Vitantonio Liuzzi,Scott Speed,1,0,1,Vitantonio Liuzzi
20,24,5,2007,Sebastian Vettel,Vitantonio Liuzzi,5,3,2,Sebastian Vettel
20,26,5,2007,Sebastian Vettel,Scott Speed,5,0,5,Sebastian Vettel
24,26,5,2007,Vitantonio Liuzzi,Scott Speed,3,0,3,Vitantonio Liuzzi
20,7,5,2008,Sebastian Vettel,SÃ©bastien Bourdais,35,4,31,Sebastian Vettel
153,67,5,2009,Jaime Alguersuari,SÃ©bastien Buemi,0,6,6,SÃ©bastien Buemi
153,7,5,2009,Jaime Alguersuari,SÃ©bastien Bourdais,0,2,2,SÃ©bastien Bourdais
67,7,5,2009,SÃ©bastien Buemi,SÃ©bastien Bourdais,6,2,4,SÃ©bastien Buemi
153,67,5,2010,Jaime Alguersuari,SÃ©bastien Buemi,5,8,3,SÃ©bastien Buemi
153,67,5,2011,Jaime Alguersuari,SÃ©bastien Buemi,26,15,11,Jaime Alguersuari
817,818,5,2012,Daniel Ricciardo,Jean-Ã‰ric Vergne,10,16,6,Jean-Ã‰ric Vergne
817,818,5,2013,Daniel Ricciardo,Jean-Ã‰ric Vergne,20,13,7,Daniel Ricciardo
818,826,5,2014,Jean-Ã‰ric Vergne,Daniil Kvyat,22,8,14,Jean-Ã‰ric Vergne
830,832,5,2015,Max Verstappen,Carlos Sainz,49,18,31,Max Verstappen
826,830,5,2016,Daniil Kvyat,Max Verstappen,4,13,9,Max Verstappen
826,832,5,2016,Daniil Kvyat,Carlos Sainz,4,46,42,Carlos Sainz
830,832,5,2016,Max Verstappen,Carlos Sainz,13,46,33,Carlos Sainz
826,832,5,2017,Daniil Kvyat,Carlos Sainz,5,48,43,Carlos Sainz
826,842,5,2017,Daniil Kvyat,Pierre Gasly,5,0,5,Daniil Kvyat
826,843,5,2017,Daniil Kvyat,Brendon Hartley,5,0,5,Daniil Kvyat
832,842,5,2017,Carlos Sainz,Pierre Gasly,48,0,48,Carlos Sainz
832,843,5,2017,Carlos Sainz,Brendon Hartley,48,0,48,Carlos Sainz
842,843,5,2017,Pierre Gasly,Brendon Hartley,0,0,0,Brendon Hartley
842,843,5,2018,Pierre Gasly,Brendon Hartley,29,4,25,Pierre Gasly
826,842,5,2019,Daniil Kvyat,Pierre Gasly,37,32,5,Daniil Kvyat
826,848,5,2019,Daniil Kvyat,Alexander Albon,37,16,21,Daniil Kvyat
842,848,5,2019,Pierre Gasly,Alexander Albon,32,16,16,Pierre Gasly
168,186,50,1983,Jean-Louis Schlesser,Kenny Acheson,0,0,0,Kenny Acheson
168,194,50,1983,Jean-Louis Schlesser,Eliseo Salazar,0,0,0,Eliseo Salazar
168,198,50,1983,Jean-Louis Schlesser,Jacques Villeneuve Sr.,0,0,0,Jacques Villeneuve Sr.
186,194,50,1983,Kenny Acheson,Eliseo Salazar,0,0,0,Eliseo Salazar
186,198,50,1983,Kenny Acheson,Jacques Villeneuve Sr.,0,0,0,Jacques Villeneuve Sr.
194,198,50,1983,Eliseo Salazar,Jacques Villeneuve Sr.,0,0,0,Jacques Villeneuve Sr.
112,156,50,1984,Philippe Alliot,Jonathan Palmer,0,0,0,Jonathan Palmer
112,191,50,1984,Philippe Alliot,Mike Thackwell,0,0,0,Mike Thackwell
156,191,50,1984,Jonathan Palmer,Mike Thackwell,0,0,0,Mike Thackwell
112,181,50,1985,Philippe Alliot,Manfred Winkelhock,0,0,0,Manfred Winkelhock
112,186,50,1985,Philippe Alliot,Kenny Acheson,0,0,0,Kenny Acheson
181,186,50,1985,Manfred Winkelhock,Kenny Acheson,0,0,0,Kenny Acheson
579,641,51,1950,Juan Fangio,Piero Taruffi,27,0,27,Juan Fangio
579,642,51,1950,Juan Fangio,Nino Farina,27,30,3,Nino Farina
579,686,51,1950,Juan Fangio,Reg Parnell,27,4,23,Juan Fangio
579,763,51,1950,Juan Fangio,Consalvo Sanesi,27,0,27,Juan Fangio
579,786,51,1950,Juan Fangio,Luigi Fagioli,27,28,1,Luigi Fagioli
641,642,51,1950,Piero Taruffi,Nino Farina,0,30,30,Nino Farina
641,686,51,1950,Piero Taruffi,Reg Parnell,0,4,4,Reg Parnell
641,763,51,1950,Piero Taruffi,Consalvo Sanesi,0,0,0,Consalvo Sanesi
641,786,51,1950,Piero Taruffi,Luigi Fagioli,0,28,28,Luigi Fagioli
642,686,51,1950,Nino Farina,Reg Parnell,30,4,26,Nino Farina
642,763,51,1950,Nino Farina,Consalvo Sanesi,30,0,30,Nino Farina
642,786,51,1950,Nino Farina,Luigi Fagioli,30,28,2,Nino Farina
686,763,51,1950,Reg Parnell,Consalvo Sanesi,4,0,4,Reg Parnell
686,786,51,1950,Reg Parnell,Luigi Fagioli,4,28,24,Luigi Fagioli
763,786,51,1950,Consalvo Sanesi,Luigi Fagioli,0,28,28,Luigi Fagioli
579,640,51,1951,Juan Fangio,Toulo de Graffenried,37,2,35,Juan Fangio
579,642,51,1951,Juan Fangio,Nino Farina,37,22,15,Juan Fangio
579,697,51,1951,Juan Fangio,Felice Bonetto,37,7,30,Juan Fangio
579,756,51,1951,Juan Fangio,Paul Pietsch,37,0,37,Juan Fangio
579,763,51,1951,Juan Fangio,Consalvo Sanesi,37,3,34,Juan Fangio
579,786,51,1951,Juan Fangio,Luigi Fagioli,37,4,33,Juan Fangio
640,642,51,1951,Toulo de Graffenried,Nino Farina,2,22,20,Nino Farina
640,697,51,1951,Toulo de Graffenried,Felice Bonetto,2,7,5,Felice Bonetto
640,756,51,1951,Toulo de Graffenried,Paul Pietsch,2,0,2,Toulo de Graffenried
640,763,51,1951,Toulo de Graffenried,Consalvo Sanesi,2,3,1,Consalvo Sanesi
640,786,51,1951,Toulo de Graffenried,Luigi Fagioli,2,4,2,Luigi Fagioli
642,697,51,1951,Nino Farina,Felice Bonetto,22,7,15,Nino Farina
642,756,51,1951,Nino Farina,Paul Pietsch,22,0,22,Nino Farina
642,763,51,1951,Nino Farina,Consalvo Sanesi,22,3,19,Nino Farina
642,786,51,1951,Nino Farina,Luigi Fagioli,22,4,18,Nino Farina
697,756,51,1951,Felice Bonetto,Paul Pietsch,7,0,7,Felice Bonetto
697,763,51,1951,Felice Bonetto,Consalvo Sanesi,7,3,4,Felice Bonetto
697,786,51,1951,Felice Bonetto,Luigi Fagioli,7,4,3,Felice Bonetto
756,763,51,1951,Paul Pietsch,Consalvo Sanesi,0,3,3,Consalvo Sanesi
756,786,51,1951,Paul Pietsch,Luigi Fagioli,0,4,4,Luigi Fagioli
763,786,51,1951,Consalvo Sanesi,Luigi Fagioli,3,4,1,Luigi Fagioli
152,230,51,1979,Bruno Giacomelli,Vittorio Brambilla,0,0,0,Vittorio Brambilla
110,152,51,1980,Andrea de Cesaris,Bruno Giacomelli,0,4,4,Bruno Giacomelli
110,221,51,1980,Andrea de Cesaris,Patrick Depailler,0,0,0,Patrick Depailler
110,230,51,1980,Andrea de Cesaris,Vittorio Brambilla,0,0,0,Vittorio Brambilla
152,221,51,1980,Bruno Giacomelli,Patrick Depailler,4,0,4,Bruno Giacomelli
152,230,51,1980,Bruno Giacomelli,Vittorio Brambilla,4,0,4,Bruno Giacomelli
221,230,51,1980,Patrick Depailler,Vittorio Brambilla,0,0,0,Vittorio Brambilla
152,207,51,1981,Bruno Giacomelli,Mario Andretti,7,3,4,Bruno Giacomelli
110,152,51,1982,Andrea de Cesaris,Bruno Giacomelli,5,2,3,Andrea de Cesaris
110,184,51,1983,Andrea de Cesaris,Mauro Baldi,15,3,12,Andrea de Cesaris
119,158,51,1984,Riccardo Patrese,Eddie Cheever,8,3,5,Riccardo Patrese
119,158,51,1985,Riccardo Patrese,Eddie Cheever,0,0,0,Eddie Cheever
8,841,51,2019,Kimi RÃ¤ikkÃ¶nen,Antonio Giovinazzi,43,14,29,Kimi RÃ¤ikkÃ¶nen
8,841,51,2020,Kimi RÃ¤ikkÃ¶nen,Antonio Giovinazzi,4,4,0,Antonio Giovinazzi
8,841,51,2021,Kimi RÃ¤ikkÃ¶nen,Antonio Giovinazzi,10,3,7,Kimi RÃ¤ikkÃ¶nen
8,9,51,2021,Kimi RÃ¤ikkÃ¶nen,Robert Kubica,10,0,10,Kimi RÃ¤ikkÃ¶nen
841,9,51,2021,Antonio Giovinazzi,Robert Kubica,3,0,3,Antonio Giovinazzi
822,855,51,2022,Valtteri Bottas,Guanyu Zhou,47,6,41,Valtteri Bottas
822,855,51,2023,Valtteri Bottas,Guanyu Zhou,10,6,4,Valtteri Bottas
179,184,52,1984,Huub Rothengatter,Mauro Baldi,0,0,0,Mauro Baldi
118,205,53,1981,Derek Warwick,Brian Henton,0,0,0,Brian Henton
118,170,53,1982,Derek Warwick,Teo Fabi,0,0,0,Teo Fabi
118,152,53,1983,Derek Warwick,Bruno Giacomelli,9,1,8,Derek Warwick
102,140,53,1984,Ayrton Senna,Stefan Johansson,13,3,10,Ayrton Senna
102,188,53,1984,Ayrton Senna,Johnny Cecotto,13,0,13,Ayrton Senna
102,94,53,1984,Ayrton Senna,Pierluigi Martini,13,0,13,Ayrton Senna
140,188,53,1984,Stefan Johansson,Johnny Cecotto,3,0,3,Stefan Johansson
140,94,53,1984,Stefan Johansson,Pierluigi Martini,3,0,3,Stefan Johansson
188,94,53,1984,Johnny Cecotto,Pierluigi Martini,0,0,0,Pierluigi Martini
160,170,53,1985,Piercarlo Ghinzani,Teo Fabi,0,0,0,Teo Fabi
394,403,54,1963,Giancarlo Baghetti,Phil Hill,0,0,0,Phil Hill
177,197,54,1978,Keke Rosberg,Jean-Pierre Jarier,0,0,0,Jean-Pierre Jarier
177,200,54,1978,Keke Rosberg,Jochen Mass,0,0,0,Jochen Mass
177,229,54,1978,Keke Rosberg,Harald Ertl,0,0,0,Harald Ertl
177,244,54,1978,Keke Rosberg,Alberto Colombo,0,0,0,Alberto Colombo
177,246,54,1978,Keke Rosberg,Hans Binder,0,0,0,Hans Binder
177,247,54,1978,Keke Rosberg,Michael Bleekemolen,0,0,0,Michael Bleekemolen
197,200,54,1978,Jean-Pierre Jarier,Jochen Mass,0,0,0,Jochen Mass
197,229,54,1978,Jean-Pierre Jarier,Harald Ertl,0,0,0,Harald Ertl
197,244,54,1978,Jean-Pierre Jarier,Alberto Colombo,0,0,0,Alberto Colombo
197,246,54,1978,Jean-Pierre Jarier,Hans Binder,0,0,0,Hans Binder
197,247,54,1978,Jean-Pierre Jarier,Michael Bleekemolen,0,0,0,Michael Bleekemolen
200,229,54,1978,Jochen Mass,Harald Ertl,0,0,0,Harald Ertl
200,244,54,1978,Jochen Mass,Alberto Colombo,0,0,0,Alberto Colombo
200,246,54,1978,Jochen Mass,Hans Binder,0,0,0,Hans Binder
200,247,54,1978,Jochen Mass,Michael Bleekemolen,0,0,0,Michael Bleekemolen
229,244,54,1978,Harald Ertl,Alberto Colombo,0,0,0,Alberto Colombo
229,246,54,1978,Harald Ertl,Hans Binder,0,0,0,Hans Binder
229,247,54,1978,Harald Ertl,Michael Bleekemolen,0,0,0,Michael Bleekemolen
244,246,54,1978,Alberto Colombo,Hans Binder,0,0,0,Hans Binder
244,247,54,1978,Alberto Colombo,Michael Bleekemolen,0,0,0,Michael Bleekemolen
246,247,54,1978,Hans Binder,Michael Bleekemolen,0,0,0,Michael Bleekemolen
136,176,54,1980,Jan Lammers,Marc Surer,0,0,0,Marc Surer
136,229,54,1980,Jan Lammers,Harald Ertl,0,0,0,Harald Ertl
176,229,54,1980,Marc Surer,Harald Ertl,0,0,0,Harald Ertl
136,201,54,1981,Jan Lammers,Slim Borgudd,0,1,1,Slim Borgudd
181,194,54,1982,Manfred Winkelhock,Eliseo Salazar,2,2,0,Eliseo Salazar
181,77,54,1984,Manfred Winkelhock,Gerhard Berger,0,0,0,Gerhard Berger
158,177,55,1978,Eddie Cheever,Keke Rosberg,0,0,0,Keke Rosberg
175,176,55,1981,Patrick Tambay,Marc Surer,1,0,1,Patrick Tambay
136,206,55,1982,Jan Lammers,Derek Daly,0,0,0,Derek Daly
136,209,55,1982,Jan Lammers,Geoff Lees,0,0,0,Geoff Lees
136,210,55,1982,Jan Lammers,Tommy Byrne,0,0,0,Tommy Byrne
206,209,55,1982,Derek Daly,Geoff Lees,0,0,0,Geoff Lees
206,210,55,1982,Derek Daly,Tommy Byrne,0,0,0,Tommy Byrne
209,210,55,1982,Geoff Lees,Tommy Byrne,0,0,0,Tommy Byrne
188,195,55,1983,Johnny Cecotto,Roberto Guerrero,1,0,1,Johnny Cecotto
232,290,56,1975,Arturo Merzario,Wilson Fittipaldi,0,0,0,Wilson Fittipaldi
224,253,56,1976,Emerson Fittipaldi,Ingo Hoffmann,3,0,3,Emerson Fittipaldi
224,253,56,1977,Emerson Fittipaldi,Ingo Hoffmann,11,0,11,Emerson Fittipaldi
224,237,56,1979,Emerson Fittipaldi,Alex Ribeiro,1,0,1,Emerson Fittipaldi
177,224,56,1980,Keke Rosberg,Emerson Fittipaldi,6,5,1,Keke Rosberg
177,192,56,1981,Keke Rosberg,Chico Serra,0,0,0,Chico Serra
267,283,57,1974,Vern Schuppan,Mike Wilds,0,0,0,Mike Wilds
278,295,57,1975,Chris Amon,Roelof Wunderink,0,0,0,Roelof Wunderink
278,298,57,1975,Chris Amon,Gijs van Lennep,0,1,1,Gijs van Lennep
295,298,57,1975,Roelof Wunderink,Gijs van Lennep,0,1,1,Gijs van Lennep
235,246,57,1976,Jacky Ickx,Hans Binder,0,0,0,Hans Binder
235,258,57,1976,Jacky Ickx,Patrick NÃ¨ve,0,0,0,Patrick NÃ¨ve
235,278,57,1976,Jacky Ickx,Chris Amon,0,2,2,Chris Amon
246,258,57,1976,Hans Binder,Patrick NÃ¨ve,0,0,0,Patrick NÃ¨ve
246,278,57,1976,Hans Binder,Chris Amon,0,2,2,Chris Amon
258,278,57,1976,Patrick NÃ¨ve,Chris Amon,0,2,2,Chris Amon
175,223,57,1977,Patrick Tambay,Clay Regazzoni,5,5,0,Clay Regazzoni
175,235,57,1977,Patrick Tambay,Jacky Ickx,5,0,5,Patrick Tambay
223,235,57,1977,Clay Regazzoni,Jacky Ickx,5,0,5,Clay Regazzoni
137,206,57,1978,Nelson Piquet,Derek Daly,0,1,1,Derek Daly
137,209,57,1978,Nelson Piquet,Geoff Lees,0,0,0,Geoff Lees
137,229,57,1978,Nelson Piquet,Harald Ertl,0,0,0,Harald Ertl
137,235,57,1978,Nelson Piquet,Jacky Ickx,0,0,0,Jacky Ickx
137,239,57,1978,Nelson Piquet,Brett Lunger,0,0,0,Brett Lunger
137,240,57,1978,Nelson Piquet,Danny Ongais,0,0,0,Danny Ongais
137,241,57,1978,Nelson Piquet,Lamberto Leoni,0,0,0,Lamberto Leoni
206,209,57,1978,Derek Daly,Geoff Lees,1,0,1,Derek Daly
206,229,57,1978,Derek Daly,Harald Ertl,1,0,1,Derek Daly
206,235,57,1978,Derek Daly,Jacky Ickx,1,0,1,Derek Daly
206,239,57,1978,Derek Daly,Brett Lunger,1,0,1,Derek Daly
206,240,57,1978,Derek Daly,Danny Ongais,1,0,1,Derek Daly
206,241,57,1978,Derek Daly,Lamberto Leoni,1,0,1,Derek Daly
209,229,57,1978,Geoff Lees,Harald Ertl,0,0,0,Harald Ertl
209,235,57,1978,Geoff Lees,Jacky Ickx,0,0,0,Jacky Ickx
209,239,57,1978,Geoff Lees,Brett Lunger,0,0,0,Brett Lunger
209,240,57,1978,Geoff Lees,Danny Ongais,0,0,0,Danny Ongais
209,241,57,1978,Geoff Lees,Lamberto Leoni,0,0,0,Lamberto Leoni
229,235,57,1978,Harald Ertl,Jacky Ickx,0,0,0,Jacky Ickx
229,239,57,1978,Harald Ertl,Brett Lunger,0,0,0,Brett Lunger
229,240,57,1978,Harald Ertl,Danny Ongais,0,0,0,Danny Ongais
229,241,57,1978,Harald Ertl,Lamberto Leoni,0,0,0,Lamberto Leoni
235,239,57,1978,Jacky Ickx,Brett Lunger,0,0,0,Brett Lunger
235,240,57,1978,Jacky Ickx,Danny Ongais,0,0,0,Danny Ongais
235,241,57,1978,Jacky Ickx,Lamberto Leoni,0,0,0,Lamberto Leoni
239,240,57,1978,Brett Lunger,Danny Ongais,0,0,0,Danny Ongais
239,241,57,1978,Brett Lunger,Lamberto Leoni,0,0,0,Lamberto Leoni
240,241,57,1978,Danny Ongais,Lamberto Leoni,0,0,0,Lamberto Leoni
176,206,57,1979,Marc Surer,Derek Daly,0,0,0,Derek Daly
176,236,57,1979,Marc Surer,Patrick Gaillard,0,0,0,Patrick Gaillard
206,236,57,1979,Derek Daly,Patrick Gaillard,0,0,0,Patrick Gaillard
136,209,57,1980,Jan Lammers,Geoff Lees,0,0,0,Geoff Lees
136,223,57,1980,Jan Lammers,Clay Regazzoni,0,0,0,Clay Regazzoni
136,227,57,1980,Jan Lammers,Tiff Needell,0,0,0,Tiff Needell
209,223,57,1980,Geoff Lees,Clay Regazzoni,0,0,0,Clay Regazzoni
209,227,57,1980,Geoff Lees,Tiff Needell,0,0,0,Tiff Needell
223,227,57,1980,Clay Regazzoni,Tiff Needell,0,0,0,Tiff Needell
176,194,57,1981,Marc Surer,Eliseo Salazar,4,1,3,Marc Surer
176,218,57,1981,Marc Surer,Ricardo LondoÃ±o,4,0,4,Marc Surer
194,218,57,1981,Eliseo Salazar,Ricardo LondoÃ±o,1,0,1,Eliseo Salazar
262,289,58,1973,Jackie Oliver,Graham Hill,4,0,4,Jackie Oliver
262,312,58,1973,Jackie Oliver,Brian Redman,4,0,4,Jackie Oliver
262,332,58,1973,Jackie Oliver,George Follmer,4,5,1,George Follmer
289,312,58,1973,Graham Hill,Brian Redman,0,0,0,Brian Redman
289,332,58,1973,Graham Hill,George Follmer,0,5,5,George Follmer
312,332,58,1973,Brian Redman,George Follmer,0,5,5,George Follmer
197,252,58,1974,Jean-Pierre Jarier,Tom Pryce,6,1,5,Jean-Pierre Jarier
197,309,58,1974,Jean-Pierre Jarier,Peter Revson,6,0,6,Jean-Pierre Jarier
197,312,58,1974,Jean-Pierre Jarier,Brian Redman,6,0,6,Jean-Pierre Jarier
197,318,58,1974,Jean-Pierre Jarier,Bertil Roos,6,0,6,Jean-Pierre Jarier
252,309,58,1974,Tom Pryce,Peter Revson,1,0,1,Tom Pryce
252,312,58,1974,Tom Pryce,Brian Redman,1,0,1,Tom Pryce
252,318,58,1974,Tom Pryce,Bertil Roos,1,0,1,Tom Pryce
309,312,58,1974,Peter Revson,Brian Redman,0,0,0,Brian Redman
309,318,58,1974,Peter Revson,Bertil Roos,0,0,0,Bertil Roos
312,318,58,1974,Brian Redman,Bertil Roos,0,0,0,Bertil Roos
197,252,58,1976,Jean-Pierre Jarier,Tom Pryce,0,10,10,Tom Pryce
197,283,58,1976,Jean-Pierre Jarier,Mike Wilds,0,0,0,Mike Wilds
252,283,58,1976,Tom Pryce,Mike Wilds,10,0,10,Tom Pryce
119,178,58,1977,Riccardo Patrese,Alan Jones,1,22,21,Alan Jones
119,197,58,1977,Riccardo Patrese,Jean-Pierre Jarier,1,0,1,Riccardo Patrese
119,232,58,1977,Riccardo Patrese,Arturo Merzario,1,0,1,Riccardo Patrese
119,252,58,1977,Riccardo Patrese,Tom Pryce,1,0,1,Riccardo Patrese
119,254,58,1977,Riccardo Patrese,Renzo Zorzi,1,1,0,Renzo Zorzi
119,262,58,1977,Riccardo Patrese,Jackie Oliver,1,0,1,Riccardo Patrese
178,197,58,1977,Alan Jones,Jean-Pierre Jarier,22,0,22,Alan Jones
178,232,58,1977,Alan Jones,Arturo Merzario,22,0,22,Alan Jones
178,252,58,1977,Alan Jones,Tom Pryce,22,0,22,Alan Jones
178,254,58,1977,Alan Jones,Renzo Zorzi,22,1,21,Alan Jones
178,262,58,1977,Alan Jones,Jackie Oliver,22,0,22,Alan Jones
197,232,58,1977,Jean-Pierre Jarier,Arturo Merzario,0,0,0,Arturo Merzario
197,252,58,1977,Jean-Pierre Jarier,Tom Pryce,0,0,0,Tom Pryce
197,254,58,1977,Jean-Pierre Jarier,Renzo Zorzi,0,1,1,Renzo Zorzi
197,262,58,1977,Jean-Pierre Jarier,Jackie Oliver,0,0,0,Jackie Oliver
232,252,58,1977,Arturo Merzario,Tom Pryce,0,0,0,Tom Pryce
232,254,58,1977,Arturo Merzario,Renzo Zorzi,0,1,1,Renzo Zorzi
232,262,58,1977,Arturo Merzario,Jackie Oliver,0,0,0,Jackie Oliver
252,254,58,1977,Tom Pryce,Renzo Zorzi,0,1,1,Renzo Zorzi
252,262,58,1977,Tom Pryce,Jackie Oliver,0,0,0,Jackie Oliver
254,262,58,1977,Renzo Zorzi,Jackie Oliver,1,0,1,Renzo Zorzi
223,233,58,1978,Clay Regazzoni,Hans-Joachim Stuck,4,2,2,Clay Regazzoni
223,240,58,1978,Clay Regazzoni,Danny Ongais,4,0,4,Clay Regazzoni
233,240,58,1978,Hans-Joachim Stuck,Danny Ongais,2,0,2,Hans-Joachim Stuck
136,173,58,1979,Jan Lammers,Elio de Angelis,0,3,3,Elio de Angelis
140,209,58,1980,Stefan Johansson,Geoff Lees,0,0,0,Geoff Lees
140,225,58,1980,Stefan Johansson,Dave Kennedy,0,0,0,Dave Kennedy
209,225,58,1980,Geoff Lees,Dave Kennedy,0,0,0,Dave Kennedy
232,235,59,1976,Arturo Merzario,Jacky Ickx,0,0,0,Jacky Ickx
232,246,59,1976,Arturo Merzario,Hans Binder,0,0,0,Hans Binder
232,277,59,1976,Arturo Merzario,Michel LeclÃ¨re,0,0,0,Michel LeclÃ¨re
232,278,59,1976,Arturo Merzario,Chris Amon,0,0,0,Chris Amon
232,286,59,1976,Arturo Merzario,Warwick Brown,0,0,0,Warwick Brown
235,246,59,1976,Jacky Ickx,Hans Binder,0,0,0,Hans Binder
235,277,59,1976,Jacky Ickx,Michel LeclÃ¨re,0,0,0,Michel LeclÃ¨re
235,278,59,1976,Jacky Ickx,Chris Amon,0,0,0,Chris Amon
235,286,59,1976,Jacky Ickx,Warwick Brown,0,0,0,Warwick Brown
246,277,59,1976,Hans Binder,Michel LeclÃ¨re,0,0,0,Michel LeclÃ¨re
246,278,59,1976,Hans Binder,Chris Amon,0,0,0,Chris Amon
246,286,59,1976,Hans Binder,Warwick Brown,0,0,0,Warwick Brown
277,278,59,1976,Michel LeclÃ¨re,Chris Amon,0,0,0,Chris Amon
277,286,59,1976,Michel LeclÃ¨re,Warwick Brown,0,0,0,Warwick Brown
278,286,59,1976,Chris Amon,Warwick Brown,0,0,0,Warwick Brown
177,222,59,1978,Keke Rosberg,Jody Scheckter,0,24,24,Jody Scheckter
177,249,59,1978,Keke Rosberg,Bobby Rahal,0,0,0,Bobby Rahal
222,249,59,1978,Jody Scheckter,Bobby Rahal,24,0,24,Jody Scheckter
177,231,59,1979,Keke Rosberg,James Hunt,0,0,0,James Hunt
633,647,6,1950,Luigi Villoresi,Alberto Ascari,0,11,11,Alberto Ascari
633,687,6,1950,Luigi Villoresi,Peter Whitehead,0,4,4,Peter Whitehead
633,791,6,1950,Luigi Villoresi,Clemente Biondetti,0,0,0,Clemente Biondetti
633,793,6,1950,Luigi Villoresi,Raymond Sommer,0,3,3,Raymond Sommer
633,802,6,1950,Luigi Villoresi,Dorino Serafini,0,3,3,Dorino Serafini
647,687,6,1950,Alberto Ascari,Peter Whitehead,11,4,7,Alberto Ascari
647,791,6,1950,Alberto Ascari,Clemente Biondetti,11,0,11,Alberto Ascari
647,793,6,1950,Alberto Ascari,Raymond Sommer,11,3,8,Alberto Ascari
647,802,6,1950,Alberto Ascari,Dorino Serafini,11,3,8,Alberto Ascari
687,791,6,1950,Peter Whitehead,Clemente Biondetti,4,0,4,Peter Whitehead
687,793,6,1950,Peter Whitehead,Raymond Sommer,4,3,1,Peter Whitehead
687,802,6,1950,Peter Whitehead,Dorino Serafini,4,3,1,Peter Whitehead
791,793,6,1950,Clemente Biondetti,Raymond Sommer,0,3,3,Raymond Sommer
791,802,6,1950,Clemente Biondetti,Dorino Serafini,0,3,3,Dorino Serafini
793,802,6,1950,Raymond Sommer,Dorino Serafini,3,3,0,Dorino Serafini
498,622,6,1951,JosÃ© FroilÃ¡n GonzÃ¡lez,Chico Landi,27,0,27,JosÃ© FroilÃ¡n GonzÃ¡lez
498,633,6,1951,JosÃ© FroilÃ¡n GonzÃ¡lez,Luigi Villoresi,27,18,9,JosÃ© FroilÃ¡n GonzÃ¡lez
498,641,6,1951,JosÃ© FroilÃ¡n GonzÃ¡lez,Piero Taruffi,27,10,17,JosÃ© FroilÃ¡n GonzÃ¡lez
498,647,6,1951,JosÃ© FroilÃ¡n GonzÃ¡lez,Alberto Ascari,27,28,1,Alberto Ascari
498,686,6,1951,JosÃ© FroilÃ¡n GonzÃ¡lez,Reg Parnell,27,3,24,JosÃ© FroilÃ¡n GonzÃ¡lez
498,687,6,1951,JosÃ© FroilÃ¡n GonzÃ¡lez,Peter Whitehead,27,0,27,JosÃ© FroilÃ¡n GonzÃ¡lez
498,723,6,1951,JosÃ© FroilÃ¡n GonzÃ¡lez,Rudi Fischer,27,0,27,JosÃ© FroilÃ¡n GonzÃ¡lez
622,633,6,1951,Chico Landi,Luigi Villoresi,0,18,18,Luigi Villoresi
622,641,6,1951,Chico Landi,Piero Taruffi,0,10,10,Piero Taruffi
622,647,6,1951,Chico Landi,Alberto Ascari,0,28,28,Alberto Ascari
622,686,6,1951,Chico Landi,Reg Parnell,0,3,3,Reg Parnell
622,687,6,1951,Chico Landi,Peter Whitehead,0,0,0,Peter Whitehead
622,723,6,1951,Chico Landi,Rudi Fischer,0,0,0,Rudi Fischer
633,641,6,1951,Luigi Villoresi,Piero Taruffi,18,10,8,Luigi Villoresi
633,647,6,1951,Luigi Villoresi,Alberto Ascari,18,28,10,Alberto Ascari
633,686,6,1951,Luigi Villoresi,Reg Parnell,18,3,15,Luigi Villoresi
633,687,6,1951,Luigi Villoresi,Peter Whitehead,18,0,18,Luigi Villoresi
633,723,6,1951,Luigi Villoresi,Rudi Fischer,18,0,18,Luigi Villoresi
641,647,6,1951,Piero Taruffi,Alberto Ascari,10,28,18,Alberto Ascari
641,686,6,1951,Piero Taruffi,Reg Parnell,10,3,7,Piero Taruffi
641,687,6,1951,Piero Taruffi,Peter Whitehead,10,0,10,Piero Taruffi
641,723,6,1951,Piero Taruffi,Rudi Fischer,10,0,10,Piero Taruffi
647,686,6,1951,Alberto Ascari,Reg Parnell,28,3,25,Alberto Ascari
647,687,6,1951,Alberto Ascari,Peter Whitehead,28,0,28,Alberto Ascari
647,723,6,1951,Alberto Ascari,Rudi Fischer,28,0,28,Alberto Ascari
686,687,6,1951,Reg Parnell,Peter Whitehead,3,0,3,Reg Parnell
686,723,6,1951,Reg Parnell,Rudi Fischer,3,0,3,Reg Parnell
687,723,6,1951,Peter Whitehead,Rudi Fischer,0,0,0,Rudi Fischer
456,609,6,1952,Roy Salvadori,AndrÃ© Simon,0,0,0,AndrÃ© Simon
456,627,6,1952,Roy Salvadori,Louis Rosier,0,0,0,Louis Rosier
456,633,6,1952,Roy Salvadori,Luigi Villoresi,0,8,8,Luigi Villoresi
456,641,6,1952,Roy Salvadori,Piero Taruffi,0,22,22,Piero Taruffi
456,642,6,1952,Roy Salvadori,Nino Farina,0,27,27,Nino Farina
456,647,6,1952,Roy Salvadori,Alberto Ascari,0,53,53,Alberto Ascari
456,687,6,1952,Roy Salvadori,Peter Whitehead,0,0,0,Peter Whitehead
456,717,6,1952,Roy Salvadori,Hans von Stuck,0,0,0,Hans von Stuck
456,721,6,1952,Roy Salvadori,Peter Hirt,0,0,0,Peter Hirt
456,722,6,1952,Roy Salvadori,Piero Carini,0,0,0,Piero Carini
456,723,6,1952,Roy Salvadori,Rudi Fischer,0,10,10,Rudi Fischer
456,735,6,1952,Roy Salvadori,Charles de Tornaco,0,0,0,Charles de Tornaco
456,736,6,1952,Roy Salvadori,Roger Laurent,0,0,0,Roger Laurent
456,740,6,1952,Roy Salvadori,Franco Comotti,0,0,0,Franco Comotti
456,755,6,1952,Roy Salvadori,Rudolf Schoeller,0,0,0,Rudolf Schoeller
609,627,6,1952,AndrÃ© Simon,Louis Rosier,0,0,0,Louis Rosier
609,633,6,1952,AndrÃ© Simon,Luigi Villoresi,0,8,8,Luigi Villoresi
609,641,6,1952,AndrÃ© Simon,Piero Taruffi,0,22,22,Piero Taruffi
609,642,6,1952,AndrÃ© Simon,Nino Farina,0,27,27,Nino Farina
609,647,6,1952,AndrÃ© Simon,Alberto Ascari,0,53,53,Alberto Ascari
609,687,6,1952,AndrÃ© Simon,Peter Whitehead,0,0,0,Peter Whitehead
609,717,6,1952,AndrÃ© Simon,Hans von Stuck,0,0,0,Hans von Stuck
609,721,6,1952,AndrÃ© Simon,Peter Hirt,0,0,0,Peter Hirt
609,722,6,1952,AndrÃ© Simon,Piero Carini,0,0,0,Piero Carini
609,723,6,1952,AndrÃ© Simon,Rudi Fischer,0,10,10,Rudi Fischer
609,735,6,1952,AndrÃ© Simon,Charles de Tornaco,0,0,0,Charles de Tornaco
609,736,6,1952,AndrÃ© Simon,Roger Laurent,0,0,0,Roger Laurent
609,740,6,1952,AndrÃ© Simon,Franco Comotti,0,0,0,Franco Comotti
609,755,6,1952,AndrÃ© Simon,Rudolf Schoeller,0,0,0,Rudolf Schoeller
627,633,6,1952,Louis Rosier,Luigi Villoresi,0,8,8,Luigi Villoresi
627,641,6,1952,Louis Rosier,Piero Taruffi,0,22,22,Piero Taruffi
627,642,6,1952,Louis Rosier,Nino Farina,0,27,27,Nino Farina
627,647,6,1952,Louis Rosier,Alberto Ascari,0,53,53,Alberto Ascari
627,687,6,1952,Louis Rosier,Peter Whitehead,0,0,0,Peter Whitehead
627,717,6,1952,Louis Rosier,Hans von Stuck,0,0,0,Hans von Stuck
627,721,6,1952,Louis Rosier,Peter Hirt,0,0,0,Peter Hirt
627,722,6,1952,Louis Rosier,Piero Carini,0,0,0,Piero Carini
627,723,6,1952,Louis Rosier,Rudi Fischer,0,10,10,Rudi Fischer
627,735,6,1952,Louis Rosier,Charles de Tornaco,0,0,0,Charles de Tornaco
627,736,6,1952,Louis Rosier,Roger Laurent,0,0,0,Roger Laurent
627,740,6,1952,Louis Rosier,Franco Comotti,0,0,0,Franco Comotti
627,755,6,1952,Louis Rosier,Rudolf Schoeller,0,0,0,Rudolf Schoeller
633,641,6,1952,Luigi Villoresi,Piero Taruffi,8,22,14,Piero Taruffi
633,642,6,1952,Luigi Villoresi,Nino Farina,8,27,19,Nino Farina
633,647,6,1952,Luigi Villoresi,Alberto Ascari,8,53,45,Alberto Ascari
633,687,6,1952,Luigi Villoresi,Peter Whitehead,8,0,8,Luigi Villoresi
633,717,6,1952,Luigi Villoresi,Hans von Stuck,8,0,8,Luigi Villoresi
633,721,6,1952,Luigi Villoresi,Peter Hirt,8,0,8,Luigi Villoresi
633,722,6,1952,Luigi Villoresi,Piero Carini,8,0,8,Luigi Villoresi
633,723,6,1952,Luigi Villoresi,Rudi Fischer,8,10,2,Rudi Fischer
633,735,6,1952,Luigi Villoresi,Charles de Tornaco,8,0,8,Luigi Villoresi
633,736,6,1952,Luigi Villoresi,Roger Laurent,8,0,8,Luigi Villoresi
633,740,6,1952,Luigi Villoresi,Franco Comotti,8,0,8,Luigi Villoresi
633,755,6,1952,Luigi Villoresi,Rudolf Schoeller,8,0,8,Luigi Villoresi
641,642,6,1952,Piero Taruffi,Nino Farina,22,27,5,Nino Farina
641,647,6,1952,Piero Taruffi,Alberto Ascari,22,53,31,Alberto Ascari
641,687,6,1952,Piero Taruffi,Peter Whitehead,22,0,22,Piero Taruffi
641,717,6,1952,Piero Taruffi,Hans von Stuck,22,0,22,Piero Taruffi
641,721,6,1952,Piero Taruffi,Peter Hirt,22,0,22,Piero Taruffi
641,722,6,1952,Piero Taruffi,Piero Carini,22,0,22,Piero Taruffi
641,723,6,1952,Piero Taruffi,Rudi Fischer,22,10,12,Piero Taruffi
641,735,6,1952,Piero Taruffi,Charles de Tornaco,22,0,22,Piero Taruffi
641,736,6,1952,Piero Taruffi,Roger Laurent,22,0,22,Piero Taruffi
641,740,6,1952,Piero Taruffi,Franco Comotti,22,0,22,Piero Taruffi
641,755,6,1952,Piero Taruffi,Rudolf Schoeller,22,0,22,Piero Taruffi
642,647,6,1952,Nino Farina,Alberto Ascari,27,53,26,Alberto Ascari
642,687,6,1952,Nino Farina,Peter Whitehead,27,0,27,Nino Farina
642,717,6,1952,Nino Farina,Hans von Stuck,27,0,27,Nino Farina
642,721,6,1952,Nino Farina,Peter Hirt,27,0,27,Nino Farina
642,722,6,1952,Nino Farina,Piero Carini,27,0,27,Nino Farina
642,723,6,1952,Nino Farina,Rudi Fischer,27,10,17,Nino Farina
642,735,6,1952,Nino Farina,Charles de Tornaco,27,0,27,Nino Farina
642,736,6,1952,Nino Farina,Roger Laurent,27,0,27,Nino Farina
642,740,6,1952,Nino Farina,Franco Comotti,27,0,27,Nino Farina
642,755,6,1952,Nino Farina,Rudolf Schoeller,27,0,27,Nino Farina
647,687,6,1952,Alberto Ascari,Peter Whitehead,53,0,53,Alberto Ascari
647,717,6,1952,Alberto Ascari,Hans von Stuck,53,0,53,Alberto Ascari
647,721,6,1952,Alberto Ascari,Peter Hirt,53,0,53,Alberto Ascari
647,722,6,1952,Alberto Ascari,Piero Carini,53,0,53,Alberto Ascari
647,723,6,1952,Alberto Ascari,Rudi Fischer,53,10,43,Alberto Ascari
647,735,6,1952,Alberto Ascari,Charles de Tornaco,53,0,53,Alberto Ascari
647,736,6,1952,Alberto Ascari,Roger Laurent,53,0,53,Alberto Ascari
647,740,6,1952,Alberto Ascari,Franco Comotti,53,0,53,Alberto Ascari
647,755,6,1952,Alberto Ascari,Rudolf Schoeller,53,0,53,Alberto Ascari
687,717,6,1952,Peter Whitehead,Hans von Stuck,0,0,0,Hans von Stuck
687,721,6,1952,Peter Whitehead,Peter Hirt,0,0,0,Peter Hirt
687,722,6,1952,Peter Whitehead,Piero Carini,0,0,0,Piero Carini
687,723,6,1952,Peter Whitehead,Rudi Fischer,0,10,10,Rudi Fischer
687,735,6,1952,Peter Whitehead,Charles de Tornaco,0,0,0,Charles de Tornaco
687,736,6,1952,Peter Whitehead,Roger Laurent,0,0,0,Roger Laurent
687,740,6,1952,Peter Whitehead,Franco Comotti,0,0,0,Franco Comotti
687,755,6,1952,Peter Whitehead,Rudolf Schoeller,0,0,0,Rudolf Schoeller
717,721,6,1952,Hans von Stuck,Peter Hirt,0,0,0,Peter Hirt
717,722,6,1952,Hans von Stuck,Piero Carini,0,0,0,Piero Carini
717,723,6,1952,Hans von Stuck,Rudi Fischer,0,10,10,Rudi Fischer
717,735,6,1952,Hans von Stuck,Charles de Tornaco,0,0,0,Charles de Tornaco
717,736,6,1952,Hans von Stuck,Roger Laurent,0,0,0,Roger Laurent
717,740,6,1952,Hans von Stuck,Franco Comotti,0,0,0,Franco Comotti
717,755,6,1952,Hans von Stuck,Rudolf Schoeller,0,0,0,Rudolf Schoeller
721,722,6,1952,Peter Hirt,Piero Carini,0,0,0,Piero Carini
721,723,6,1952,Peter Hirt,Rudi Fischer,0,10,10,Rudi Fischer
721,735,6,1952,Peter Hirt,Charles de Tornaco,0,0,0,Charles de Tornaco
721,736,6,1952,Peter Hirt,Roger Laurent,0,0,0,Roger Laurent
721,740,6,1952,Peter Hirt,Franco Comotti,0,0,0,Franco Comotti
721,755,6,1952,Peter Hirt,Rudolf Schoeller,0,0,0,Rudolf Schoeller
722,723,6,1952,Piero Carini,Rudi Fischer,0,10,10,Rudi Fischer
722,735,6,1952,Piero Carini,Charles de Tornaco,0,0,0,Charles de Tornaco
722,736,6,1952,Piero Carini,Roger Laurent,0,0,0,Roger Laurent
722,740,6,1952,Piero Carini,Franco Comotti,0,0,0,Franco Comotti
722,755,6,1952,Piero Carini,Rudolf Schoeller,0,0,0,Rudolf Schoeller
723,735,6,1952,Rudi Fischer,Charles de Tornaco,10,0,10,Rudi Fischer
723,736,6,1952,Rudi Fischer,Roger Laurent,10,0,10,Rudi Fischer
723,740,6,1952,Rudi Fischer,Franco Comotti,10,0,10,Rudi Fischer
723,755,6,1952,Rudi Fischer,Rudolf Schoeller,10,0,10,Rudi Fischer
735,736,6,1952,Charles de Tornaco,Roger Laurent,0,0,0,Roger Laurent
735,740,6,1952,Charles de Tornaco,Franco Comotti,0,0,0,Franco Comotti
735,755,6,1952,Charles de Tornaco,Rudolf Schoeller,0,0,0,Rudolf Schoeller
736,740,6,1952,Roger Laurent,Franco Comotti,0,0,0,Franco Comotti
736,755,6,1952,Roger Laurent,Rudolf Schoeller,0,0,0,Rudolf Schoeller
740,755,6,1952,Franco Comotti,Rudolf Schoeller,0,0,0,Rudolf Schoeller
578,620,6,1953,Mike Hawthorn,Umberto Maglioli,27,0,27,Mike Hawthorn
578,627,6,1953,Mike Hawthorn,Louis Rosier,27,0,27,Mike Hawthorn
578,633,6,1953,Mike Hawthorn,Luigi Villoresi,27,17,10,Mike Hawthorn
578,642,6,1953,Mike Hawthorn,Nino Farina,27,32,5,Nino Farina
578,647,6,1953,Mike Hawthorn,Alberto Ascari,27,46,19,Alberto Ascari
578,680,6,1953,Mike Hawthorn,Jacques Swaters,27,0,27,Mike Hawthorn
578,714,6,1953,Mike Hawthorn,Kurt Adolff,27,0,27,Mike Hawthorn
578,720,6,1953,Mike Hawthorn,Max de Terra,27,0,27,Mike Hawthorn
578,721,6,1953,Mike Hawthorn,Peter Hirt,27,0,27,Mike Hawthorn
578,722,6,1953,Mike Hawthorn,Piero Carini,27,0,27,Mike Hawthorn
620,627,6,1953,Umberto Maglioli,Louis Rosier,0,0,0,Louis Rosier
620,633,6,1953,Umberto Maglioli,Luigi Villoresi,0,17,17,Luigi Villoresi
620,642,6,1953,Umberto Maglioli,Nino Farina,0,32,32,Nino Farina
620,647,6,1953,Umberto Maglioli,Alberto Ascari,0,46,46,Alberto Ascari
620,680,6,1953,Umberto Maglioli,Jacques Swaters,0,0,0,Jacques Swaters
620,714,6,1953,Umberto Maglioli,Kurt Adolff,0,0,0,Kurt Adolff
620,720,6,1953,Umberto Maglioli,Max de Terra,0,0,0,Max de Terra
620,721,6,1953,Umberto Maglioli,Peter Hirt,0,0,0,Peter Hirt
620,722,6,1953,Umberto Maglioli,Piero Carini,0,0,0,Piero Carini
627,633,6,1953,Louis Rosier,Luigi Villoresi,0,17,17,Luigi Villoresi
627,642,6,1953,Louis Rosier,Nino Farina,0,32,32,Nino Farina
627,647,6,1953,Louis Rosier,Alberto Ascari,0,46,46,Alberto Ascari
627,680,6,1953,Louis Rosier,Jacques Swaters,0,0,0,Jacques Swaters
627,714,6,1953,Louis Rosier,Kurt Adolff,0,0,0,Kurt Adolff
627,720,6,1953,Louis Rosier,Max de Terra,0,0,0,Max de Terra
627,721,6,1953,Louis Rosier,Peter Hirt,0,0,0,Peter Hirt
627,722,6,1953,Louis Rosier,Piero Carini,0,0,0,Piero Carini
633,642,6,1953,Luigi Villoresi,Nino Farina,17,32,15,Nino Farina
633,647,6,1953,Luigi Villoresi,Alberto Ascari,17,46,29,Alberto Ascari
633,680,6,1953,Luigi Villoresi,Jacques Swaters,17,0,17,Luigi Villoresi
633,714,6,1953,Luigi Villoresi,Kurt Adolff,17,0,17,Luigi Villoresi
633,720,6,1953,Luigi Villoresi,Max de Terra,17,0,17,Luigi Villoresi
633,721,6,1953,Luigi Villoresi,Peter Hirt,17,0,17,Luigi Villoresi
633,722,6,1953,Luigi Villoresi,Piero Carini,17,0,17,Luigi Villoresi
642,647,6,1953,Nino Farina,Alberto Ascari,32,46,14,Alberto Ascari
642,680,6,1953,Nino Farina,Jacques Swaters,32,0,32,Nino Farina
642,714,6,1953,Nino Farina,Kurt Adolff,32,0,32,Nino Farina
642,720,6,1953,Nino Farina,Max de Terra,32,0,32,Nino Farina
642,721,6,1953,Nino Farina,Peter Hirt,32,0,32,Nino Farina
642,722,6,1953,Nino Farina,Piero Carini,32,0,32,Nino Farina
647,680,6,1953,Alberto Ascari,Jacques Swaters,46,0,46,Alberto Ascari
647,714,6,1953,Alberto Ascari,Kurt Adolff,46,0,46,Alberto Ascari
647,720,6,1953,Alberto Ascari,Max de Terra,46,0,46,Alberto Ascari
647,721,6,1953,Alberto Ascari,Peter Hirt,46,0,46,Alberto Ascari
647,722,6,1953,Alberto Ascari,Piero Carini,46,0,46,Alberto Ascari
680,714,6,1953,Jacques Swaters,Kurt Adolff,0,0,0,Kurt Adolff
680,720,6,1953,Jacques Swaters,Max de Terra,0,0,0,Max de Terra
680,721,6,1953,Jacques Swaters,Peter Hirt,0,0,0,Peter Hirt
680,722,6,1953,Jacques Swaters,Piero Carini,0,0,0,Piero Carini
714,720,6,1953,Kurt Adolff,Max de Terra,0,0,0,Max de Terra
714,721,6,1953,Kurt Adolff,Peter Hirt,0,0,0,Peter Hirt
714,722,6,1953,Kurt Adolff,Piero Carini,0,0,0,Piero Carini
720,721,6,1953,Max de Terra,Peter Hirt,0,0,0,Peter Hirt
720,722,6,1953,Max de Terra,Piero Carini,0,0,0,Piero Carini
721,722,6,1953,Peter Hirt,Piero Carini,0,0,0,Piero Carini
427,498,6,1954,Maurice Trintignant,JosÃ© FroilÃ¡n GonzÃ¡lez,17,27,10,JosÃ© FroilÃ¡n GonzÃ¡lez
427,578,6,1954,Maurice Trintignant,Mike Hawthorn,17,25,8,Mike Hawthorn
427,620,6,1954,Maurice Trintignant,Umberto Maglioli,17,2,15,Maurice Trintignant
427,626,6,1954,Maurice Trintignant,Robert Manzon,17,4,13,Maurice Trintignant
427,627,6,1954,Maurice Trintignant,Louis Rosier,17,0,17,Maurice Trintignant
427,641,6,1954,Maurice Trintignant,Piero Taruffi,17,0,17,Maurice Trintignant
427,642,6,1954,Maurice Trintignant,Nino Farina,17,6,11,Maurice Trintignant
427,647,6,1954,Maurice Trintignant,Alberto Ascari,17,0,17,Maurice Trintignant
427,680,6,1954,Maurice Trintignant,Jacques Swaters,17,0,17,Maurice Trintignant
427,686,6,1954,Maurice Trintignant,Reg Parnell,17,0,17,Maurice Trintignant
498,578,6,1954,JosÃ© FroilÃ¡n GonzÃ¡lez,Mike Hawthorn,27,25,2,JosÃ© FroilÃ¡n GonzÃ¡lez
498,620,6,1954,JosÃ© FroilÃ¡n GonzÃ¡lez,Umberto Maglioli,27,2,25,JosÃ© FroilÃ¡n GonzÃ¡lez
498,626,6,1954,JosÃ© FroilÃ¡n GonzÃ¡lez,Robert Manzon,27,4,23,JosÃ© FroilÃ¡n GonzÃ¡lez
498,627,6,1954,JosÃ© FroilÃ¡n GonzÃ¡lez,Louis Rosier,27,0,27,JosÃ© FroilÃ¡n GonzÃ¡lez
498,641,6,1954,JosÃ© FroilÃ¡n GonzÃ¡lez,Piero Taruffi,27,0,27,JosÃ© FroilÃ¡n GonzÃ¡lez
498,642,6,1954,JosÃ© FroilÃ¡n GonzÃ¡lez,Nino Farina,27,6,21,JosÃ© FroilÃ¡n GonzÃ¡lez
498,647,6,1954,JosÃ© FroilÃ¡n GonzÃ¡lez,Alberto Ascari,27,0,27,JosÃ© FroilÃ¡n GonzÃ¡lez
498,680,6,1954,JosÃ© FroilÃ¡n GonzÃ¡lez,Jacques Swaters,27,0,27,JosÃ© FroilÃ¡n GonzÃ¡lez
498,686,6,1954,JosÃ© FroilÃ¡n GonzÃ¡lez,Reg Parnell,27,0,27,JosÃ© FroilÃ¡n GonzÃ¡lez
578,620,6,1954,Mike Hawthorn,Umberto Maglioli,25,2,23,Mike Hawthorn
578,626,6,1954,Mike Hawthorn,Robert Manzon,25,4,21,Mike Hawthorn
578,627,6,1954,Mike Hawthorn,Louis Rosier,25,0,25,Mike Hawthorn
578,641,6,1954,Mike Hawthorn,Piero Taruffi,25,0,25,Mike Hawthorn
578,642,6,1954,Mike Hawthorn,Nino Farina,25,6,19,Mike Hawthorn
578,647,6,1954,Mike Hawthorn,Alberto Ascari,25,0,25,Mike Hawthorn
578,680,6,1954,Mike Hawthorn,Jacques Swaters,25,0,25,Mike Hawthorn
578,686,6,1954,Mike Hawthorn,Reg Parnell,25,0,25,Mike Hawthorn
620,626,6,1954,Umberto Maglioli,Robert Manzon,2,4,2,Robert Manzon
620,627,6,1954,Umberto Maglioli,Louis Rosier,2,0,2,Umberto Maglioli
620,641,6,1954,Umberto Maglioli,Piero Taruffi,2,0,2,Umberto Maglioli
620,642,6,1954,Umberto Maglioli,Nino Farina,2,6,4,Nino Farina
620,647,6,1954,Umberto Maglioli,Alberto Ascari,2,0,2,Umberto Maglioli
620,680,6,1954,Umberto Maglioli,Jacques Swaters,2,0,2,Umberto Maglioli
620,686,6,1954,Umberto Maglioli,Reg Parnell,2,0,2,Umberto Maglioli
626,627,6,1954,Robert Manzon,Louis Rosier,4,0,4,Robert Manzon
626,641,6,1954,Robert Manzon,Piero Taruffi,4,0,4,Robert Manzon
626,642,6,1954,Robert Manzon,Nino Farina,4,6,2,Nino Farina
626,647,6,1954,Robert Manzon,Alberto Ascari,4,0,4,Robert Manzon
626,680,6,1954,Robert Manzon,Jacques Swaters,4,0,4,Robert Manzon
626,686,6,1954,Robert Manzon,Reg Parnell,4,0,4,Robert Manzon
627,641,6,1954,Louis Rosier,Piero Taruffi,0,0,0,Piero Taruffi
627,642,6,1954,Louis Rosier,Nino Farina,0,6,6,Nino Farina
627,647,6,1954,Louis Rosier,Alberto Ascari,0,0,0,Alberto Ascari
627,680,6,1954,Louis Rosier,Jacques Swaters,0,0,0,Jacques Swaters
627,686,6,1954,Louis Rosier,Reg Parnell,0,0,0,Reg Parnell
641,642,6,1954,Piero Taruffi,Nino Farina,0,6,6,Nino Farina
641,647,6,1954,Piero Taruffi,Alberto Ascari,0,0,0,Alberto Ascari
641,680,6,1954,Piero Taruffi,Jacques Swaters,0,0,0,Jacques Swaters
641,686,6,1954,Piero Taruffi,Reg Parnell,0,0,0,Reg Parnell
642,647,6,1954,Nino Farina,Alberto Ascari,6,0,6,Nino Farina
642,680,6,1954,Nino Farina,Jacques Swaters,6,0,6,Nino Farina
642,686,6,1954,Nino Farina,Reg Parnell,6,0,6,Nino Farina
647,680,6,1954,Alberto Ascari,Jacques Swaters,0,0,0,Jacques Swaters
647,686,6,1954,Alberto Ascari,Reg Parnell,0,0,0,Reg Parnell
680,686,6,1954,Jacques Swaters,Reg Parnell,0,0,0,Reg Parnell
427,498,6,1955,Maurice Trintignant,JosÃ© FroilÃ¡n GonzÃ¡lez,11,2,9,Maurice Trintignant
427,501,6,1955,Maurice Trintignant,Harry Schell,11,0,11,Maurice Trintignant
427,578,6,1955,Maurice Trintignant,Mike Hawthorn,11,0,11,Maurice Trintignant
427,608,6,1955,Maurice Trintignant,Eugenio Castellotti,11,6,5,Maurice Trintignant
427,620,6,1955,Maurice Trintignant,Umberto Maglioli,11,1,10,Maurice Trintignant
427,632,6,1955,Maurice Trintignant,Paul FrÃ¨re,11,3,8,Maurice Trintignant
427,633,6,1955,Maurice Trintignant,Luigi Villoresi,11,0,11,Maurice Trintignant
427,641,6,1955,Maurice Trintignant,Piero Taruffi,11,0,11,Maurice Trintignant
427,642,6,1955,Maurice Trintignant,Nino Farina,11,10,1,Maurice Trintignant
427,660,6,1955,Maurice Trintignant,Johnny Claes,11,0,11,Maurice Trintignant
498,501,6,1955,JosÃ© FroilÃ¡n GonzÃ¡lez,Harry Schell,2,0,2,JosÃ© FroilÃ¡n GonzÃ¡lez
498,578,6,1955,JosÃ© FroilÃ¡n GonzÃ¡lez,Mike Hawthorn,2,0,2,JosÃ© FroilÃ¡n GonzÃ¡lez
498,608,6,1955,JosÃ© FroilÃ¡n GonzÃ¡lez,Eugenio Castellotti,2,6,4,Eugenio Castellotti
498,620,6,1955,JosÃ© FroilÃ¡n GonzÃ¡lez,Umberto Maglioli,2,1,1,JosÃ© FroilÃ¡n GonzÃ¡lez
498,632,6,1955,JosÃ© FroilÃ¡n GonzÃ¡lez,Paul FrÃ¨re,2,3,1,Paul FrÃ¨re
498,633,6,1955,JosÃ© FroilÃ¡n GonzÃ¡lez,Luigi Villoresi,2,0,2,JosÃ© FroilÃ¡n GonzÃ¡lez
498,641,6,1955,JosÃ© FroilÃ¡n GonzÃ¡lez,Piero Taruffi,2,0,2,JosÃ© FroilÃ¡n GonzÃ¡lez
498,642,6,1955,JosÃ© FroilÃ¡n GonzÃ¡lez,Nino Farina,2,10,8,Nino Farina
498,660,6,1955,JosÃ© FroilÃ¡n GonzÃ¡lez,Johnny Claes,2,0,2,JosÃ© FroilÃ¡n GonzÃ¡lez
501,578,6,1955,Harry Schell,Mike Hawthorn,0,0,0,Mike Hawthorn
501,608,6,1955,Harry Schell,Eugenio Castellotti,0,6,6,Eugenio Castellotti
501,620,6,1955,Harry Schell,Umberto Maglioli,0,1,1,Umberto Maglioli
501,632,6,1955,Harry Schell,Paul FrÃ¨re,0,3,3,Paul FrÃ¨re
501,633,6,1955,Harry Schell,Luigi Villoresi,0,0,0,Luigi Villoresi
501,641,6,1955,Harry Schell,Piero Taruffi,0,0,0,Piero Taruffi
501,642,6,1955,Harry Schell,Nino Farina,0,10,10,Nino Farina
501,660,6,1955,Harry Schell,Johnny Claes,0,0,0,Johnny Claes
578,608,6,1955,Mike Hawthorn,Eugenio Castellotti,0,6,6,Eugenio Castellotti
578,620,6,1955,Mike Hawthorn,Umberto Maglioli,0,1,1,Umberto Maglioli
578,632,6,1955,Mike Hawthorn,Paul FrÃ¨re,0,3,3,Paul FrÃ¨re
578,633,6,1955,Mike Hawthorn,Luigi Villoresi,0,0,0,Luigi Villoresi
578,641,6,1955,Mike Hawthorn,Piero Taruffi,0,0,0,Piero Taruffi
578,642,6,1955,Mike Hawthorn,Nino Farina,0,10,10,Nino Farina
578,660,6,1955,Mike Hawthorn,Johnny Claes,0,0,0,Johnny Claes
608,620,6,1955,Eugenio Castellotti,Umberto Maglioli,6,1,5,Eugenio Castellotti
608,632,6,1955,Eugenio Castellotti,Paul FrÃ¨re,6,3,3,Eugenio Castellotti
608,633,6,1955,Eugenio Castellotti,Luigi Villoresi,6,0,6,Eugenio Castellotti
608,641,6,1955,Eugenio Castellotti,Piero Taruffi,6,0,6,Eugenio Castellotti
608,642,6,1955,Eugenio Castellotti,Nino Farina,6,10,4,Nino Farina
608,660,6,1955,Eugenio Castellotti,Johnny Claes,6,0,6,Eugenio Castellotti
620,632,6,1955,Umberto Maglioli,Paul FrÃ¨re,1,3,2,Paul FrÃ¨re
620,633,6,1955,Umberto Maglioli,Luigi Villoresi,1,0,1,Umberto Maglioli
620,641,6,1955,Umberto Maglioli,Piero Taruffi,1,0,1,Umberto Maglioli
620,642,6,1955,Umberto Maglioli,Nino Farina,1,10,9,Nino Farina
620,660,6,1955,Umberto Maglioli,Johnny Claes,1,0,1,Umberto Maglioli
632,633,6,1955,Paul FrÃ¨re,Luigi Villoresi,3,0,3,Paul FrÃ¨re
632,641,6,1955,Paul FrÃ¨re,Piero Taruffi,3,0,3,Paul FrÃ¨re
632,642,6,1955,Paul FrÃ¨re,Nino Farina,3,10,7,Nino Farina
632,660,6,1955,Paul FrÃ¨re,Johnny Claes,3,0,3,Paul FrÃ¨re
633,641,6,1955,Luigi Villoresi,Piero Taruffi,0,0,0,Piero Taruffi
633,642,6,1955,Luigi Villoresi,Nino Farina,0,10,10,Nino Farina
633,660,6,1955,Luigi Villoresi,Johnny Claes,0,0,0,Johnny Claes
641,642,6,1955,Piero Taruffi,Nino Farina,0,10,10,Nino Farina
641,660,6,1955,Piero Taruffi,Johnny Claes,0,0,0,Johnny Claes
642,660,6,1955,Nino Farina,Johnny Claes,10,0,10,Nino Farina
429,476,6,1956,AndrÃ© Pilette,Wolfgang von Trips,0,0,0,Wolfgang von Trips
429,482,6,1956,AndrÃ© Pilette,Olivier Gendebien,0,2,2,Olivier Gendebien
429,483,6,1956,AndrÃ© Pilette,Giorgio Scarlatti,0,0,0,Giorgio Scarlatti
429,577,6,1956,AndrÃ© Pilette,Luigi Musso,0,4,4,Luigi Musso
429,579,6,1956,AndrÃ© Pilette,Juan Fangio,0,35,35,Juan Fangio
429,581,6,1956,AndrÃ© Pilette,Peter Collins,0,25,25,Peter Collins
429,606,6,1956,AndrÃ© Pilette,Alfonso de Portago,0,3,3,Alfonso de Portago
429,608,6,1956,AndrÃ© Pilette,Eugenio Castellotti,0,8,8,Eugenio Castellotti
429,632,6,1956,AndrÃ© Pilette,Paul FrÃ¨re,0,6,6,Paul FrÃ¨re
476,482,6,1956,Wolfgang von Trips,Olivier Gendebien,0,2,2,Olivier Gendebien
476,483,6,1956,Wolfgang von Trips,Giorgio Scarlatti,0,0,0,Giorgio Scarlatti
476,577,6,1956,Wolfgang von Trips,Luigi Musso,0,4,4,Luigi Musso
476,579,6,1956,Wolfgang von Trips,Juan Fangio,0,35,35,Juan Fangio
476,581,6,1956,Wolfgang von Trips,Peter Collins,0,25,25,Peter Collins
476,606,6,1956,Wolfgang von Trips,Alfonso de Portago,0,3,3,Alfonso de Portago
476,608,6,1956,Wolfgang von Trips,Eugenio Castellotti,0,8,8,Eugenio Castellotti
476,632,6,1956,Wolfgang von Trips,Paul FrÃ¨re,0,6,6,Paul FrÃ¨re
482,483,6,1956,Olivier Gendebien,Giorgio Scarlatti,2,0,2,Olivier Gendebien
482,577,6,1956,Olivier Gendebien,Luigi Musso,2,4,2,Luigi Musso
482,579,6,1956,Olivier Gendebien,Juan Fangio,2,35,33,Juan Fangio
482,581,6,1956,Olivier Gendebien,Peter Collins,2,25,23,Peter Collins
482,606,6,1956,Olivier Gendebien,Alfonso de Portago,2,3,1,Alfonso de Portago
482,608,6,1956,Olivier Gendebien,Eugenio Castellotti,2,8,6,Eugenio Castellotti
482,632,6,1956,Olivier Gendebien,Paul FrÃ¨re,2,6,4,Paul FrÃ¨re
483,577,6,1956,Giorgio Scarlatti,Luigi Musso,0,4,4,Luigi Musso
483,579,6,1956,Giorgio Scarlatti,Juan Fangio,0,35,35,Juan Fangio
483,581,6,1956,Giorgio Scarlatti,Peter Collins,0,25,25,Peter Collins
483,606,6,1956,Giorgio Scarlatti,Alfonso de Portago,0,3,3,Alfonso de Portago
483,608,6,1956,Giorgio Scarlatti,Eugenio Castellotti,0,8,8,Eugenio Castellotti
483,632,6,1956,Giorgio Scarlatti,Paul FrÃ¨re,0,6,6,Paul FrÃ¨re
577,579,6,1956,Luigi Musso,Juan Fangio,4,35,31,Juan Fangio
577,581,6,1956,Luigi Musso,Peter Collins,4,25,21,Peter Collins
577,606,6,1956,Luigi Musso,Alfonso de Portago,4,3,1,Luigi Musso
577,608,6,1956,Luigi Musso,Eugenio Castellotti,4,8,4,Eugenio Castellotti
577,632,6,1956,Luigi Musso,Paul FrÃ¨re,4,6,2,Paul FrÃ¨re
579,581,6,1956,Juan Fangio,Peter Collins,35,25,10,Juan Fangio
579,606,6,1956,Juan Fangio,Alfonso de Portago,35,3,32,Juan Fangio
579,608,6,1956,Juan Fangio,Eugenio Castellotti,35,8,27,Juan Fangio
579,632,6,1956,Juan Fangio,Paul FrÃ¨re,35,6,29,Juan Fangio
581,606,6,1956,Peter Collins,Alfonso de Portago,25,3,22,Peter Collins
581,608,6,1956,Peter Collins,Eugenio Castellotti,25,8,17,Peter Collins
581,632,6,1956,Peter Collins,Paul FrÃ¨re,25,6,19,Peter Collins
606,608,6,1956,Alfonso de Portago,Eugenio Castellotti,3,8,5,Eugenio Castellotti
606,632,6,1956,Alfonso de Portago,Paul FrÃ¨re,3,6,3,Paul FrÃ¨re
608,632,6,1956,Eugenio Castellotti,Paul FrÃ¨re,8,6,2,Eugenio Castellotti
427,476,6,1957,Maurice Trintignant,Wolfgang von Trips,5,4,1,Maurice Trintignant
427,498,6,1957,Maurice Trintignant,JosÃ© FroilÃ¡n GonzÃ¡lez,5,1,4,Maurice Trintignant
427,573,6,1957,Maurice Trintignant,Alessandro de Tomaso,5,0,5,Maurice Trintignant
427,577,6,1957,Maurice Trintignant,Luigi Musso,5,16,11,Luigi Musso
427,578,6,1957,Maurice Trintignant,Mike Hawthorn,5,13,8,Mike Hawthorn
427,581,6,1957,Maurice Trintignant,Peter Collins,5,8,3,Peter Collins
427,606,6,1957,Maurice Trintignant,Alfonso de Portago,5,1,4,Maurice Trintignant
427,607,6,1957,Maurice Trintignant,Cesare Perdisa,5,0,5,Maurice Trintignant
427,608,6,1957,Maurice Trintignant,Eugenio Castellotti,5,0,5,Maurice Trintignant
476,498,6,1957,Wolfgang von Trips,JosÃ© FroilÃ¡n GonzÃ¡lez,4,1,3,Wolfgang von Trips
476,573,6,1957,Wolfgang von Trips,Alessandro de Tomaso,4,0,4,Wolfgang von Trips
476,577,6,1957,Wolfgang von Trips,Luigi Musso,4,16,12,Luigi Musso
476,578,6,1957,Wolfgang von Trips,Mike Hawthorn,4,13,9,Mike Hawthorn
476,581,6,1957,Wolfgang von Trips,Peter Collins,4,8,4,Peter Collins
476,606,6,1957,Wolfgang von Trips,Alfonso de Portago,4,1,3,Wolfgang von Trips
476,607,6,1957,Wolfgang von Trips,Cesare Perdisa,4,0,4,Wolfgang von Trips
476,608,6,1957,Wolfgang von Trips,Eugenio Castellotti,4,0,4,Wolfgang von Trips
498,573,6,1957,JosÃ© FroilÃ¡n GonzÃ¡lez,Alessandro de Tomaso,1,0,1,JosÃ© FroilÃ¡n GonzÃ¡lez
498,577,6,1957,JosÃ© FroilÃ¡n GonzÃ¡lez,Luigi Musso,1,16,15,Luigi Musso
498,578,6,1957,JosÃ© FroilÃ¡n GonzÃ¡lez,Mike Hawthorn,1,13,12,Mike Hawthorn
498,581,6,1957,JosÃ© FroilÃ¡n GonzÃ¡lez,Peter Collins,1,8,7,Peter Collins
498,606,6,1957,JosÃ© FroilÃ¡n GonzÃ¡lez,Alfonso de Portago,1,1,0,Alfonso de Portago
498,607,6,1957,JosÃ© FroilÃ¡n GonzÃ¡lez,Cesare Perdisa,1,0,1,JosÃ© FroilÃ¡n GonzÃ¡lez
498,608,6,1957,JosÃ© FroilÃ¡n GonzÃ¡lez,Eugenio Castellotti,1,0,1,JosÃ© FroilÃ¡n GonzÃ¡lez
573,577,6,1957,Alessandro de Tomaso,Luigi Musso,0,16,16,Luigi Musso
573,578,6,1957,Alessandro de Tomaso,Mike Hawthorn,0,13,13,Mike Hawthorn
573,581,6,1957,Alessandro de Tomaso,Peter Collins,0,8,8,Peter Collins
573,606,6,1957,Alessandro de Tomaso,Alfonso de Portago,0,1,1,Alfonso de Portago
573,607,6,1957,Alessandro de Tomaso,Cesare Perdisa,0,0,0,Cesare Perdisa
573,608,6,1957,Alessandro de Tomaso,Eugenio Castellotti,0,0,0,Eugenio Castellotti
577,578,6,1957,Luigi Musso,Mike Hawthorn,16,13,3,Luigi Musso
577,581,6,1957,Luigi Musso,Peter Collins,16,8,8,Luigi Musso
577,606,6,1957,Luigi Musso,Alfonso de Portago,16,1,15,Luigi Musso
577,607,6,1957,Luigi Musso,Cesare Perdisa,16,0,16,Luigi Musso
577,608,6,1957,Luigi Musso,Eugenio Castellotti,16,0,16,Luigi Musso
578,581,6,1957,Mike Hawthorn,Peter Collins,13,8,5,Mike Hawthorn
578,606,6,1957,Mike Hawthorn,Alfonso de Portago,13,1,12,Mike Hawthorn
578,607,6,1957,Mike Hawthorn,Cesare Perdisa,13,0,13,Mike Hawthorn
578,608,6,1957,Mike Hawthorn,Eugenio Castellotti,13,0,13,Mike Hawthorn
581,606,6,1957,Peter Collins,Alfonso de Portago,8,1,7,Peter Collins
581,607,6,1957,Peter Collins,Cesare Perdisa,8,0,8,Peter Collins
581,608,6,1957,Peter Collins,Eugenio Castellotti,8,0,8,Peter Collins
606,607,6,1957,Alfonso de Portago,Cesare Perdisa,1,0,1,Alfonso de Portago
606,608,6,1957,Alfonso de Portago,Eugenio Castellotti,1,0,1,Alfonso de Portago
607,608,6,1957,Cesare Perdisa,Eugenio Castellotti,0,0,0,Eugenio Castellotti
403,476,6,1958,Phil Hill,Wolfgang von Trips,9,9,0,Wolfgang von Trips
403,482,6,1958,Phil Hill,Olivier Gendebien,9,0,9,Phil Hill
403,577,6,1958,Phil Hill,Luigi Musso,9,12,3,Luigi Musso
403,578,6,1958,Phil Hill,Mike Hawthorn,9,49,40,Mike Hawthorn
403,581,6,1958,Phil Hill,Peter Collins,9,14,5,Peter Collins
476,482,6,1958,Wolfgang von Trips,Olivier Gendebien,9,0,9,Wolfgang von Trips
476,577,6,1958,Wolfgang von Trips,Luigi Musso,9,12,3,Luigi Musso
476,578,6,1958,Wolfgang von Trips,Mike Hawthorn,9,49,40,Mike Hawthorn
476,581,6,1958,Wolfgang von Trips,Peter Collins,9,14,5,Peter Collins
482,577,6,1958,Olivier Gendebien,Luigi Musso,0,12,12,Luigi Musso
482,578,6,1958,Olivier Gendebien,Mike Hawthorn,0,49,49,Mike Hawthorn
482,581,6,1958,Olivier Gendebien,Peter Collins,0,14,14,Peter Collins
577,578,6,1958,Luigi Musso,Mike Hawthorn,12,49,37,Mike Hawthorn
577,581,6,1958,Luigi Musso,Peter Collins,12,14,2,Peter Collins
578,581,6,1958,Mike Hawthorn,Peter Collins,49,14,35,Mike Hawthorn
364,403,6,1959,Dan Gurney,Phil Hill,13,20,7,Phil Hill
364,476,6,1959,Dan Gurney,Wolfgang von Trips,13,0,13,Dan Gurney
364,477,6,1959,Dan Gurney,Cliff Allison,13,2,11,Dan Gurney
364,479,6,1959,Dan Gurney,Tony Brooks,13,27,14,Tony Brooks
364,482,6,1959,Dan Gurney,Olivier Gendebien,13,3,10,Dan Gurney
364,554,6,1959,Dan Gurney,Jean Behra,13,2,11,Dan Gurney
403,476,6,1959,Phil Hill,Wolfgang von Trips,20,0,20,Phil Hill
403,477,6,1959,Phil Hill,Cliff Allison,20,2,18,Phil Hill
403,479,6,1959,Phil Hill,Tony Brooks,20,27,7,Tony Brooks
403,482,6,1959,Phil Hill,Olivier Gendebien,20,3,17,Phil Hill
403,554,6,1959,Phil Hill,Jean Behra,20,2,18,Phil Hill
476,477,6,1959,Wolfgang von Trips,Cliff Allison,0,2,2,Cliff Allison
476,479,6,1959,Wolfgang von Trips,Tony Brooks,0,27,27,Tony Brooks
476,482,6,1959,Wolfgang von Trips,Olivier Gendebien,0,3,3,Olivier Gendebien
476,554,6,1959,Wolfgang von Trips,Jean Behra,0,2,2,Jean Behra
477,479,6,1959,Cliff Allison,Tony Brooks,2,27,25,Tony Brooks
477,482,6,1959,Cliff Allison,Olivier Gendebien,2,3,1,Olivier Gendebien
477,554,6,1959,Cliff Allison,Jean Behra,2,2,0,Jean Behra
479,482,6,1959,Tony Brooks,Olivier Gendebien,27,3,24,Tony Brooks
479,554,6,1959,Tony Brooks,Jean Behra,27,2,25,Tony Brooks
482,554,6,1959,Olivier Gendebien,Jean Behra,3,2,1,Olivier Gendebien
386,403,6,1960,Richie Ginther,Phil Hill,8,15,7,Phil Hill
386,435,6,1960,Richie Ginther,Willy Mairesse,8,4,4,Richie Ginther
386,476,6,1960,Richie Ginther,Wolfgang von Trips,8,10,2,Wolfgang von Trips
386,477,6,1960,Richie Ginther,Cliff Allison,8,6,2,Richie Ginther
386,498,6,1960,Richie Ginther,JosÃ© FroilÃ¡n GonzÃ¡lez,8,0,8,Richie Ginther
403,435,6,1960,Phil Hill,Willy Mairesse,15,4,11,Phil Hill
403,476,6,1960,Phil Hill,Wolfgang von Trips,15,10,5,Phil Hill
403,477,6,1960,Phil Hill,Cliff Allison,15,6,9,Phil Hill
403,498,6,1960,Phil Hill,JosÃ© FroilÃ¡n GonzÃ¡lez,15,0,15,Phil Hill
435,476,6,1960,Willy Mairesse,Wolfgang von Trips,4,10,6,Wolfgang von Trips
435,477,6,1960,Willy Mairesse,Cliff Allison,4,6,2,Cliff Allison
435,498,6,1960,Willy Mairesse,JosÃ© FroilÃ¡n GonzÃ¡lez,4,0,4,Willy Mairesse
476,477,6,1960,Wolfgang von Trips,Cliff Allison,10,6,4,Wolfgang von Trips
476,498,6,1960,Wolfgang von Trips,JosÃ© FroilÃ¡n GonzÃ¡lez,10,0,10,Wolfgang von Trips
477,498,6,1960,Cliff Allison,JosÃ© FroilÃ¡n GonzÃ¡lez,6,0,6,Cliff Allison
386,394,6,1961,Richie Ginther,Giancarlo Baghetti,16,9,7,Richie Ginther
386,403,6,1961,Richie Ginther,Phil Hill,16,38,22,Phil Hill
386,435,6,1961,Richie Ginther,Willy Mairesse,16,0,16,Richie Ginther
386,454,6,1961,Richie Ginther,Ricardo RodrÃ­guez,16,0,16,Richie Ginther
386,476,6,1961,Richie Ginther,Wolfgang von Trips,16,33,17,Wolfgang von Trips
386,482,6,1961,Richie Ginther,Olivier Gendebien,16,3,13,Richie Ginther
394,403,6,1961,Giancarlo Baghetti,Phil Hill,9,38,29,Phil Hill
394,435,6,1961,Giancarlo Baghetti,Willy Mairesse,9,0,9,Giancarlo Baghetti
394,454,6,1961,Giancarlo Baghetti,Ricardo RodrÃ­guez,9,0,9,Giancarlo Baghetti
394,476,6,1961,Giancarlo Baghetti,Wolfgang von Trips,9,33,24,Wolfgang von Trips
394,482,6,1961,Giancarlo Baghetti,Olivier Gendebien,9,3,6,Giancarlo Baghetti
403,435,6,1961,Phil Hill,Willy Mairesse,38,0,38,Phil Hill
403,454,6,1961,Phil Hill,Ricardo RodrÃ­guez,38,0,38,Phil Hill
403,476,6,1961,Phil Hill,Wolfgang von Trips,38,33,5,Phil Hill
403,482,6,1961,Phil Hill,Olivier Gendebien,38,3,35,Phil Hill
435,454,6,1961,Willy Mairesse,Ricardo RodrÃ­guez,0,0,0,Ricardo RodrÃ­guez
435,476,6,1961,Willy Mairesse,Wolfgang von Trips,0,33,33,Wolfgang von Trips
435,482,6,1961,Willy Mairesse,Olivier Gendebien,0,3,3,Olivier Gendebien
454,476,6,1961,Ricardo RodrÃ­guez,Wolfgang von Trips,0,33,33,Wolfgang von Trips
454,482,6,1961,Ricardo RodrÃ­guez,Olivier Gendebien,0,3,3,Olivier Gendebien
476,482,6,1961,Wolfgang von Trips,Olivier Gendebien,33,3,30,Wolfgang von Trips
385,394,6,1962,Lorenzo Bandini,Giancarlo Baghetti,4,5,1,Giancarlo Baghetti
385,403,6,1962,Lorenzo Bandini,Phil Hill,4,14,10,Phil Hill
385,435,6,1962,Lorenzo Bandini,Willy Mairesse,4,3,1,Lorenzo Bandini
385,454,6,1962,Lorenzo Bandini,Ricardo RodrÃ­guez,4,4,0,Ricardo RodrÃ­guez
394,403,6,1962,Giancarlo Baghetti,Phil Hill,5,14,9,Phil Hill
394,435,6,1962,Giancarlo Baghetti,Willy Mairesse,5,3,2,Giancarlo Baghetti
394,454,6,1962,Giancarlo Baghetti,Ricardo RodrÃ­guez,5,4,1,Giancarlo Baghetti
403,435,6,1962,Phil Hill,Willy Mairesse,14,3,11,Phil Hill
403,454,6,1962,Phil Hill,Ricardo RodrÃ­guez,14,4,10,Phil Hill
435,454,6,1962,Willy Mairesse,Ricardo RodrÃ­guez,3,4,1,Ricardo RodrÃ­guez
341,375,6,1963,John Surtees,Ludovico Scarfiotti,22,1,21,John Surtees
341,385,6,1963,John Surtees,Lorenzo Bandini,22,4,18,John Surtees
341,435,6,1963,John Surtees,Willy Mairesse,22,0,22,John Surtees
375,385,6,1963,Ludovico Scarfiotti,Lorenzo Bandini,1,4,3,Lorenzo Bandini
375,435,6,1963,Ludovico Scarfiotti,Willy Mairesse,1,0,1,Ludovico Scarfiotti
385,435,6,1963,Lorenzo Bandini,Willy Mairesse,4,0,4,Lorenzo Bandini
341,345,6,1964,John Surtees,Pedro RodrÃ­guez,40,1,39,John Surtees
341,375,6,1964,John Surtees,Ludovico Scarfiotti,40,0,40,John Surtees
341,385,6,1964,John Surtees,Lorenzo Bandini,40,23,17,John Surtees
345,375,6,1964,Pedro RodrÃ­guez,Ludovico Scarfiotti,1,0,1,Pedro RodrÃ­guez
345,385,6,1964,Pedro RodrÃ­guez,Lorenzo Bandini,1,23,22,Lorenzo Bandini
375,385,6,1964,Ludovico Scarfiotti,Lorenzo Bandini,0,23,23,Lorenzo Bandini
341,345,6,1965,John Surtees,Pedro RodrÃ­guez,17,2,15,John Surtees
341,375,6,1965,John Surtees,Ludovico Scarfiotti,17,0,17,John Surtees
341,385,6,1965,John Surtees,Lorenzo Bandini,17,13,4,John Surtees
341,396,6,1965,John Surtees,Bob Bondurant,17,0,17,John Surtees
341,425,6,1965,John Surtees,Nino Vaccarella,17,0,17,John Surtees
345,375,6,1965,Pedro RodrÃ­guez,Ludovico Scarfiotti,2,0,2,Pedro RodrÃ­guez
345,385,6,1965,Pedro RodrÃ­guez,Lorenzo Bandini,2,13,11,Lorenzo Bandini
345,396,6,1965,Pedro RodrÃ­guez,Bob Bondurant,2,0,2,Pedro RodrÃ­guez
345,425,6,1965,Pedro RodrÃ­guez,Nino Vaccarella,2,0,2,Pedro RodrÃ­guez
375,385,6,1965,Ludovico Scarfiotti,Lorenzo Bandini,0,13,13,Lorenzo Bandini
375,396,6,1965,Ludovico Scarfiotti,Bob Bondurant,0,0,0,Bob Bondurant
375,425,6,1965,Ludovico Scarfiotti,Nino Vaccarella,0,0,0,Nino Vaccarella
385,396,6,1965,Lorenzo Bandini,Bob Bondurant,13,0,13,Lorenzo Bandini
385,425,6,1965,Lorenzo Bandini,Nino Vaccarella,13,0,13,Lorenzo Bandini
396,425,6,1965,Bob Bondurant,Nino Vaccarella,0,0,0,Nino Vaccarella
341,375,6,1966,John Surtees,Ludovico Scarfiotti,9,9,0,Ludovico Scarfiotti
341,385,6,1966,John Surtees,Lorenzo Bandini,9,12,3,Lorenzo Bandini
341,387,6,1966,John Surtees,Mike Parkes,9,12,3,Mike Parkes
341,394,6,1966,John Surtees,Giancarlo Baghetti,9,0,9,John Surtees
375,385,6,1966,Ludovico Scarfiotti,Lorenzo Bandini,9,12,3,Lorenzo Bandini
375,387,6,1966,Ludovico Scarfiotti,Mike Parkes,9,12,3,Mike Parkes
375,394,6,1966,Ludovico Scarfiotti,Giancarlo Baghetti,9,0,9,Ludovico Scarfiotti
385,387,6,1966,Lorenzo Bandini,Mike Parkes,12,12,0,Mike Parkes
385,394,6,1966,Lorenzo Bandini,Giancarlo Baghetti,12,0,12,Lorenzo Bandini
387,394,6,1966,Mike Parkes,Giancarlo Baghetti,12,0,12,Mike Parkes
278,375,6,1967,Chris Amon,Ludovico Scarfiotti,20,1,19,Chris Amon
278,385,6,1967,Chris Amon,Lorenzo Bandini,20,0,20,Chris Amon
278,387,6,1967,Chris Amon,Mike Parkes,20,2,18,Chris Amon
278,395,6,1967,Chris Amon,Jonathan Williams,20,0,20,Chris Amon
375,385,6,1967,Ludovico Scarfiotti,Lorenzo Bandini,1,0,1,Ludovico Scarfiotti
375,387,6,1967,Ludovico Scarfiotti,Mike Parkes,1,2,1,Mike Parkes
375,395,6,1967,Ludovico Scarfiotti,Jonathan Williams,1,0,1,Ludovico Scarfiotti
385,387,6,1967,Lorenzo Bandini,Mike Parkes,0,2,2,Mike Parkes
385,395,6,1967,Lorenzo Bandini,Jonathan Williams,0,0,0,Jonathan Williams
387,395,6,1967,Mike Parkes,Jonathan Williams,2,0,2,Mike Parkes
235,278,6,1968,Jacky Ickx,Chris Amon,27,10,17,Jacky Ickx
235,321,6,1968,Jacky Ickx,Derek Bell,27,0,27,Jacky Ickx
235,333,6,1968,Jacky Ickx,Andrea de Adamich,27,0,27,Jacky Ickx
278,321,6,1968,Chris Amon,Derek Bell,10,0,10,Chris Amon
278,333,6,1968,Chris Amon,Andrea de Adamich,10,0,10,Chris Amon
321,333,6,1968,Derek Bell,Andrea de Adamich,0,0,0,Andrea de Adamich
278,345,6,1969,Chris Amon,Pedro RodrÃ­guez,4,3,1,Chris Amon
223,235,6,1970,Clay Regazzoni,Jacky Ickx,33,40,7,Jacky Ickx
223,363,6,1970,Clay Regazzoni,Ignazio Giunti,33,3,30,Clay Regazzoni
235,363,6,1970,Jacky Ickx,Ignazio Giunti,40,3,37,Jacky Ickx
207,223,6,1971,Mario Andretti,Clay Regazzoni,12,13,1,Clay Regazzoni
207,235,6,1971,Mario Andretti,Jacky Ickx,12,19,7,Jacky Ickx
223,235,6,1971,Clay Regazzoni,Jacky Ickx,13,19,6,Jacky Ickx
207,223,6,1972,Mario Andretti,Clay Regazzoni,4,15,11,Clay Regazzoni
207,232,6,1972,Mario Andretti,Arturo Merzario,4,1,3,Mario Andretti
207,235,6,1972,Mario Andretti,Jacky Ickx,4,27,23,Jacky Ickx
207,330,6,1972,Mario Andretti,Nanni Galli,4,0,4,Mario Andretti
223,232,6,1972,Clay Regazzoni,Arturo Merzario,15,1,14,Clay Regazzoni
223,235,6,1972,Clay Regazzoni,Jacky Ickx,15,27,12,Jacky Ickx
223,330,6,1972,Clay Regazzoni,Nanni Galli,15,0,15,Clay Regazzoni
232,235,6,1972,Arturo Merzario,Jacky Ickx,1,27,26,Jacky Ickx
232,330,6,1972,Arturo Merzario,Nanni Galli,1,0,1,Arturo Merzario
235,330,6,1972,Jacky Ickx,Nanni Galli,27,0,27,Jacky Ickx
232,235,6,1973,Arturo Merzario,Jacky Ickx,6,8,2,Jacky Ickx
182,223,6,1974,Niki Lauda,Clay Regazzoni,38,52,14,Clay Regazzoni
182,223,6,1975,Niki Lauda,Clay Regazzoni,64,25,39,Niki Lauda
182,199,6,1976,Niki Lauda,Carlos Reutemann,68,0,68,Niki Lauda
182,223,6,1976,Niki Lauda,Clay Regazzoni,68,31,37,Niki Lauda
199,223,6,1976,Carlos Reutemann,Clay Regazzoni,0,31,31,Clay Regazzoni
182,199,6,1977,Niki Lauda,Carlos Reutemann,72,42,30,Niki Lauda
182,203,6,1977,Niki Lauda,Gilles Villeneuve,72,0,72,Niki Lauda
199,203,6,1977,Carlos Reutemann,Gilles Villeneuve,42,0,42,Carlos Reutemann
199,203,6,1978,Carlos Reutemann,Gilles Villeneuve,48,17,31,Carlos Reutemann
203,222,6,1979,Gilles Villeneuve,Jody Scheckter,53,60,7,Jody Scheckter
203,222,6,1980,Gilles Villeneuve,Jody Scheckter,6,2,4,Gilles Villeneuve
202,203,6,1981,Didier Pironi,Gilles Villeneuve,9,25,16,Gilles Villeneuve
175,202,6,1982,Patrick Tambay,Didier Pironi,25,39,14,Didier Pironi
175,203,6,1982,Patrick Tambay,Gilles Villeneuve,25,6,19,Patrick Tambay
175,207,6,1982,Patrick Tambay,Mario Andretti,25,4,21,Patrick Tambay
202,203,6,1982,Didier Pironi,Gilles Villeneuve,39,6,33,Didier Pironi
202,207,6,1982,Didier Pironi,Mario Andretti,39,4,35,Didier Pironi
203,207,6,1982,Gilles Villeneuve,Mario Andretti,6,4,2,Gilles Villeneuve
163,175,6,1983,RenÃ© Arnoux,Patrick Tambay,49,40,9,RenÃ© Arnoux
105,163,6,1984,Michele Alboreto,RenÃ© Arnoux,30,27,3,Michele Alboreto
105,140,6,1985,Michele Alboreto,Stefan Johansson,53,26,27,Michele Alboreto
105,163,6,1985,Michele Alboreto,RenÃ© Arnoux,53,3,50,Michele Alboreto
140,163,6,1985,Stefan Johansson,RenÃ© Arnoux,26,3,23,Stefan Johansson
105,140,6,1986,Michele Alboreto,Stefan Johansson,14,23,9,Stefan Johansson
105,77,6,1987,Michele Alboreto,Gerhard Berger,17,36,19,Gerhard Berger
105,77,6,1988,Michele Alboreto,Gerhard Berger,24,41,17,Gerhard Berger
77,95,6,1989,Gerhard Berger,Nigel Mansell,21,38,17,Nigel Mansell
117,95,6,1990,Alain Prost,Nigel Mansell,73,37,36,Alain Prost
117,55,6,1991,Alain Prost,Jean Alesi,34,21,13,Alain Prost
117,81,6,1991,Alain Prost,Gianni Morbidelli,34,0,34,Alain Prost
55,81,6,1991,Jean Alesi,Gianni Morbidelli,21,0,21,Jean Alesi
122,55,6,1992,Ivan Capelli,Jean Alesi,3,18,15,Jean Alesi
122,78,6,1992,Ivan Capelli,Nicola Larini,3,0,3,Ivan Capelli
55,78,6,1992,Jean Alesi,Nicola Larini,18,0,18,Jean Alesi
55,77,6,1993,Jean Alesi,Gerhard Berger,16,12,4,Jean Alesi
55,77,6,1994,Jean Alesi,Gerhard Berger,24,41,17,Gerhard Berger
55,78,6,1994,Jean Alesi,Nicola Larini,24,6,18,Jean Alesi
77,78,6,1994,Gerhard Berger,Nicola Larini,41,6,35,Gerhard Berger
55,77,6,1995,Jean Alesi,Gerhard Berger,42,31,11,Jean Alesi
30,56,6,1996,Michael Schumacher,Eddie Irvine,59,11,48,Michael Schumacher
30,56,6,1997,Michael Schumacher,Eddie Irvine,78,24,54,Michael Schumacher
30,56,6,1998,Michael Schumacher,Eddie Irvine,86,47,39,Michael Schumacher
30,56,6,1999,Michael Schumacher,Eddie Irvine,44,74,30,Eddie Irvine
30,63,6,1999,Michael Schumacher,Mika Salo,44,10,34,Michael Schumacher
56,63,6,1999,Eddie Irvine,Mika Salo,74,10,64,Eddie Irvine
22,30,6,2000,Rubens Barrichello,Michael Schumacher,62,108,46,Michael Schumacher
22,30,6,2001,Rubens Barrichello,Michael Schumacher,56,123,67,Michael Schumacher
22,30,6,2002,Rubens Barrichello,Michael Schumacher,77,144,67,Michael Schumacher
22,30,6,2003,Rubens Barrichello,Michael Schumacher,65,93,28,Michael Schumacher
22,30,6,2004,Rubens Barrichello,Michael Schumacher,114,148,34,Michael Schumacher
22,30,6,2005,Rubens Barrichello,Michael Schumacher,38,62,24,Michael Schumacher
13,30,6,2006,Felipe Massa,Michael Schumacher,80,121,41,Michael Schumacher
13,8,6,2007,Felipe Massa,Kimi RÃ¤ikkÃ¶nen,94,110,16,Kimi RÃ¤ikkÃ¶nen
13,8,6,2008,Felipe Massa,Kimi RÃ¤ikkÃ¶nen,97,75,22,Felipe Massa
13,21,6,2009,Felipe Massa,Giancarlo Fisichella,22,0,22,Felipe Massa
13,69,6,2009,Felipe Massa,Luca Badoer,22,0,22,Felipe Massa
13,8,6,2009,Felipe Massa,Kimi RÃ¤ikkÃ¶nen,22,48,26,Kimi RÃ¤ikkÃ¶nen
21,69,6,2009,Giancarlo Fisichella,Luca Badoer,0,0,0,Luca Badoer
21,8,6,2009,Giancarlo Fisichella,Kimi RÃ¤ikkÃ¶nen,0,48,48,Kimi RÃ¤ikkÃ¶nen
69,8,6,2009,Luca Badoer,Kimi RÃ¤ikkÃ¶nen,0,48,48,Kimi RÃ¤ikkÃ¶nen
13,4,6,2010,Felipe Massa,Fernando Alonso,144,252,108,Fernando Alonso
13,4,6,2011,Felipe Massa,Fernando Alonso,118,257,139,Fernando Alonso
13,4,6,2012,Felipe Massa,Fernando Alonso,122,278,156,Fernando Alonso
13,4,6,2013,Felipe Massa,Fernando Alonso,112,242,130,Fernando Alonso
4,8,6,2014,Fernando Alonso,Kimi RÃ¤ikkÃ¶nen,161,55,106,Fernando Alonso
20,8,6,2015,Sebastian Vettel,Kimi RÃ¤ikkÃ¶nen,278,150,128,Sebastian Vettel
20,8,6,2016,Sebastian Vettel,Kimi RÃ¤ikkÃ¶nen,212,186,26,Sebastian Vettel
20,8,6,2017,Sebastian Vettel,Kimi RÃ¤ikkÃ¶nen,317,205,112,Sebastian Vettel
20,8,6,2018,Sebastian Vettel,Kimi RÃ¤ikkÃ¶nen,320,251,69,Sebastian Vettel
20,844,6,2019,Sebastian Vettel,Charles Leclerc,240,264,24,Charles Leclerc
20,844,6,2020,Sebastian Vettel,Charles Leclerc,33,98,65,Charles Leclerc
832,844,6,2021,Carlos Sainz,Charles Leclerc,163,159,4,Carlos Sainz
832,844,6,2022,Carlos Sainz,Charles Leclerc,228,291,63,Charles Leclerc
832,844,6,2023,Carlos Sainz,Charles Leclerc,178,185,7,Charles Leclerc
832,844,6,2024,Carlos Sainz,Charles Leclerc,134,136,2,Charles Leclerc
832,860,6,2024,Carlos Sainz,Oliver Bearman,134,6,128,Carlos Sainz
844,860,6,2024,Charles Leclerc,Oliver Bearman,136,6,130,Charles Leclerc
232,244,60,1978,Arturo Merzario,Alberto Colombo,0,0,0,Alberto Colombo
232,234,60,1979,Arturo Merzario,Gianfranco Brancatelli,0,0,0,Gianfranco Brancatelli
321,341,63,1970,Derek Bell,John Surtees,1,2,1,John Surtees
243,298,63,1971,Rolf Stommelen,Gijs van Lennep,3,0,3,Rolf Stommelen
243,305,63,1971,Rolf Stommelen,Mike Hailwood,3,3,0,Mike Hailwood
243,312,63,1971,Rolf Stommelen,Brian Redman,3,0,3,Rolf Stommelen
243,321,63,1971,Rolf Stommelen,Derek Bell,3,0,3,Rolf Stommelen
243,341,63,1971,Rolf Stommelen,John Surtees,3,3,0,John Surtees
243,344,63,1971,Rolf Stommelen,Sam Posey,3,0,3,Rolf Stommelen
298,305,63,1971,Gijs van Lennep,Mike Hailwood,0,3,3,Mike Hailwood
298,312,63,1971,Gijs van Lennep,Brian Redman,0,0,0,Brian Redman
298,321,63,1971,Gijs van Lennep,Derek Bell,0,0,0,Derek Bell
298,341,63,1971,Gijs van Lennep,John Surtees,0,3,3,John Surtees
298,344,63,1971,Gijs van Lennep,Sam Posey,0,0,0,Sam Posey
305,312,63,1971,Mike Hailwood,Brian Redman,3,0,3,Mike Hailwood
305,321,63,1971,Mike Hailwood,Derek Bell,3,0,3,Mike Hailwood
305,341,63,1971,Mike Hailwood,John Surtees,3,3,0,John Surtees
305,344,63,1971,Mike Hailwood,Sam Posey,3,0,3,Mike Hailwood
312,321,63,1971,Brian Redman,Derek Bell,0,0,0,Derek Bell
312,341,63,1971,Brian Redman,John Surtees,0,3,3,John Surtees
312,344,63,1971,Brian Redman,Sam Posey,0,0,0,Sam Posey
321,341,63,1971,Derek Bell,John Surtees,0,3,3,John Surtees
321,344,63,1971,Derek Bell,Sam Posey,0,0,0,Sam Posey
341,344,63,1971,John Surtees,Sam Posey,3,0,3,John Surtees
305,314,63,1972,Mike Hailwood,Tim Schenken,13,2,11,Mike Hailwood
305,333,63,1972,Mike Hailwood,Andrea de Adamich,13,3,10,Mike Hailwood
305,340,63,1972,Mike Hailwood,John Love,13,0,13,Mike Hailwood
305,341,63,1972,Mike Hailwood,John Surtees,13,0,13,Mike Hailwood
305,344,63,1972,Mike Hailwood,Sam Posey,13,0,13,Mike Hailwood
314,333,63,1972,Tim Schenken,Andrea de Adamich,2,3,1,Andrea de Adamich
314,340,63,1972,Tim Schenken,John Love,2,0,2,Tim Schenken
314,341,63,1972,Tim Schenken,John Surtees,2,0,2,Tim Schenken
314,344,63,1972,Tim Schenken,Sam Posey,2,0,2,Tim Schenken
333,340,63,1972,Andrea de Adamich,John Love,3,0,3,Andrea de Adamich
333,341,63,1972,Andrea de Adamich,John Surtees,3,0,3,Andrea de Adamich
333,344,63,1972,Andrea de Adamich,Sam Posey,3,0,3,Andrea de Adamich
340,341,63,1972,John Love,John Surtees,0,0,0,John Surtees
340,344,63,1972,John Love,Sam Posey,0,0,0,Sam Posey
341,344,63,1972,John Surtees,Sam Posey,0,0,0,Sam Posey
200,250,63,1973,Jochen Mass,Carlos Pace,0,7,7,Carlos Pace
200,305,63,1973,Jochen Mass,Mike Hailwood,0,0,0,Mike Hailwood
200,331,63,1973,Jochen Mass,Luiz Bueno,0,0,0,Luiz Bueno
200,333,63,1973,Jochen Mass,Andrea de Adamich,0,0,0,Andrea de Adamich
250,305,63,1973,Carlos Pace,Mike Hailwood,7,0,7,Carlos Pace
250,331,63,1973,Carlos Pace,Luiz Bueno,7,0,7,Carlos Pace
250,333,63,1973,Carlos Pace,Andrea de Adamich,7,0,7,Carlos Pace
305,331,63,1973,Mike Hailwood,Luiz Bueno,0,0,0,Luiz Bueno
305,333,63,1973,Mike Hailwood,Andrea de Adamich,0,0,0,Andrea de Adamich
331,333,63,1973,Luiz Bueno,Andrea de Adamich,0,0,0,Andrea de Adamich
200,219,63,1974,Jochen Mass,Jean-Pierre Jabouille,0,0,0,Jean-Pierre Jabouille
200,250,63,1974,Jochen Mass,Carlos Pace,0,3,3,Carlos Pace
200,316,63,1974,Jochen Mass,Leo Kinnunen,0,0,0,Leo Kinnunen
200,319,63,1974,Jochen Mass,JosÃ© Dolhem,0,0,0,JosÃ© Dolhem
200,321,63,1974,Jochen Mass,Derek Bell,0,0,0,Derek Bell
200,323,63,1974,Jochen Mass,Dieter Quester,0,0,0,Dieter Quester
200,324,63,1974,Jochen Mass,Helmuth Koinigg,0,0,0,Helmuth Koinigg
219,250,63,1974,Jean-Pierre Jabouille,Carlos Pace,0,3,3,Carlos Pace
219,316,63,1974,Jean-Pierre Jabouille,Leo Kinnunen,0,0,0,Leo Kinnunen
219,319,63,1974,Jean-Pierre Jabouille,JosÃ© Dolhem,0,0,0,JosÃ© Dolhem
219,321,63,1974,Jean-Pierre Jabouille,Derek Bell,0,0,0,Derek Bell
219,323,63,1974,Jean-Pierre Jabouille,Dieter Quester,0,0,0,Dieter Quester
219,324,63,1974,Jean-Pierre Jabouille,Helmuth Koinigg,0,0,0,Helmuth Koinigg
250,316,63,1974,Carlos Pace,Leo Kinnunen,3,0,3,Carlos Pace
250,319,63,1974,Carlos Pace,JosÃ© Dolhem,3,0,3,Carlos Pace
250,321,63,1974,Carlos Pace,Derek Bell,3,0,3,Carlos Pace
250,323,63,1974,Carlos Pace,Dieter Quester,3,0,3,Carlos Pace
250,324,63,1974,Carlos Pace,Helmuth Koinigg,3,0,3,Carlos Pace
316,319,63,1974,Leo Kinnunen,JosÃ© Dolhem,0,0,0,JosÃ© Dolhem
316,321,63,1974,Leo Kinnunen,Derek Bell,0,0,0,Derek Bell
316,323,63,1974,Leo Kinnunen,Dieter Quester,0,0,0,Dieter Quester
316,324,63,1974,Leo Kinnunen,Helmuth Koinigg,0,0,0,Helmuth Koinigg
319,321,63,1974,JosÃ© Dolhem,Derek Bell,0,0,0,Derek Bell
319,323,63,1974,JosÃ© Dolhem,Dieter Quester,0,0,0,Dieter Quester
319,324,63,1974,JosÃ© Dolhem,Helmuth Koinigg,0,0,0,Helmuth Koinigg
321,323,63,1974,Derek Bell,Dieter Quester,0,0,0,Dieter Quester
321,324,63,1974,Derek Bell,Helmuth Koinigg,0,0,0,Helmuth Koinigg
323,324,63,1974,Dieter Quester,Helmuth Koinigg,0,0,0,Helmuth Koinigg
187,301,63,1975,John Watson,Dave Morgan,0,0,0,Dave Morgan
178,239,63,1976,Alan Jones,Brett Lunger,7,0,7,Alan Jones
178,242,63,1976,Alan Jones,Divina Galica,7,0,7,Alan Jones
178,260,63,1976,Alan Jones,Conny Andersson,7,0,7,Alan Jones
178,274,63,1976,Alan Jones,Noritake Takahara,7,0,7,Alan Jones
178,280,63,1976,Alan Jones,Henri Pescarolo,7,0,7,Alan Jones
239,242,63,1976,Brett Lunger,Divina Galica,0,0,0,Divina Galica
239,260,63,1976,Brett Lunger,Conny Andersson,0,0,0,Conny Andersson
239,274,63,1976,Brett Lunger,Noritake Takahara,0,0,0,Noritake Takahara
239,280,63,1976,Brett Lunger,Henri Pescarolo,0,0,0,Henri Pescarolo
242,260,63,1976,Divina Galica,Conny Andersson,0,0,0,Conny Andersson
242,274,63,1976,Divina Galica,Noritake Takahara,0,0,0,Noritake Takahara
242,280,63,1976,Divina Galica,Henri Pescarolo,0,0,0,Henri Pescarolo
260,274,63,1976,Conny Andersson,Noritake Takahara,0,0,0,Noritake Takahara
260,280,63,1976,Conny Andersson,Henri Pescarolo,0,0,0,Henri Pescarolo
274,280,63,1976,Noritake Takahara,Henri Pescarolo,0,0,0,Henri Pescarolo
175,230,63,1977,Patrick Tambay,Vittorio Brambilla,0,6,6,Vittorio Brambilla
175,241,63,1977,Patrick Tambay,Lamberto Leoni,0,0,0,Lamberto Leoni
175,245,63,1977,Patrick Tambay,Tony Trimmer,0,0,0,Tony Trimmer
175,246,63,1977,Patrick Tambay,Hans Binder,0,0,0,Hans Binder
175,256,63,1977,Patrick Tambay,Larry Perkins,0,0,0,Larry Perkins
175,267,63,1977,Patrick Tambay,Vern Schuppan,0,0,0,Vern Schuppan
230,241,63,1977,Vittorio Brambilla,Lamberto Leoni,6,0,6,Vittorio Brambilla
230,245,63,1977,Vittorio Brambilla,Tony Trimmer,6,0,6,Vittorio Brambilla
230,246,63,1977,Vittorio Brambilla,Hans Binder,6,0,6,Vittorio Brambilla
230,256,63,1977,Vittorio Brambilla,Larry Perkins,6,0,6,Vittorio Brambilla
230,267,63,1977,Vittorio Brambilla,Vern Schuppan,6,0,6,Vittorio Brambilla
241,245,63,1977,Lamberto Leoni,Tony Trimmer,0,0,0,Tony Trimmer
241,246,63,1977,Lamberto Leoni,Hans Binder,0,0,0,Hans Binder
241,256,63,1977,Lamberto Leoni,Larry Perkins,0,0,0,Larry Perkins
241,267,63,1977,Lamberto Leoni,Vern Schuppan,0,0,0,Vern Schuppan
245,246,63,1977,Tony Trimmer,Hans Binder,0,0,0,Hans Binder
245,256,63,1977,Tony Trimmer,Larry Perkins,0,0,0,Larry Perkins
245,267,63,1977,Tony Trimmer,Vern Schuppan,0,0,0,Vern Schuppan
246,256,63,1977,Hans Binder,Larry Perkins,0,0,0,Larry Perkins
246,267,63,1977,Hans Binder,Vern Schuppan,0,0,0,Vern Schuppan
256,267,63,1977,Larry Perkins,Vern Schuppan,0,0,0,Vern Schuppan
163,211,63,1978,RenÃ© Arnoux,Rupert Keegan,0,0,0,Rupert Keegan
163,213,63,1978,RenÃ© Arnoux,Beppe Gabbiani,0,0,0,Beppe Gabbiani
163,230,63,1978,RenÃ© Arnoux,Vittorio Brambilla,0,1,1,Vittorio Brambilla
163,248,63,1978,RenÃ© Arnoux,Carlo Franchi,0,0,0,Carlo Franchi
211,213,63,1978,Rupert Keegan,Beppe Gabbiani,0,0,0,Beppe Gabbiani
211,230,63,1978,Rupert Keegan,Vittorio Brambilla,0,1,1,Vittorio Brambilla
211,248,63,1978,Rupert Keegan,Carlo Franchi,0,0,0,Carlo Franchi
213,230,63,1978,Beppe Gabbiani,Vittorio Brambilla,0,1,1,Vittorio Brambilla
213,248,63,1978,Beppe Gabbiani,Carlo Franchi,0,0,0,Carlo Franchi
230,248,63,1978,Vittorio Brambilla,Carlo Franchi,1,0,1,Vittorio Brambilla
231,251,64,1974,James Hunt,Ian Scheckter,15,0,15,James Hunt
178,229,64,1975,Alan Jones,Harald Ertl,0,0,0,Harald Ertl
178,231,64,1975,Alan Jones,James Hunt,0,33,33,James Hunt
178,239,64,1975,Alan Jones,Brett Lunger,0,0,0,Brett Lunger
178,297,64,1975,Alan Jones,Torsten Palm,0,0,0,Torsten Palm
229,231,64,1975,Harald Ertl,James Hunt,0,33,33,James Hunt
229,239,64,1975,Harald Ertl,Brett Lunger,0,0,0,Brett Lunger
229,297,64,1975,Harald Ertl,Torsten Palm,0,0,0,Torsten Palm
231,239,64,1975,James Hunt,Brett Lunger,33,0,33,James Hunt
231,297,64,1975,James Hunt,Torsten Palm,33,0,33,James Hunt
239,297,64,1975,Brett Lunger,Torsten Palm,0,0,0,Torsten Palm
229,237,64,1976,Harald Ertl,Alex Ribeiro,0,0,0,Alex Ribeiro
229,243,64,1976,Harald Ertl,Rolf Stommelen,0,0,0,Rolf Stommelen
229,265,64,1976,Harald Ertl,Guy Edwards,0,0,0,Guy Edwards
237,243,64,1976,Alex Ribeiro,Rolf Stommelen,0,0,0,Rolf Stommelen
237,265,64,1976,Alex Ribeiro,Guy Edwards,0,0,0,Guy Edwards
243,265,64,1976,Rolf Stommelen,Guy Edwards,0,0,0,Guy Edwards
211,212,64,1977,Rupert Keegan,Hector Rebaque,0,0,0,Hector Rebaque
211,229,64,1977,Rupert Keegan,Harald Ertl,0,0,0,Harald Ertl
211,270,64,1977,Rupert Keegan,Ian Ashley,0,0,0,Ian Ashley
212,229,64,1977,Hector Rebaque,Harald Ertl,0,0,0,Harald Ertl
212,270,64,1977,Hector Rebaque,Ian Ashley,0,0,0,Ian Ashley
229,270,64,1977,Harald Ertl,Ian Ashley,0,0,0,Ian Ashley
158,206,64,1978,Eddie Cheever,Derek Daly,0,0,0,Derek Daly
158,242,64,1978,Eddie Cheever,Divina Galica,0,0,0,Divina Galica
206,242,64,1978,Derek Daly,Divina Galica,0,0,0,Divina Galica
661,686,66,1951,Peter Walker,Reg Parnell,0,2,2,Reg Parnell
661,781,66,1951,Peter Walker,Ken Richardson,0,0,0,Ken Richardson
686,781,66,1951,Reg Parnell,Ken Richardson,2,0,2,Reg Parnell
479,541,66,1956,Tony Brooks,Ron Flockhart,0,0,0,Ron Flockhart
479,578,66,1956,Tony Brooks,Mike Hawthorn,0,0,0,Mike Hawthorn
541,578,66,1956,Ron Flockhart,Mike Hawthorn,0,0,0,Mike Hawthorn
456,486,66,1957,Roy Salvadori,Jack Fairman,0,0,0,Jack Fairman
456,541,66,1957,Roy Salvadori,Ron Flockhart,0,0,0,Ron Flockhart
456,610,66,1957,Roy Salvadori,Les Leston,0,0,0,Les Leston
456,618,66,1957,Roy Salvadori,Herbert MacKay-Fraser,0,0,0,Herbert MacKay-Fraser
486,541,66,1957,Jack Fairman,Ron Flockhart,0,0,0,Ron Flockhart
486,610,66,1957,Jack Fairman,Les Leston,0,0,0,Les Leston
486,618,66,1957,Jack Fairman,Herbert MacKay-Fraser,0,0,0,Herbert MacKay-Fraser
541,610,66,1957,Ron Flockhart,Les Leston,0,0,0,Les Leston
541,618,66,1957,Ron Flockhart,Herbert MacKay-Fraser,0,0,0,Herbert MacKay-Fraser
610,618,66,1957,Les Leston,Herbert MacKay-Fraser,0,0,0,Herbert MacKay-Fraser
347,427,66,1958,Jo Bonnier,Maurice Trintignant,3,0,3,Jo Bonnier
347,501,66,1958,Jo Bonnier,Harry Schell,3,14,11,Harry Schell
347,541,66,1958,Jo Bonnier,Ron Flockhart,3,0,3,Jo Bonnier
347,554,66,1958,Jo Bonnier,Jean Behra,3,7,4,Jean Behra
427,501,66,1958,Maurice Trintignant,Harry Schell,0,14,14,Harry Schell
427,541,66,1958,Maurice Trintignant,Ron Flockhart,0,0,0,Ron Flockhart
427,554,66,1958,Maurice Trintignant,Jean Behra,0,7,7,Jean Behra
501,541,66,1958,Harry Schell,Ron Flockhart,14,0,14,Harry Schell
501,554,66,1958,Harry Schell,Jean Behra,14,7,7,Harry Schell
541,554,66,1958,Ron Flockhart,Jean Behra,0,7,7,Jean Behra
347,475,66,1959,Jo Bonnier,Stirling Moss,10,7,3,Jo Bonnier
347,478,66,1959,Jo Bonnier,Hans Herrmann,10,0,10,Jo Bonnier
347,501,66,1959,Jo Bonnier,Harry Schell,10,5,5,Jo Bonnier
347,541,66,1959,Jo Bonnier,Ron Flockhart,10,0,10,Jo Bonnier
475,478,66,1959,Stirling Moss,Hans Herrmann,7,0,7,Stirling Moss
475,501,66,1959,Stirling Moss,Harry Schell,7,5,2,Stirling Moss
475,541,66,1959,Stirling Moss,Ron Flockhart,7,0,7,Stirling Moss
478,501,66,1959,Hans Herrmann,Harry Schell,0,5,5,Harry Schell
478,541,66,1959,Hans Herrmann,Ron Flockhart,0,0,0,Ron Flockhart
501,541,66,1959,Harry Schell,Ron Flockhart,5,0,5,Harry Schell
289,347,66,1960,Graham Hill,Jo Bonnier,4,4,0,Jo Bonnier
289,364,66,1960,Graham Hill,Dan Gurney,4,0,4,Graham Hill
347,364,66,1960,Jo Bonnier,Dan Gurney,4,0,4,Jo Bonnier
289,479,66,1961,Graham Hill,Tony Brooks,3,6,3,Tony Brooks
289,386,66,1962,Graham Hill,Richie Ginther,52,10,42,Graham Hill
289,453,66,1962,Graham Hill,Jackie Lewis,52,0,52,Graham Hill
289,459,66,1962,Graham Hill,Tony Marsh,52,0,52,Graham Hill
289,460,66,1962,Graham Hill,Gerry Ashmore,52,0,52,Graham Hill
289,471,66,1962,Graham Hill,Bruce Johnstone,52,0,52,Graham Hill
386,453,66,1962,Richie Ginther,Jackie Lewis,10,0,10,Richie Ginther
386,459,66,1962,Richie Ginther,Tony Marsh,10,0,10,Richie Ginther
386,460,66,1962,Richie Ginther,Gerry Ashmore,10,0,10,Richie Ginther
386,471,66,1962,Richie Ginther,Bruce Johnstone,10,0,10,Richie Ginther
453,459,66,1962,Jackie Lewis,Tony Marsh,0,0,0,Tony Marsh
453,460,66,1962,Jackie Lewis,Gerry Ashmore,0,0,0,Gerry Ashmore
453,471,66,1962,Jackie Lewis,Bruce Johnstone,0,0,0,Bruce Johnstone
459,460,66,1962,Tony Marsh,Gerry Ashmore,0,0,0,Gerry Ashmore
459,471,66,1962,Tony Marsh,Bruce Johnstone,0,0,0,Bruce Johnstone
460,471,66,1962,Gerry Ashmore,Bruce Johnstone,0,0,0,Bruce Johnstone
289,382,66,1963,Graham Hill,MoisÃ©s Solana,29,0,29,Graham Hill
289,385,66,1963,Graham Hill,Lorenzo Bandini,29,2,27,Graham Hill
289,386,66,1963,Graham Hill,Richie Ginther,29,34,5,Richie Ginther
289,427,66,1963,Graham Hill,Maurice Trintignant,29,0,29,Graham Hill
382,385,66,1963,MoisÃ©s Solana,Lorenzo Bandini,0,2,2,Lorenzo Bandini
382,386,66,1963,MoisÃ©s Solana,Richie Ginther,0,34,34,Richie Ginther
382,427,66,1963,MoisÃ©s Solana,Maurice Trintignant,0,0,0,Maurice Trintignant
385,386,66,1963,Lorenzo Bandini,Richie Ginther,2,34,32,Richie Ginther
385,427,66,1963,Lorenzo Bandini,Maurice Trintignant,2,0,2,Lorenzo Bandini
386,427,66,1963,Richie Ginther,Maurice Trintignant,34,0,34,Richie Ginther
289,370,66,1964,Graham Hill,Richard Attwood,41,0,41,Graham Hill
289,386,66,1964,Graham Hill,Richie Ginther,41,23,18,Graham Hill
289,394,66,1964,Graham Hill,Giancarlo Baghetti,41,0,41,Graham Hill
289,408,66,1964,Graham Hill,Tony Maggs,41,4,37,Graham Hill
289,427,66,1964,Graham Hill,Maurice Trintignant,41,2,39,Graham Hill
370,386,66,1964,Richard Attwood,Richie Ginther,0,23,23,Richie Ginther
370,394,66,1964,Richard Attwood,Giancarlo Baghetti,0,0,0,Giancarlo Baghetti
370,408,66,1964,Richard Attwood,Tony Maggs,0,4,4,Tony Maggs
370,427,66,1964,Richard Attwood,Maurice Trintignant,0,2,2,Maurice Trintignant
386,394,66,1964,Richie Ginther,Giancarlo Baghetti,23,0,23,Richie Ginther
386,408,66,1964,Richie Ginther,Tony Maggs,23,4,19,Richie Ginther
386,427,66,1964,Richie Ginther,Maurice Trintignant,23,2,21,Richie Ginther
394,408,66,1964,Giancarlo Baghetti,Tony Maggs,0,4,4,Tony Maggs
394,427,66,1964,Giancarlo Baghetti,Maurice Trintignant,0,2,2,Maurice Trintignant
408,427,66,1964,Tony Maggs,Maurice Trintignant,4,2,2,Tony Maggs
289,328,66,1965,Graham Hill,Jackie Stewart,47,34,13,Graham Hill
289,376,66,1965,Graham Hill,Lucien Bianchi,47,0,47,Graham Hill
289,418,66,1965,Graham Hill,Masten Gregory,47,0,47,Graham Hill
289,424,66,1965,Graham Hill,Roberto Bussinello,47,0,47,Graham Hill
289,426,66,1965,Graham Hill,Giorgio Bassi,47,0,47,Graham Hill
328,376,66,1965,Jackie Stewart,Lucien Bianchi,34,0,34,Jackie Stewart
328,418,66,1965,Jackie Stewart,Masten Gregory,34,0,34,Jackie Stewart
328,424,66,1965,Jackie Stewart,Roberto Bussinello,34,0,34,Jackie Stewart
328,426,66,1965,Jackie Stewart,Giorgio Bassi,34,0,34,Jackie Stewart
376,418,66,1965,Lucien Bianchi,Masten Gregory,0,0,0,Masten Gregory
376,424,66,1965,Lucien Bianchi,Roberto Bussinello,0,0,0,Roberto Bussinello
376,426,66,1965,Lucien Bianchi,Giorgio Bassi,0,0,0,Giorgio Bassi
418,424,66,1965,Masten Gregory,Roberto Bussinello,0,0,0,Roberto Bussinello
418,426,66,1965,Masten Gregory,Giorgio Bassi,0,0,0,Giorgio Bassi
424,426,66,1965,Roberto Bussinello,Giorgio Bassi,0,0,0,Giorgio Bassi
289,328,66,1966,Graham Hill,Jackie Stewart,17,14,3,Graham Hill
289,396,66,1966,Graham Hill,Bob Bondurant,17,3,14,Graham Hill
289,398,66,1966,Graham Hill,Vic Wilson,17,0,17,Graham Hill
289,404,66,1966,Graham Hill,Innes Ireland,17,0,17,Graham Hill
328,396,66,1966,Jackie Stewart,Bob Bondurant,14,3,11,Jackie Stewart
328,398,66,1966,Jackie Stewart,Vic Wilson,14,0,14,Jackie Stewart
328,404,66,1966,Jackie Stewart,Innes Ireland,14,0,14,Jackie Stewart
396,398,66,1966,Bob Bondurant,Vic Wilson,3,0,3,Bob Bondurant
396,404,66,1966,Bob Bondurant,Innes Ireland,3,0,3,Bob Bondurant
398,404,66,1966,Vic Wilson,Innes Ireland,0,0,0,Innes Ireland
322,328,66,1967,David Hobbs,Jackie Stewart,0,10,10,Jackie Stewart
322,361,66,1967,David Hobbs,Piers Courage,0,0,0,Piers Courage
322,374,66,1967,David Hobbs,Mike Spence,0,9,9,Mike Spence
322,388,66,1967,David Hobbs,Chris Irwin,0,2,2,Chris Irwin
328,361,66,1967,Jackie Stewart,Piers Courage,10,0,10,Jackie Stewart
328,374,66,1967,Jackie Stewart,Mike Spence,10,9,1,Jackie Stewart
328,388,66,1967,Jackie Stewart,Chris Irwin,10,2,8,Jackie Stewart
361,374,66,1967,Piers Courage,Mike Spence,0,9,9,Mike Spence
361,388,66,1967,Piers Courage,Chris Irwin,0,2,2,Chris Irwin
374,388,66,1967,Mike Spence,Chris Irwin,9,2,7,Mike Spence
345,361,66,1968,Pedro RodrÃ­guez,Piers Courage,18,4,14,Pedro RodrÃ­guez
345,370,66,1968,Pedro RodrÃ­guez,Richard Attwood,18,6,12,Pedro RodrÃ­guez
345,374,66,1968,Pedro RodrÃ­guez,Mike Spence,18,0,18,Pedro RodrÃ­guez
345,380,66,1968,Pedro RodrÃ­guez,Frank Gardner,18,0,18,Pedro RodrÃ­guez
345,381,66,1968,Pedro RodrÃ­guez,Bobby Unser,18,0,18,Pedro RodrÃ­guez
361,370,66,1968,Piers Courage,Richard Attwood,4,6,2,Richard Attwood
361,374,66,1968,Piers Courage,Mike Spence,4,0,4,Piers Courage
361,380,66,1968,Piers Courage,Frank Gardner,4,0,4,Piers Courage
361,381,66,1968,Piers Courage,Bobby Unser,4,0,4,Piers Courage
370,374,66,1968,Richard Attwood,Mike Spence,6,0,6,Richard Attwood
370,380,66,1968,Richard Attwood,Frank Gardner,6,0,6,Richard Attwood
370,381,66,1968,Richard Attwood,Bobby Unser,6,0,6,Richard Attwood
374,380,66,1968,Mike Spence,Frank Gardner,0,0,0,Frank Gardner
374,381,66,1968,Mike Spence,Bobby Unser,0,0,0,Bobby Unser
380,381,66,1968,Frank Gardner,Bobby Unser,0,0,0,Bobby Unser
262,341,66,1969,Jackie Oliver,John Surtees,1,6,5,John Surtees
262,343,66,1969,Jackie Oliver,Bill Brack,1,0,1,Jackie Oliver
262,345,66,1969,Jackie Oliver,Pedro RodrÃ­guez,1,0,1,Jackie Oliver
262,352,66,1969,Jackie Oliver,George Eaton,1,0,1,Jackie Oliver
341,343,66,1969,John Surtees,Bill Brack,6,0,6,John Surtees
341,345,66,1969,John Surtees,Pedro RodrÃ­guez,6,0,6,John Surtees
341,352,66,1969,John Surtees,George Eaton,6,0,6,John Surtees
343,345,66,1969,Bill Brack,Pedro RodrÃ­guez,0,0,0,Pedro RodrÃ­guez
343,352,66,1969,Bill Brack,George Eaton,0,0,0,George Eaton
345,352,66,1969,Pedro RodrÃ­guez,George Eaton,0,0,0,George Eaton
262,345,66,1970,Jackie Oliver,Pedro RodrÃ­guez,2,23,21,Pedro RodrÃ­guez
262,352,66,1970,Jackie Oliver,George Eaton,2,0,2,Jackie Oliver
262,367,66,1970,Jackie Oliver,Peter Westbury,2,0,2,Jackie Oliver
345,352,66,1970,Pedro RodrÃ­guez,George Eaton,23,0,23,Pedro RodrÃ­guez
345,367,66,1970,Pedro RodrÃ­guez,Peter Westbury,23,0,23,Pedro RodrÃ­guez
352,367,66,1970,George Eaton,Peter Westbury,0,0,0,Peter Westbury
307,320,66,1971,Howden Ganley,Peter Gethin,5,9,4,Peter Gethin
307,337,66,1971,Howden Ganley,Helmut Marko,5,0,5,Howden Ganley
307,345,66,1971,Howden Ganley,Pedro RodrÃ­guez,5,9,4,Pedro RodrÃ­guez
307,346,66,1971,Howden Ganley,Jo Siffert,5,19,14,Jo Siffert
307,350,66,1971,Howden Ganley,Vic Elford,5,0,5,Howden Ganley
307,352,66,1971,Howden Ganley,George Eaton,5,0,5,Howden Ganley
307,355,66,1971,Howden Ganley,John Cannon,5,0,5,Howden Ganley
320,337,66,1971,Peter Gethin,Helmut Marko,9,0,9,Peter Gethin
320,345,66,1971,Peter Gethin,Pedro RodrÃ­guez,9,9,0,Pedro RodrÃ­guez
320,346,66,1971,Peter Gethin,Jo Siffert,9,19,10,Jo Siffert
320,350,66,1971,Peter Gethin,Vic Elford,9,0,9,Peter Gethin
320,352,66,1971,Peter Gethin,George Eaton,9,0,9,Peter Gethin
320,355,66,1971,Peter Gethin,John Cannon,9,0,9,Peter Gethin
337,345,66,1971,Helmut Marko,Pedro RodrÃ­guez,0,9,9,Pedro RodrÃ­guez
337,346,66,1971,Helmut Marko,Jo Siffert,0,19,19,Jo Siffert
337,350,66,1971,Helmut Marko,Vic Elford,0,0,0,Vic Elford
337,352,66,1971,Helmut Marko,George Eaton,0,0,0,George Eaton
337,355,66,1971,Helmut Marko,John Cannon,0,0,0,John Cannon
345,346,66,1971,Pedro RodrÃ­guez,Jo Siffert,9,19,10,Jo Siffert
345,350,66,1971,Pedro RodrÃ­guez,Vic Elford,9,0,9,Pedro RodrÃ­guez
345,352,66,1971,Pedro RodrÃ­guez,George Eaton,9,0,9,Pedro RodrÃ­guez
345,355,66,1971,Pedro RodrÃ­guez,John Cannon,9,0,9,Pedro RodrÃ­guez
346,350,66,1971,Jo Siffert,Vic Elford,19,0,19,Jo Siffert
346,352,66,1971,Jo Siffert,George Eaton,19,0,19,Jo Siffert
346,355,66,1971,Jo Siffert,John Cannon,19,0,19,Jo Siffert
350,352,66,1971,Vic Elford,George Eaton,0,0,0,George Eaton
350,355,66,1971,Vic Elford,John Cannon,0,0,0,John Cannon
352,355,66,1971,George Eaton,John Cannon,0,0,0,John Cannon
262,306,66,1972,Jackie Oliver,Jean-Pierre Beltoise,0,9,9,Jean-Pierre Beltoise
262,307,66,1972,Jackie Oliver,Howden Ganley,0,4,4,Howden Ganley
262,312,66,1972,Jackie Oliver,Brian Redman,0,0,0,Brian Redman
262,317,66,1972,Jackie Oliver,Reine Wisell,0,0,0,Reine Wisell
262,320,66,1972,Jackie Oliver,Peter Gethin,0,1,1,Peter Gethin
262,337,66,1972,Jackie Oliver,Helmut Marko,0,0,0,Helmut Marko
262,339,66,1972,Jackie Oliver,Alex Soler-Roig,0,0,0,Alex Soler-Roig
262,343,66,1972,Jackie Oliver,Bill Brack,0,0,0,Bill Brack
306,307,66,1972,Jean-Pierre Beltoise,Howden Ganley,9,4,5,Jean-Pierre Beltoise
306,312,66,1972,Jean-Pierre Beltoise,Brian Redman,9,0,9,Jean-Pierre Beltoise
306,317,66,1972,Jean-Pierre Beltoise,Reine Wisell,9,0,9,Jean-Pierre Beltoise
306,320,66,1972,Jean-Pierre Beltoise,Peter Gethin,9,1,8,Jean-Pierre Beltoise
306,337,66,1972,Jean-Pierre Beltoise,Helmut Marko,9,0,9,Jean-Pierre Beltoise
306,339,66,1972,Jean-Pierre Beltoise,Alex Soler-Roig,9,0,9,Jean-Pierre Beltoise
306,343,66,1972,Jean-Pierre Beltoise,Bill Brack,9,0,9,Jean-Pierre Beltoise
307,312,66,1972,Howden Ganley,Brian Redman,4,0,4,Howden Ganley
307,317,66,1972,Howden Ganley,Reine Wisell,4,0,4,Howden Ganley
307,320,66,1972,Howden Ganley,Peter Gethin,4,1,3,Howden Ganley
307,337,66,1972,Howden Ganley,Helmut Marko,4,0,4,Howden Ganley
307,339,66,1972,Howden Ganley,Alex Soler-Roig,4,0,4,Howden Ganley
307,343,66,1972,Howden Ganley,Bill Brack,4,0,4,Howden Ganley
312,317,66,1972,Brian Redman,Reine Wisell,0,0,0,Reine Wisell
312,320,66,1972,Brian Redman,Peter Gethin,0,1,1,Peter Gethin
312,337,66,1972,Brian Redman,Helmut Marko,0,0,0,Helmut Marko
312,339,66,1972,Brian Redman,Alex Soler-Roig,0,0,0,Alex Soler-Roig
312,343,66,1972,Brian Redman,Bill Brack,0,0,0,Bill Brack
317,320,66,1972,Reine Wisell,Peter Gethin,0,1,1,Peter Gethin
317,337,66,1972,Reine Wisell,Helmut Marko,0,0,0,Helmut Marko
317,339,66,1972,Reine Wisell,Alex Soler-Roig,0,0,0,Alex Soler-Roig
317,343,66,1972,Reine Wisell,Bill Brack,0,0,0,Bill Brack
320,337,66,1972,Peter Gethin,Helmut Marko,1,0,1,Peter Gethin
320,339,66,1972,Peter Gethin,Alex Soler-Roig,1,0,1,Peter Gethin
320,343,66,1972,Peter Gethin,Bill Brack,1,0,1,Peter Gethin
337,339,66,1972,Helmut Marko,Alex Soler-Roig,0,0,0,Alex Soler-Roig
337,343,66,1972,Helmut Marko,Bill Brack,0,0,0,Bill Brack
339,343,66,1972,Alex Soler-Roig,Bill Brack,0,0,0,Bill Brack
182,223,66,1973,Niki Lauda,Clay Regazzoni,2,2,0,Clay Regazzoni
182,306,66,1973,Niki Lauda,Jean-Pierre Beltoise,2,9,7,Jean-Pierre Beltoise
182,320,66,1973,Niki Lauda,Peter Gethin,2,0,2,Niki Lauda
223,306,66,1973,Clay Regazzoni,Jean-Pierre Beltoise,2,9,7,Jean-Pierre Beltoise
223,320,66,1973,Clay Regazzoni,Peter Gethin,2,0,2,Clay Regazzoni
306,320,66,1973,Jean-Pierre Beltoise,Peter Gethin,9,0,9,Jean-Pierre Beltoise
278,280,66,1974,Chris Amon,Henri Pescarolo,0,0,0,Henri Pescarolo
278,296,66,1974,Chris Amon,FranÃ§ois Migault,0,0,0,FranÃ§ois Migault
278,306,66,1974,Chris Amon,Jean-Pierre Beltoise,0,10,10,Jean-Pierre Beltoise
280,296,66,1974,Henri Pescarolo,FranÃ§ois Migault,0,0,0,FranÃ§ois Migault
280,306,66,1974,Henri Pescarolo,Jean-Pierre Beltoise,0,10,10,Jean-Pierre Beltoise
296,306,66,1974,FranÃ§ois Migault,Jean-Pierre Beltoise,0,10,10,Jean-Pierre Beltoise
276,283,66,1975,Bob Evans,Mike Wilds,0,0,0,Mike Wilds
256,260,66,1977,Larry Perkins,Conny Andersson,0,0,0,Conny Andersson
256,265,66,1977,Larry Perkins,Guy Edwards,0,0,0,Guy Edwards
256,269,66,1977,Larry Perkins,Teddy Pilette,0,0,0,Teddy Pilette
260,265,66,1977,Conny Andersson,Guy Edwards,0,0,0,Guy Edwards
260,269,66,1977,Conny Andersson,Teddy Pilette,0,0,0,Teddy Pilette
265,269,66,1977,Guy Edwards,Teddy Pilette,0,0,0,Teddy Pilette
187,288,67,1975,John Watson,Mark Donohue,0,2,2,Mark Donohue
187,257,67,1976,John Watson,Boy Lunger,20,0,20,John Watson
197,240,67,1977,Jean-Pierre Jarier,Danny Ongais,1,0,1,Jean-Pierre Jarier
197,246,67,1977,Jean-Pierre Jarier,Hans Binder,1,0,1,Jean-Pierre Jarier
197,268,67,1977,Jean-Pierre Jarier,Hans Heyer,1,0,1,Jean-Pierre Jarier
240,246,67,1977,Danny Ongais,Hans Binder,0,0,0,Hans Binder
240,268,67,1977,Danny Ongais,Hans Heyer,0,0,0,Hans Heyer
246,268,67,1977,Hans Binder,Hans Heyer,0,0,0,Hans Heyer
63,66,7,2002,Mika Salo,Allan McNish,2,0,2,Mika Salo
43,44,7,2003,Cristiano da Matta,Olivier Panis,10,6,4,Cristiano da Matta
15,41,7,2004,Jarno Trulli,Ricardo Zonta,0,0,0,Ricardo Zonta
15,43,7,2004,Jarno Trulli,Cristiano da Matta,0,3,3,Cristiano da Matta
15,44,7,2004,Jarno Trulli,Olivier Panis,0,6,6,Olivier Panis
41,43,7,2004,Ricardo Zonta,Cristiano da Matta,0,3,3,Cristiano da Matta
41,44,7,2004,Ricardo Zonta,Olivier Panis,0,6,6,Olivier Panis
43,44,7,2004,Cristiano da Matta,Olivier Panis,3,6,3,Olivier Panis
15,23,7,2005,Jarno Trulli,Ralf Schumacher,43,45,2,Ralf Schumacher
15,41,7,2005,Jarno Trulli,Ricardo Zonta,43,0,43,Jarno Trulli
23,41,7,2005,Ralf Schumacher,Ricardo Zonta,45,0,45,Ralf Schumacher
15,23,7,2006,Jarno Trulli,Ralf Schumacher,15,20,5,Ralf Schumacher
15,23,7,2007,Jarno Trulli,Ralf Schumacher,8,5,3,Jarno Trulli
10,15,7,2008,Timo Glock,Jarno Trulli,25,31,6,Jarno Trulli
10,15,7,2009,Timo Glock,Jarno Trulli,24,32,8,Jarno Trulli
10,155,7,2009,Timo Glock,Kamui Kobayashi,24,3,21,Timo Glock
15,155,7,2009,Jarno Trulli,Kamui Kobayashi,32,3,29,Jarno Trulli
273,274,72,1977,Kazuyoshi Hoshino,Noritake Takahara,0,0,0,Noritake Takahara
245,299,74,1975,Tony Trimmer,Hiroshi Fushida,0,0,0,Hiroshi Fushida
178,243,75,1975,Alan Jones,Rolf Stommelen,2,0,2,Alan Jones
178,267,75,1975,Alan Jones,Vern Schuppan,2,0,2,Alan Jones
178,289,75,1975,Alan Jones,Graham Hill,2,0,2,Alan Jones
178,294,75,1975,Alan Jones,Tony Brise,2,1,1,Alan Jones
178,296,75,1975,Alan Jones,FranÃ§ois Migault,2,0,2,Alan Jones
243,267,75,1975,Rolf Stommelen,Vern Schuppan,0,0,0,Vern Schuppan
243,289,75,1975,Rolf Stommelen,Graham Hill,0,0,0,Graham Hill
243,294,75,1975,Rolf Stommelen,Tony Brise,0,1,1,Tony Brise
243,296,75,1975,Rolf Stommelen,FranÃ§ois Migault,0,0,0,FranÃ§ois Migault
267,289,75,1975,Vern Schuppan,Graham Hill,0,0,0,Graham Hill
267,294,75,1975,Vern Schuppan,Tony Brise,0,1,1,Tony Brise
267,296,75,1975,Vern Schuppan,FranÃ§ois Migault,0,0,0,FranÃ§ois Migault
289,294,75,1975,Graham Hill,Tony Brise,0,1,1,Tony Brise
289,296,75,1975,Graham Hill,FranÃ§ois Migault,0,0,0,FranÃ§ois Migault
294,296,75,1975,Tony Brise,FranÃ§ois Migault,1,0,1,Tony Brise
256,278,78,1974,Larry Perkins,Chris Amon,0,0,0,Chris Amon
252,259,79,1974,Tom Pryce,David Purley,0,0,0,David Purley
252,270,79,1974,Tom Pryce,Ian Ashley,0,0,0,Ian Ashley
259,270,79,1974,David Purley,Ian Ashley,0,0,0,Ian Ashley
11,29,8,2006,Takuma Sato,Sakon Yamamoto,0,0,0,Sakon Yamamoto
11,34,8,2006,Takuma Sato,Yuji Ide,0,0,0,Yuji Ide
11,36,8,2006,Takuma Sato,Franck Montagny,0,0,0,Franck Montagny
29,34,8,2006,Sakon Yamamoto,Yuji Ide,0,0,0,Yuji Ide
29,36,8,2006,Sakon Yamamoto,Franck Montagny,0,0,0,Franck Montagny
34,36,8,2006,Yuji Ide,Franck Montagny,0,0,0,Franck Montagny
11,19,8,2007,Takuma Sato,Anthony Davidson,4,0,4,Takuma Sato
11,19,8,2008,Takuma Sato,Anthony Davidson,0,0,0,Anthony Davidson
235,280,80,1973,Jacky Ickx,Henri Pescarolo,0,0,0,Henri Pescarolo
235,298,80,1973,Jacky Ickx,Gijs van Lennep,0,1,1,Gijs van Lennep
235,307,80,1973,Jacky Ickx,Howden Ganley,0,1,1,Howden Ganley
235,314,80,1973,Jacky Ickx,Tim Schenken,0,0,0,Tim Schenken
235,330,80,1973,Jacky Ickx,Nanni Galli,0,0,0,Nanni Galli
235,334,80,1973,Jacky Ickx,Jackie Pretorius,0,0,0,Jackie Pretorius
235,336,80,1973,Jacky Ickx,Graham McRae,0,0,0,Graham McRae
280,298,80,1973,Henri Pescarolo,Gijs van Lennep,0,1,1,Gijs van Lennep
280,307,80,1973,Henri Pescarolo,Howden Ganley,0,1,1,Howden Ganley
280,314,80,1973,Henri Pescarolo,Tim Schenken,0,0,0,Tim Schenken
280,330,80,1973,Henri Pescarolo,Nanni Galli,0,0,0,Nanni Galli
280,334,80,1973,Henri Pescarolo,Jackie Pretorius,0,0,0,Jackie Pretorius
280,336,80,1973,Henri Pescarolo,Graham McRae,0,0,0,Graham McRae
298,307,80,1973,Gijs van Lennep,Howden Ganley,1,1,0,Howden Ganley
298,314,80,1973,Gijs van Lennep,Tim Schenken,1,0,1,Gijs van Lennep
298,330,80,1973,Gijs van Lennep,Nanni Galli,1,0,1,Gijs van Lennep
298,334,80,1973,Gijs van Lennep,Jackie Pretorius,1,0,1,Gijs van Lennep
298,336,80,1973,Gijs van Lennep,Graham McRae,1,0,1,Gijs van Lennep
307,314,80,1973,Howden Ganley,Tim Schenken,1,0,1,Howden Ganley
307,330,80,1973,Howden Ganley,Nanni Galli,1,0,1,Howden Ganley
307,334,80,1973,Howden Ganley,Jackie Pretorius,1,0,1,Howden Ganley
307,336,80,1973,Howden Ganley,Graham McRae,1,0,1,Howden Ganley
314,330,80,1973,Tim Schenken,Nanni Galli,0,0,0,Nanni Galli
314,334,80,1973,Tim Schenken,Jackie Pretorius,0,0,0,Jackie Pretorius
314,336,80,1973,Tim Schenken,Graham McRae,0,0,0,Graham McRae
330,334,80,1973,Nanni Galli,Jackie Pretorius,0,0,0,Jackie Pretorius
330,336,80,1973,Nanni Galli,Graham McRae,0,0,0,Graham McRae
334,336,80,1973,Jackie Pretorius,Graham McRae,0,0,0,Graham McRae
172,219,80,1974,Jacques Laffite,Jean-Pierre Jabouille,0,0,0,Jean-Pierre Jabouille
172,232,80,1974,Jacques Laffite,Arturo Merzario,0,4,4,Arturo Merzario
172,298,80,1974,Jacques Laffite,Gijs van Lennep,0,0,0,Gijs van Lennep
172,308,80,1974,Jacques Laffite,Richard Robarts,0,0,0,Richard Robarts
172,311,80,1974,Jacques Laffite,Tom BelsÃ¸,0,0,0,Tom BelsÃ¸
219,232,80,1974,Jean-Pierre Jabouille,Arturo Merzario,0,4,4,Arturo Merzario
219,298,80,1974,Jean-Pierre Jabouille,Gijs van Lennep,0,0,0,Gijs van Lennep
219,308,80,1974,Jean-Pierre Jabouille,Richard Robarts,0,0,0,Richard Robarts
219,311,80,1974,Jean-Pierre Jabouille,Tom BelsÃ¸,0,0,0,Tom BelsÃ¸
232,298,80,1974,Arturo Merzario,Gijs van Lennep,4,0,4,Arturo Merzario
232,308,80,1974,Arturo Merzario,Richard Robarts,4,0,4,Arturo Merzario
232,311,80,1974,Arturo Merzario,Tom BelsÃ¸,4,0,4,Arturo Merzario
298,308,80,1974,Gijs van Lennep,Richard Robarts,0,0,0,Richard Robarts
298,311,80,1974,Gijs van Lennep,Tom BelsÃ¸,0,0,0,Tom BelsÃ¸
308,311,80,1974,Richard Robarts,Tom BelsÃ¸,0,0,0,Tom BelsÃ¸
321,330,81,1972,Derek Bell,Nanni Galli,0,0,0,Nanni Galli
235,306,82,1967,Jacky Ickx,Jean-Pierre Beltoise,0,0,0,Jean-Pierre Beltoise
235,359,82,1967,Jacky Ickx,Johnny Servoz-Gavin,0,0,0,Johnny Servoz-Gavin
235,377,82,1967,Jacky Ickx,Jo Schlesser,0,0,0,Jo Schlesser
306,359,82,1967,Jean-Pierre Beltoise,Johnny Servoz-Gavin,0,0,0,Johnny Servoz-Gavin
306,377,82,1967,Jean-Pierre Beltoise,Jo Schlesser,0,0,0,Jo Schlesser
359,377,82,1967,Johnny Servoz-Gavin,Jo Schlesser,0,0,0,Jo Schlesser
280,306,82,1968,Henri Pescarolo,Jean-Pierre Beltoise,0,8,8,Jean-Pierre Beltoise
280,306,82,1970,Henri Pescarolo,Jean-Pierre Beltoise,8,16,8,Jean-Pierre Beltoise
278,306,82,1971,Chris Amon,Jean-Pierre Beltoise,9,1,8,Chris Amon
312,314,86,1970,Brian Redman,Tim Schenken,0,0,0,Tim Schenken
312,361,86,1970,Brian Redman,Piers Courage,0,0,0,Piers Courage
314,361,86,1970,Tim Schenken,Piers Courage,0,0,0,Piers Courage
578,663,87,1952,Mike Hawthorn,Ken Wharton,10,0,10,Mike Hawthorn
578,686,87,1952,Mike Hawthorn,Reg Parnell,10,0,10,Mike Hawthorn
578,688,87,1952,Mike Hawthorn,Eric Brandon,10,0,10,Mike Hawthorn
578,689,87,1952,Mike Hawthorn,Alan Brown,10,2,8,Mike Hawthorn
578,747,87,1952,Mike Hawthorn,David Murray,10,0,10,Mike Hawthorn
663,686,87,1952,Ken Wharton,Reg Parnell,0,0,0,Reg Parnell
663,688,87,1952,Ken Wharton,Eric Brandon,0,0,0,Eric Brandon
663,689,87,1952,Ken Wharton,Alan Brown,0,2,2,Alan Brown
663,747,87,1952,Ken Wharton,David Murray,0,0,0,David Murray
686,688,87,1952,Reg Parnell,Eric Brandon,0,0,0,Eric Brandon
686,689,87,1952,Reg Parnell,Alan Brown,0,2,2,Alan Brown
686,747,87,1952,Reg Parnell,David Murray,0,0,0,David Murray
688,689,87,1952,Eric Brandon,Alan Brown,0,2,2,Alan Brown
688,747,87,1952,Eric Brandon,David Murray,0,0,0,David Murray
689,747,87,1952,Alan Brown,David Murray,2,0,2,Alan Brown
475,619,87,1953,Stirling Moss,Bob Gerard,0,0,0,Bob Gerard
475,663,87,1953,Stirling Moss,Ken Wharton,0,0,0,Ken Wharton
475,687,87,1953,Stirling Moss,Peter Whitehead,0,0,0,Peter Whitehead
475,689,87,1953,Stirling Moss,Alan Brown,0,0,0,Alan Brown
475,690,87,1953,Stirling Moss,Rodney Nuckey,0,0,0,Rodney Nuckey
475,696,87,1953,Stirling Moss,John Barber,0,0,0,John Barber
475,698,87,1953,Stirling Moss,Adolfo Cruz,0,0,0,Adolfo Cruz
475,705,87,1953,Stirling Moss,Tony Crook,0,0,0,Tony Crook
475,706,87,1953,Stirling Moss,Jimmy Stewart,0,0,0,Jimmy Stewart
619,663,87,1953,Bob Gerard,Ken Wharton,0,0,0,Ken Wharton
619,687,87,1953,Bob Gerard,Peter Whitehead,0,0,0,Peter Whitehead
619,689,87,1953,Bob Gerard,Alan Brown,0,0,0,Alan Brown
619,690,87,1953,Bob Gerard,Rodney Nuckey,0,0,0,Rodney Nuckey
619,696,87,1953,Bob Gerard,John Barber,0,0,0,John Barber
619,698,87,1953,Bob Gerard,Adolfo Cruz,0,0,0,Adolfo Cruz
619,705,87,1953,Bob Gerard,Tony Crook,0,0,0,Tony Crook
619,706,87,1953,Bob Gerard,Jimmy Stewart,0,0,0,Jimmy Stewart
663,687,87,1953,Ken Wharton,Peter Whitehead,0,0,0,Peter Whitehead
663,689,87,1953,Ken Wharton,Alan Brown,0,0,0,Alan Brown
663,690,87,1953,Ken Wharton,Rodney Nuckey,0,0,0,Rodney Nuckey
663,696,87,1953,Ken Wharton,John Barber,0,0,0,John Barber
663,698,87,1953,Ken Wharton,Adolfo Cruz,0,0,0,Adolfo Cruz
663,705,87,1953,Ken Wharton,Tony Crook,0,0,0,Tony Crook
663,706,87,1953,Ken Wharton,Jimmy Stewart,0,0,0,Jimmy Stewart
687,689,87,1953,Peter Whitehead,Alan Brown,0,0,0,Alan Brown
687,690,87,1953,Peter Whitehead,Rodney Nuckey,0,0,0,Rodney Nuckey
687,696,87,1953,Peter Whitehead,John Barber,0,0,0,John Barber
687,698,87,1953,Peter Whitehead,Adolfo Cruz,0,0,0,Adolfo Cruz
687,705,87,1953,Peter Whitehead,Tony Crook,0,0,0,Tony Crook
687,706,87,1953,Peter Whitehead,Jimmy Stewart,0,0,0,Jimmy Stewart
689,690,87,1953,Alan Brown,Rodney Nuckey,0,0,0,Rodney Nuckey
689,696,87,1953,Alan Brown,John Barber,0,0,0,John Barber
689,698,87,1953,Alan Brown,Adolfo Cruz,0,0,0,Adolfo Cruz
689,705,87,1953,Alan Brown,Tony Crook,0,0,0,Tony Crook
689,706,87,1953,Alan Brown,Jimmy Stewart,0,0,0,Jimmy Stewart
690,696,87,1953,Rodney Nuckey,John Barber,0,0,0,John Barber
690,698,87,1953,Rodney Nuckey,Adolfo Cruz,0,0,0,Adolfo Cruz
690,705,87,1953,Rodney Nuckey,Tony Crook,0,0,0,Tony Crook
690,706,87,1953,Rodney Nuckey,Jimmy Stewart,0,0,0,Jimmy Stewart
696,698,87,1953,John Barber,Adolfo Cruz,0,0,0,Adolfo Cruz
696,705,87,1953,John Barber,Tony Crook,0,0,0,Tony Crook
696,706,87,1953,John Barber,Jimmy Stewart,0,0,0,Jimmy Stewart
698,705,87,1953,Adolfo Cruz,Tony Crook,0,0,0,Tony Crook
698,706,87,1953,Adolfo Cruz,Jimmy Stewart,0,0,0,Jimmy Stewart
705,706,87,1953,Tony Crook,Jimmy Stewart,0,0,0,Jimmy Stewart
547,619,87,1954,Horace Gould,Bob Gerard,0,0,0,Bob Gerard
547,687,87,1954,Horace Gould,Peter Whitehead,0,0,0,Peter Whitehead
547,688,87,1954,Horace Gould,Eric Brandon,0,0,0,Eric Brandon
547,689,87,1954,Horace Gould,Alan Brown,0,0,0,Alan Brown
547,690,87,1954,Horace Gould,Rodney Nuckey,0,0,0,Rodney Nuckey
619,687,87,1954,Bob Gerard,Peter Whitehead,0,0,0,Peter Whitehead
619,688,87,1954,Bob Gerard,Eric Brandon,0,0,0,Eric Brandon
619,689,87,1954,Bob Gerard,Alan Brown,0,0,0,Alan Brown
619,690,87,1954,Bob Gerard,Rodney Nuckey,0,0,0,Rodney Nuckey
687,688,87,1954,Peter Whitehead,Eric Brandon,0,0,0,Eric Brandon
687,689,87,1954,Peter Whitehead,Alan Brown,0,0,0,Alan Brown
687,690,87,1954,Peter Whitehead,Rodney Nuckey,0,0,0,Rodney Nuckey
688,689,87,1954,Eric Brandon,Alan Brown,0,0,0,Alan Brown
688,690,87,1954,Eric Brandon,Rodney Nuckey,0,0,0,Rodney Nuckey
689,690,87,1954,Alan Brown,Rodney Nuckey,0,0,0,Rodney Nuckey
356,456,87,1957,Jack Brabham,Roy Salvadori,0,2,2,Roy Salvadori
356,459,87,1957,Jack Brabham,Tony Marsh,0,0,0,Tony Marsh
356,484,87,1957,Jack Brabham,Brian Naylor,0,0,0,Brian Naylor
356,601,87,1957,Jack Brabham,Dick Gibson,0,0,0,Dick Gibson
356,610,87,1957,Jack Brabham,Les Leston,0,0,0,Les Leston
356,617,87,1957,Jack Brabham,Mike MacDowel,0,0,0,Mike MacDowel
356,619,87,1957,Jack Brabham,Bob Gerard,0,0,0,Bob Gerard
356,621,87,1957,Jack Brabham,Paul England,0,0,0,Paul England
456,459,87,1957,Roy Salvadori,Tony Marsh,2,0,2,Roy Salvadori
456,484,87,1957,Roy Salvadori,Brian Naylor,2,0,2,Roy Salvadori
456,601,87,1957,Roy Salvadori,Dick Gibson,2,0,2,Roy Salvadori
456,610,87,1957,Roy Salvadori,Les Leston,2,0,2,Roy Salvadori
456,617,87,1957,Roy Salvadori,Mike MacDowel,2,0,2,Roy Salvadori
456,619,87,1957,Roy Salvadori,Bob Gerard,2,0,2,Roy Salvadori
456,621,87,1957,Roy Salvadori,Paul England,2,0,2,Roy Salvadori
459,484,87,1957,Tony Marsh,Brian Naylor,0,0,0,Brian Naylor
459,601,87,1957,Tony Marsh,Dick Gibson,0,0,0,Dick Gibson
459,610,87,1957,Tony Marsh,Les Leston,0,0,0,Les Leston
459,617,87,1957,Tony Marsh,Mike MacDowel,0,0,0,Mike MacDowel
459,619,87,1957,Tony Marsh,Bob Gerard,0,0,0,Bob Gerard
459,621,87,1957,Tony Marsh,Paul England,0,0,0,Paul England
484,601,87,1957,Brian Naylor,Dick Gibson,0,0,0,Dick Gibson
484,610,87,1957,Brian Naylor,Les Leston,0,0,0,Les Leston
484,617,87,1957,Brian Naylor,Mike MacDowel,0,0,0,Mike MacDowel
484,619,87,1957,Brian Naylor,Bob Gerard,0,0,0,Bob Gerard
484,621,87,1957,Brian Naylor,Paul England,0,0,0,Paul England
601,610,87,1957,Dick Gibson,Les Leston,0,0,0,Les Leston
601,617,87,1957,Dick Gibson,Mike MacDowel,0,0,0,Mike MacDowel
601,619,87,1957,Dick Gibson,Bob Gerard,0,0,0,Bob Gerard
601,621,87,1957,Dick Gibson,Paul England,0,0,0,Paul England
610,617,87,1957,Les Leston,Mike MacDowel,0,0,0,Mike MacDowel
610,619,87,1957,Les Leston,Bob Gerard,0,0,0,Bob Gerard
610,621,87,1957,Les Leston,Paul England,0,0,0,Paul England
617,619,87,1957,Mike MacDowel,Bob Gerard,0,0,0,Bob Gerard
617,621,87,1957,Mike MacDowel,Paul England,0,0,0,Paul England
619,621,87,1957,Bob Gerard,Paul England,0,0,0,Paul England
356,360,87,1958,Jack Brabham,Bruce McLaren,3,0,3,Jack Brabham
356,427,87,1958,Jack Brabham,Maurice Trintignant,3,12,9,Maurice Trintignant
356,437,87,1958,Jack Brabham,Ian Burgess,3,0,3,Jack Brabham
356,455,87,1958,Jack Brabham,Wolfgang Seidel,3,0,3,Jack Brabham
356,456,87,1958,Jack Brabham,Roy Salvadori,3,15,12,Roy Salvadori
356,459,87,1958,Jack Brabham,Tony Marsh,3,0,3,Jack Brabham
356,475,87,1958,Jack Brabham,Stirling Moss,3,8,5,Stirling Moss
356,484,87,1958,Jack Brabham,Brian Naylor,3,0,3,Jack Brabham
356,486,87,1958,Jack Brabham,Jack Fairman,3,0,3,Jack Brabham
356,541,87,1958,Jack Brabham,Ron Flockhart,3,0,3,Jack Brabham
356,600,87,1958,Jack Brabham,Christian Goethals,3,0,3,Jack Brabham
356,601,87,1958,Jack Brabham,Dick Gibson,3,0,3,Jack Brabham
356,602,87,1958,Jack Brabham,Robert La Caze,3,0,3,Jack Brabham
356,603,87,1958,Jack Brabham,AndrÃ© Guelfi,3,0,3,Jack Brabham
356,604,87,1958,Jack Brabham,FranÃ§ois Picard,3,0,3,Jack Brabham
356,605,87,1958,Jack Brabham,Tom Bridger,3,0,3,Jack Brabham
360,427,87,1958,Bruce McLaren,Maurice Trintignant,0,12,12,Maurice Trintignant
360,437,87,1958,Bruce McLaren,Ian Burgess,0,0,0,Ian Burgess
360,455,87,1958,Bruce McLaren,Wolfgang Seidel,0,0,0,Wolfgang Seidel
360,456,87,1958,Bruce McLaren,Roy Salvadori,0,15,15,Roy Salvadori
360,459,87,1958,Bruce McLaren,Tony Marsh,0,0,0,Tony Marsh
360,475,87,1958,Bruce McLaren,Stirling Moss,0,8,8,Stirling Moss
360,484,87,1958,Bruce McLaren,Brian Naylor,0,0,0,Brian Naylor
360,486,87,1958,Bruce McLaren,Jack Fairman,0,0,0,Jack Fairman
360,541,87,1958,Bruce McLaren,Ron Flockhart,0,0,0,Ron Flockhart
360,600,87,1958,Bruce McLaren,Christian Goethals,0,0,0,Christian Goethals
360,601,87,1958,Bruce McLaren,Dick Gibson,0,0,0,Dick Gibson
360,602,87,1958,Bruce McLaren,Robert La Caze,0,0,0,Robert La Caze
360,603,87,1958,Bruce McLaren,AndrÃ© Guelfi,0,0,0,AndrÃ© Guelfi
360,604,87,1958,Bruce McLaren,FranÃ§ois Picard,0,0,0,FranÃ§ois Picard
360,605,87,1958,Bruce McLaren,Tom Bridger,0,0,0,Tom Bridger
427,437,87,1958,Maurice Trintignant,Ian Burgess,12,0,12,Maurice Trintignant
427,455,87,1958,Maurice Trintignant,Wolfgang Seidel,12,0,12,Maurice Trintignant
427,456,87,1958,Maurice Trintignant,Roy Salvadori,12,15,3,Roy Salvadori
427,459,87,1958,Maurice Trintignant,Tony Marsh,12,0,12,Maurice Trintignant
427,475,87,1958,Maurice Trintignant,Stirling Moss,12,8,4,Maurice Trintignant
427,484,87,1958,Maurice Trintignant,Brian Naylor,12,0,12,Maurice Trintignant
427,486,87,1958,Maurice Trintignant,Jack Fairman,12,0,12,Maurice Trintignant
427,541,87,1958,Maurice Trintignant,Ron Flockhart,12,0,12,Maurice Trintignant
427,600,87,1958,Maurice Trintignant,Christian Goethals,12,0,12,Maurice Trintignant
427,601,87,1958,Maurice Trintignant,Dick Gibson,12,0,12,Maurice Trintignant
427,602,87,1958,Maurice Trintignant,Robert La Caze,12,0,12,Maurice Trintignant
427,603,87,1958,Maurice Trintignant,AndrÃ© Guelfi,12,0,12,Maurice Trintignant
427,604,87,1958,Maurice Trintignant,FranÃ§ois Picard,12,0,12,Maurice Trintignant
427,605,87,1958,Maurice Trintignant,Tom Bridger,12,0,12,Maurice Trintignant
437,455,87,1958,Ian Burgess,Wolfgang Seidel,0,0,0,Wolfgang Seidel
437,456,87,1958,Ian Burgess,Roy Salvadori,0,15,15,Roy Salvadori
437,459,87,1958,Ian Burgess,Tony Marsh,0,0,0,Tony Marsh
437,475,87,1958,Ian Burgess,Stirling Moss,0,8,8,Stirling Moss
437,484,87,1958,Ian Burgess,Brian Naylor,0,0,0,Brian Naylor
437,486,87,1958,Ian Burgess,Jack Fairman,0,0,0,Jack Fairman
437,541,87,1958,Ian Burgess,Ron Flockhart,0,0,0,Ron Flockhart
437,600,87,1958,Ian Burgess,Christian Goethals,0,0,0,Christian Goethals
437,601,87,1958,Ian Burgess,Dick Gibson,0,0,0,Dick Gibson
437,602,87,1958,Ian Burgess,Robert La Caze,0,0,0,Robert La Caze
437,603,87,1958,Ian Burgess,AndrÃ© Guelfi,0,0,0,AndrÃ© Guelfi
437,604,87,1958,Ian Burgess,FranÃ§ois Picard,0,0,0,FranÃ§ois Picard
437,605,87,1958,Ian Burgess,Tom Bridger,0,0,0,Tom Bridger
455,456,87,1958,Wolfgang Seidel,Roy Salvadori,0,15,15,Roy Salvadori
455,459,87,1958,Wolfgang Seidel,Tony Marsh,0,0,0,Tony Marsh
455,475,87,1958,Wolfgang Seidel,Stirling Moss,0,8,8,Stirling Moss
455,484,87,1958,Wolfgang Seidel,Brian Naylor,0,0,0,Brian Naylor
455,486,87,1958,Wolfgang Seidel,Jack Fairman,0,0,0,Jack Fairman
455,541,87,1958,Wolfgang Seidel,Ron Flockhart,0,0,0,Ron Flockhart
455,600,87,1958,Wolfgang Seidel,Christian Goethals,0,0,0,Christian Goethals
455,601,87,1958,Wolfgang Seidel,Dick Gibson,0,0,0,Dick Gibson
455,602,87,1958,Wolfgang Seidel,Robert La Caze,0,0,0,Robert La Caze
455,603,87,1958,Wolfgang Seidel,AndrÃ© Guelfi,0,0,0,AndrÃ© Guelfi
455,604,87,1958,Wolfgang Seidel,FranÃ§ois Picard,0,0,0,FranÃ§ois Picard
455,605,87,1958,Wolfgang Seidel,Tom Bridger,0,0,0,Tom Bridger
456,459,87,1958,Roy Salvadori,Tony Marsh,15,0,15,Roy Salvadori
456,475,87,1958,Roy Salvadori,Stirling Moss,15,8,7,Roy Salvadori
456,484,87,1958,Roy Salvadori,Brian Naylor,15,0,15,Roy Salvadori
456,486,87,1958,Roy Salvadori,Jack Fairman,15,0,15,Roy Salvadori
456,541,87,1958,Roy Salvadori,Ron Flockhart,15,0,15,Roy Salvadori
456,600,87,1958,Roy Salvadori,Christian Goethals,15,0,15,Roy Salvadori
456,601,87,1958,Roy Salvadori,Dick Gibson,15,0,15,Roy Salvadori
456,602,87,1958,Roy Salvadori,Robert La Caze,15,0,15,Roy Salvadori
456,603,87,1958,Roy Salvadori,AndrÃ© Guelfi,15,0,15,Roy Salvadori
456,604,87,1958,Roy Salvadori,FranÃ§ois Picard,15,0,15,Roy Salvadori
456,605,87,1958,Roy Salvadori,Tom Bridger,15,0,15,Roy Salvadori
459,475,87,1958,Tony Marsh,Stirling Moss,0,8,8,Stirling Moss
459,484,87,1958,Tony Marsh,Brian Naylor,0,0,0,Brian Naylor
459,486,87,1958,Tony Marsh,Jack Fairman,0,0,0,Jack Fairman
459,541,87,1958,Tony Marsh,Ron Flockhart,0,0,0,Ron Flockhart
459,600,87,1958,Tony Marsh,Christian Goethals,0,0,0,Christian Goethals
459,601,87,1958,Tony Marsh,Dick Gibson,0,0,0,Dick Gibson
459,602,87,1958,Tony Marsh,Robert La Caze,0,0,0,Robert La Caze
459,603,87,1958,Tony Marsh,AndrÃ© Guelfi,0,0,0,AndrÃ© Guelfi
459,604,87,1958,Tony Marsh,FranÃ§ois Picard,0,0,0,FranÃ§ois Picard
459,605,87,1958,Tony Marsh,Tom Bridger,0,0,0,Tom Bridger
475,484,87,1958,Stirling Moss,Brian Naylor,8,0,8,Stirling Moss
475,486,87,1958,Stirling Moss,Jack Fairman,8,0,8,Stirling Moss
475,541,87,1958,Stirling Moss,Ron Flockhart,8,0,8,Stirling Moss
475,600,87,1958,Stirling Moss,Christian Goethals,8,0,8,Stirling Moss
475,601,87,1958,Stirling Moss,Dick Gibson,8,0,8,Stirling Moss
475,602,87,1958,Stirling Moss,Robert La Caze,8,0,8,Stirling Moss
475,603,87,1958,Stirling Moss,AndrÃ© Guelfi,8,0,8,Stirling Moss
475,604,87,1958,Stirling Moss,FranÃ§ois Picard,8,0,8,Stirling Moss
475,605,87,1958,Stirling Moss,Tom Bridger,8,0,8,Stirling Moss
484,486,87,1958,Brian Naylor,Jack Fairman,0,0,0,Jack Fairman
484,541,87,1958,Brian Naylor,Ron Flockhart,0,0,0,Ron Flockhart
484,600,87,1958,Brian Naylor,Christian Goethals,0,0,0,Christian Goethals
484,601,87,1958,Brian Naylor,Dick Gibson,0,0,0,Dick Gibson
484,602,87,1958,Brian Naylor,Robert La Caze,0,0,0,Robert La Caze
484,603,87,1958,Brian Naylor,AndrÃ© Guelfi,0,0,0,AndrÃ© Guelfi
484,604,87,1958,Brian Naylor,FranÃ§ois Picard,0,0,0,FranÃ§ois Picard
484,605,87,1958,Brian Naylor,Tom Bridger,0,0,0,Tom Bridger
486,541,87,1958,Jack Fairman,Ron Flockhart,0,0,0,Ron Flockhart
486,600,87,1958,Jack Fairman,Christian Goethals,0,0,0,Christian Goethals
486,601,87,1958,Jack Fairman,Dick Gibson,0,0,0,Dick Gibson
486,602,87,1958,Jack Fairman,Robert La Caze,0,0,0,Robert La Caze
486,603,87,1958,Jack Fairman,AndrÃ© Guelfi,0,0,0,AndrÃ© Guelfi
486,604,87,1958,Jack Fairman,FranÃ§ois Picard,0,0,0,FranÃ§ois Picard
486,605,87,1958,Jack Fairman,Tom Bridger,0,0,0,Tom Bridger
541,600,87,1958,Ron Flockhart,Christian Goethals,0,0,0,Christian Goethals
541,601,87,1958,Ron Flockhart,Dick Gibson,0,0,0,Dick Gibson
541,602,87,1958,Ron Flockhart,Robert La Caze,0,0,0,Robert La Caze
541,603,87,1958,Ron Flockhart,AndrÃ© Guelfi,0,0,0,AndrÃ© Guelfi
541,604,87,1958,Ron Flockhart,FranÃ§ois Picard,0,0,0,FranÃ§ois Picard
541,605,87,1958,Ron Flockhart,Tom Bridger,0,0,0,Tom Bridger
600,601,87,1958,Christian Goethals,Dick Gibson,0,0,0,Dick Gibson
600,602,87,1958,Christian Goethals,Robert La Caze,0,0,0,Robert La Caze
600,603,87,1958,Christian Goethals,AndrÃ© Guelfi,0,0,0,AndrÃ© Guelfi
600,604,87,1958,Christian Goethals,FranÃ§ois Picard,0,0,0,FranÃ§ois Picard
600,605,87,1958,Christian Goethals,Tom Bridger,0,0,0,Tom Bridger
601,602,87,1958,Dick Gibson,Robert La Caze,0,0,0,Robert La Caze
601,603,87,1958,Dick Gibson,AndrÃ© Guelfi,0,0,0,AndrÃ© Guelfi
601,604,87,1958,Dick Gibson,FranÃ§ois Picard,0,0,0,FranÃ§ois Picard
601,605,87,1958,Dick Gibson,Tom Bridger,0,0,0,Tom Bridger
602,603,87,1958,Robert La Caze,AndrÃ© Guelfi,0,0,0,AndrÃ© Guelfi
602,604,87,1958,Robert La Caze,FranÃ§ois Picard,0,0,0,FranÃ§ois Picard
602,605,87,1958,Robert La Caze,Tom Bridger,0,0,0,Tom Bridger
603,604,87,1958,AndrÃ© Guelfi,FranÃ§ois Picard,0,0,0,FranÃ§ois Picard
603,605,87,1958,AndrÃ© Guelfi,Tom Bridger,0,0,0,Tom Bridger
604,605,87,1958,FranÃ§ois Picard,Tom Bridger,0,0,0,Tom Bridger
368,411,89,1963,Sam Tingle,Doug Serrurier,0,0,0,Doug Serrurier
14,24,9,2005,David Coulthard,Vitantonio Liuzzi,24,1,23,David Coulthard
14,32,9,2005,David Coulthard,Christian Klien,24,9,15,David Coulthard
24,32,9,2005,Vitantonio Liuzzi,Christian Klien,1,9,8,Christian Klien
14,32,9,2006,David Coulthard,Christian Klien,14,2,12,David Coulthard
14,38,9,2006,David Coulthard,Robert Doornbos,14,0,14,David Coulthard
32,38,9,2006,Christian Klien,Robert Doornbos,2,0,2,Christian Klien
14,17,9,2007,David Coulthard,Mark Webber,14,10,4,David Coulthard
14,17,9,2008,David Coulthard,Mark Webber,8,21,13,Mark Webber
17,20,9,2009,Mark Webber,Sebastian Vettel,70,84,14,Sebastian Vettel
17,20,9,2010,Mark Webber,Sebastian Vettel,242,256,14,Sebastian Vettel
17,20,9,2011,Mark Webber,Sebastian Vettel,258,392,134,Sebastian Vettel
17,20,9,2012,Mark Webber,Sebastian Vettel,179,281,102,Sebastian Vettel
17,20,9,2013,Mark Webber,Sebastian Vettel,199,397,198,Sebastian Vettel
20,817,9,2014,Sebastian Vettel,Daniel Ricciardo,167,238,71,Daniel Ricciardo
817,826,9,2015,Daniel Ricciardo,Daniil Kvyat,92,95,3,Daniil Kvyat
817,826,9,2016,Daniel Ricciardo,Daniil Kvyat,256,21,235,Daniel Ricciardo
817,830,9,2016,Daniel Ricciardo,Max Verstappen,256,191,65,Daniel Ricciardo
826,830,9,2016,Daniil Kvyat,Max Verstappen,21,191,170,Max Verstappen
817,830,9,2017,Daniel Ricciardo,Max Verstappen,200,168,32,Daniel Ricciardo
817,830,9,2018,Daniel Ricciardo,Max Verstappen,170,249,79,Max Verstappen
830,842,9,2019,Max Verstappen,Pierre Gasly,278,63,215,Max Verstappen
830,848,9,2019,Max Verstappen,Alexander Albon,278,76,202,Max Verstappen
842,848,9,2019,Pierre Gasly,Alexander Albon,63,76,13,Alexander Albon
830,848,9,2020,Max Verstappen,Alexander Albon,214,105,109,Max Verstappen
815,830,9,2021,Sergio PÃ©rez,Max Verstappen,190,388,198,Max Verstappen
815,830,9,2022,Sergio PÃ©rez,Max Verstappen,291,433,142,Max Verstappen
815,830,9,2023,Sergio PÃ©rez,Max Verstappen,260,530,270,Max Verstappen
815,830,9,2024,Sergio PÃ©rez,Max Verstappen,105,231,126,Max Verstappen
379,391,90,1967,Kurt Ahrens,Brian Hart,0,0,0,Brian Hart
437,438,92,1963,Ian Burgess,Tony Settember,0,0,0,Tony Settember
401,404,94,1964,Trevor Taylor,Innes Ireland,1,4,3,Innes Ireland
430,431,95,1957,Carel Godin de Beaufort,Edgar Barth,0,0,0,Edgar Barth
430,620,95,1957,Carel Godin de Beaufort,Umberto Maglioli,0,0,0,Umberto Maglioli
431,620,95,1957,Edgar Barth,Umberto Maglioli,0,0,0,Umberto Maglioli
430,431,95,1958,Carel Godin de Beaufort,Edgar Barth,0,0,0,Edgar Barth
430,476,95,1959,Carel Godin de Beaufort,Wolfgang von Trips,0,0,0,Wolfgang von Trips
430,551,95,1959,Carel Godin de Beaufort,Maria de Filippis,0,0,0,Maria de Filippis
430,572,95,1959,Carel Godin de Beaufort,Harry Blanchard,0,0,0,Harry Blanchard
476,551,95,1959,Wolfgang von Trips,Maria de Filippis,0,0,0,Maria de Filippis
476,572,95,1959,Wolfgang von Trips,Harry Blanchard,0,0,0,Harry Blanchard
551,572,95,1959,Maria de Filippis,Harry Blanchard,0,0,0,Harry Blanchard
431,478,95,1960,Edgar Barth,Hans Herrmann,0,1,1,Hans Herrmann
347,364,95,1961,Jo Bonnier,Dan Gurney,3,21,18,Dan Gurney
347,430,95,1961,Jo Bonnier,Carel Godin de Beaufort,3,0,3,Jo Bonnier
347,431,95,1961,Jo Bonnier,Edgar Barth,3,0,3,Jo Bonnier
347,478,95,1961,Jo Bonnier,Hans Herrmann,3,0,3,Jo Bonnier
364,430,95,1961,Dan Gurney,Carel Godin de Beaufort,21,0,21,Dan Gurney
364,431,95,1961,Dan Gurney,Edgar Barth,21,0,21,Dan Gurney
364,478,95,1961,Dan Gurney,Hans Herrmann,21,0,21,Dan Gurney
430,431,95,1961,Carel Godin de Beaufort,Edgar Barth,0,0,0,Edgar Barth
430,478,95,1961,Carel Godin de Beaufort,Hans Herrmann,0,0,0,Hans Herrmann
431,478,95,1961,Edgar Barth,Hans Herrmann,0,0,0,Hans Herrmann
347,364,95,1962,Jo Bonnier,Dan Gurney,3,15,12,Dan Gurney
347,425,95,1962,Jo Bonnier,Nino Vaccarella,3,0,3,Jo Bonnier
347,430,95,1962,Jo Bonnier,Carel Godin de Beaufort,3,2,1,Jo Bonnier
347,457,95,1962,Jo Bonnier,Ben Pon,3,0,3,Jo Bonnier
347,458,95,1962,Jo Bonnier,Rob Slotemaker,3,0,3,Jo Bonnier
347,461,95,1962,Jo Bonnier,Heinz Schiller,3,0,3,Jo Bonnier
347,462,95,1962,Jo Bonnier,Colin Davis,3,0,3,Jo Bonnier
347,466,95,1962,Jo Bonnier,Heini Walter,3,0,3,Jo Bonnier
364,425,95,1962,Dan Gurney,Nino Vaccarella,15,0,15,Dan Gurney
364,430,95,1962,Dan Gurney,Carel Godin de Beaufort,15,2,13,Dan Gurney
364,457,95,1962,Dan Gurney,Ben Pon,15,0,15,Dan Gurney
364,458,95,1962,Dan Gurney,Rob Slotemaker,15,0,15,Dan Gurney
364,461,95,1962,Dan Gurney,Heinz Schiller,15,0,15,Dan Gurney
364,462,95,1962,Dan Gurney,Colin Davis,15,0,15,Dan Gurney
364,466,95,1962,Dan Gurney,Heini Walter,15,0,15,Dan Gurney
425,430,95,1962,Nino Vaccarella,Carel Godin de Beaufort,0,2,2,Carel Godin de Beaufort
425,457,95,1962,Nino Vaccarella,Ben Pon,0,0,0,Ben Pon
425,458,95,1962,Nino Vaccarella,Rob Slotemaker,0,0,0,Rob Slotemaker
425,461,95,1962,Nino Vaccarella,Heinz Schiller,0,0,0,Heinz Schiller
425,462,95,1962,Nino Vaccarella,Colin Davis,0,0,0,Colin Davis
425,466,95,1962,Nino Vaccarella,Heini Walter,0,0,0,Heini Walter
430,457,95,1962,Carel Godin de Beaufort,Ben Pon,2,0,2,Carel Godin de Beaufort
430,458,95,1962,Carel Godin de Beaufort,Rob Slotemaker,2,0,2,Carel Godin de Beaufort
430,461,95,1962,Carel Godin de Beaufort,Heinz Schiller,2,0,2,Carel Godin de Beaufort
430,462,95,1962,Carel Godin de Beaufort,Colin Davis,2,0,2,Carel Godin de Beaufort
430,466,95,1962,Carel Godin de Beaufort,Heini Walter,2,0,2,Carel Godin de Beaufort
457,458,95,1962,Ben Pon,Rob Slotemaker,0,0,0,Rob Slotemaker
457,461,95,1962,Ben Pon,Heinz Schiller,0,0,0,Heinz Schiller
457,462,95,1962,Ben Pon,Colin Davis,0,0,0,Colin Davis
457,466,95,1962,Ben Pon,Heini Walter,0,0,0,Heini Walter
458,461,95,1962,Rob Slotemaker,Heinz Schiller,0,0,0,Heinz Schiller
458,462,95,1962,Rob Slotemaker,Colin Davis,0,0,0,Colin Davis
458,466,95,1962,Rob Slotemaker,Heini Walter,0,0,0,Heini Walter
461,462,95,1962,Heinz Schiller,Colin Davis,0,0,0,Colin Davis
461,466,95,1962,Heinz Schiller,Heini Walter,0,0,0,Heini Walter
462,466,95,1962,Colin Davis,Heini Walter,0,0,0,Heini Walter
423,430,95,1963,Gerhard Mitter,Carel Godin de Beaufort,3,2,1,Gerhard Mitter
423,446,95,1963,Gerhard Mitter,Carlo Abate,3,0,3,Gerhard Mitter
430,446,95,1963,Carel Godin de Beaufort,Carlo Abate,2,0,2,Carel Godin de Beaufort
448,450,98,1963,Peter Broeker,Ernie de Vos,0,0,0,Ernie de Vos
376,429,99,1961,Lucien Bianchi,AndrÃ© Pilette,0,0,0,AndrÃ© Pilette
376,482,99,1961,Lucien Bianchi,Olivier Gendebien,0,0,0,Olivier Gendebien
429,482,99,1961,AndrÃ© Pilette,Olivier Gendebien,0,0,0,Olivier Gendebien
436,438,99,1962,John Campbell-Jones,Tony Settember,0,0,0,Tony Settember
436,455,99,1962,John Campbell-Jones,Wolfgang Seidel,0,0,0,Wolfgang Seidel
438,455,99,1962,Tony Settember,Wolfgang Seidel,0,0,0,Wolfgang Seidel
